timestamp,marginal_profit,pnl,trades,position,actual_pnl,starfruit_price,amethyst_price
100,-10242,-10242,"(AMETHYSTS, MARKET << US, 10002, 1, 100)
(AMETHYSTS, MARKET << US, 10002, 1, 100)
(STARFRUIT, US << MARKET, 5041, 1, 100)
(STARFRUIT, US << MARKET, 5041, 1, 100)
(STARFRUIT, US << MARKET, 5041, 1, 100)
(STARFRUIT, US << MARKET, 5041, 1, 100)
(STARFRUIT, US << MARKET, 5041, 1, 100)
(STARFRUIT, US << MARKET, 5041, 1, 100)","{""AMETHYSTS"": -2, ""STARFRUIT"": 6}",12,5042,9999
300,-34803,-45045,"(AMETHYSTS, US << MARKET, 9998, 1, 300)
(AMETHYSTS, US << MARKET, 9998, 1, 300)
(AMETHYSTS, US << MARKET, 9998, 1, 300)
(AMETHYSTS, US << MARKET, 9998, 1, 300)
(AMETHYSTS, US << MARKET, 9998, 1, 300)
(AMETHYSTS, US << MARKET, 9998, 1, 300)
(STARFRUIT, MARKET << US, 5037, 1, 300)
(STARFRUIT, MARKET << US, 5037, 1, 300)
(STARFRUIT, MARKET << US, 5037, 1, 300)
(STARFRUIT, MARKET << US, 5037, 1, 300)
(STARFRUIT, MARKET << US, 5037, 1, 300)","{""AMETHYSTS"": 4, ""STARFRUIT"": 1}",-17,5040,9997
500,-82,-45127,"(AMETHYSTS, US << MARKET, 10002, 1, 500)
(AMETHYSTS, MARKET << US, 10004, 1, 500)
(AMETHYSTS, MARKET << US, 10004, 1, 500)
(STARFRUIT, US << MARKET, 5044, 1, 500)
(STARFRUIT, US << MARKET, 5044, 1, 500)","{""AMETHYSTS"": 3, ""STARFRUIT"": 3}",2,5040,10003
1300,10080,-35047,"(STARFRUIT, MARKET << US, 5040, 1, 1300)
(STARFRUIT, MARKET << US, 5040, 1, 1300)","{""AMETHYSTS"": 3, ""STARFRUIT"": 1}",-11,5036,10000
1400,5036,-30011,"(STARFRUIT, MARKET << US, 5036, 1, 1400)","{""AMETHYSTS"": 3, ""STARFRUIT"": 0}",-11,5039,10000
1500,9922,-20089,"(AMETHYSTS, MARKET << US, 10002, 1, 1500)
(AMETHYSTS, MARKET << US, 10002, 1, 1500)
(STARFRUIT, US << MARKET, 5041, 1, 1500)
(STARFRUIT, US << MARKET, 5041, 1, 1500)","{""AMETHYSTS"": 1, ""STARFRUIT"": 2}",-2,5042,10003
1700,-60030,-80119,"(AMETHYSTS, US << MARKET, 10005, 1, 1700)
(AMETHYSTS, US << MARKET, 10005, 1, 1700)
(AMETHYSTS, US << MARKET, 10005, 1, 1700)
(AMETHYSTS, US << MARKET, 10005, 1, 1700)
(AMETHYSTS, US << MARKET, 10005, 1, 1700)
(AMETHYSTS, US << MARKET, 10005, 1, 1700)","{""AMETHYSTS"": 7, ""STARFRUIT"": 2}",-43,5038,10000
2400,20168,-59951,"(STARFRUIT, MARKET << US, 5042, 1, 2400)
(STARFRUIT, MARKET << US, 5042, 1, 2400)
(STARFRUIT, MARKET << US, 5042, 1, 2400)
(STARFRUIT, MARKET << US, 5042, 1, 2400)","{""AMETHYSTS"": 7, ""STARFRUIT"": -2}",-28,5042,10001
2700,-99980,-159931,"(AMETHYSTS, US << MARKET, 9998, 1, 2700)
(AMETHYSTS, US << MARKET, 9998, 1, 2700)
(AMETHYSTS, US << MARKET, 9998, 1, 2700)
(AMETHYSTS, US << MARKET, 9998, 1, 2700)
(AMETHYSTS, US << MARKET, 9998, 1, 2700)
(AMETHYSTS, US << MARKET, 9998, 1, 2700)
(AMETHYSTS, US << MARKET, 9998, 1, 2700)
(AMETHYSTS, US << MARKET, 9998, 1, 2700)
(AMETHYSTS, US << MARKET, 9998, 1, 2700)
(AMETHYSTS, US << MARKET, 9998, 1, 2700)","{""AMETHYSTS"": 17, ""STARFRUIT"": -2}",12,5037,10001
2800,-10082,-170013,"(STARFRUIT, US << MARKET, 5041, 1, 2800)
(STARFRUIT, US << MARKET, 5041, 1, 2800)","{""AMETHYSTS"": 17, ""STARFRUIT"": 0}",4,5041,10001
2900,9998,-160015,"(AMETHYSTS, MARKET << US, 9998, 1, 2900)","{""AMETHYSTS"": 16, ""STARFRUIT"": 0}",33,5038,10003
3100,5035,-154980,"(STARFRUIT, MARKET << US, 5035, 1, 3100)","{""AMETHYSTS"": 16, ""STARFRUIT"": -1}",-18,5038,10000
3300,-9996,-164976,"(AMETHYSTS, US << MARKET, 9996, 1, 3300)
(AMETHYSTS, US << MARKET, 9996, 1, 3300)
(AMETHYSTS, US << MARKET, 9996, 1, 3300)
(AMETHYSTS, MARKET << US, 9996, 1, 3300)
(AMETHYSTS, MARKET << US, 9996, 1, 3300)","{""AMETHYSTS"": 17, ""STARFRUIT"": -1}",-13,5037,10000
3700,5031,-159945,"(STARFRUIT, US << MARKET, 5040, 1, 3700)
(STARFRUIT, US << MARKET, 5040, 1, 3700)
(STARFRUIT, MARKET << US, 5037, 1, 3700)
(STARFRUIT, MARKET << US, 5037, 1, 3700)
(STARFRUIT, MARKET << US, 5037, 1, 3700)","{""AMETHYSTS"": 17, ""STARFRUIT"": -2}",-51,5036,9998
3800,-30204,-190149,"(STARFRUIT, US << MARKET, 5034, 1, 3800)
(STARFRUIT, US << MARKET, 5034, 1, 3800)
(STARFRUIT, US << MARKET, 5034, 1, 3800)
(STARFRUIT, US << MARKET, 5034, 1, 3800)
(STARFRUIT, US << MARKET, 5034, 1, 3800)
(STARFRUIT, US << MARKET, 5034, 1, 3800)","{""AMETHYSTS"": 17, ""STARFRUIT"": 4}",46,5036,10003
4200,-20140,-210289,"(STARFRUIT, US << MARKET, 5035, 1, 4200)
(STARFRUIT, US << MARKET, 5035, 1, 4200)
(STARFRUIT, US << MARKET, 5035, 1, 4200)
(STARFRUIT, US << MARKET, 5035, 1, 4200)","{""AMETHYSTS"": 17, ""STARFRUIT"": 8}",15,5038,10000
4300,34948,-175341,"(AMETHYSTS, MARKET << US, 9996, 1, 4300)
(AMETHYSTS, MARKET << US, 9996, 1, 4300)
(AMETHYSTS, MARKET << US, 9996, 1, 4300)
(AMETHYSTS, MARKET << US, 9995, 1, 4300)
(STARFRUIT, US << MARKET, 5035, 1, 4300)","{""AMETHYSTS"": 13, ""STARFRUIT"": 9}",1,5038,10000
4400,15033,-160308,"(AMETHYSTS, MARKET << US, 9998, 1, 4400)
(STARFRUIT, MARKET << US, 5035, 1, 4400)","{""AMETHYSTS"": 12, ""STARFRUIT"": 8}",-32,5039,9997
4800,-35045,-195353,"(AMETHYSTS, US << MARKET, 10002, 1, 4800)
(AMETHYSTS, US << MARKET, 10002, 1, 4800)
(AMETHYSTS, US << MARKET, 10002, 1, 4800)
(STARFRUIT, US << MARKET, 5039, 1, 4800)","{""AMETHYSTS"": 15, ""STARFRUIT"": 9}",16,5036,10003
4900,-49990,-245343,"(AMETHYSTS, US << MARKET, 9998, 1, 4900)
(AMETHYSTS, US << MARKET, 9998, 1, 4900)
(AMETHYSTS, US << MARKET, 9998, 1, 4900)
(AMETHYSTS, US << MARKET, 9998, 1, 4900)
(AMETHYSTS, US << MARKET, 9998, 1, 4900)","{""AMETHYSTS"": 20, ""STARFRUIT"": 9}",-99,5036,9996
5400,30210,-215133,"(STARFRUIT, MARKET << US, 5035, 1, 5400)
(STARFRUIT, MARKET << US, 5035, 1, 5400)
(STARFRUIT, MARKET << US, 5035, 1, 5400)
(STARFRUIT, MARKET << US, 5035, 1, 5400)
(STARFRUIT, MARKET << US, 5035, 1, 5400)
(STARFRUIT, MARKET << US, 5035, 1, 5400)","{""AMETHYSTS"": 20, ""STARFRUIT"": 3}",-94,5033,9997
6700,0,-215133,,"{""AMETHYSTS"": 20, ""STARFRUIT"": 3}",26,5033,10003
6800,30054,-185079,"(AMETHYSTS, MARKET << US, 9998, 1, 6800)
(AMETHYSTS, MARKET << US, 9996, 1, 6800)
(STARFRUIT, MARKET << US, 5030, 1, 6800)
(STARFRUIT, MARKET << US, 5030, 1, 6800)","{""AMETHYSTS"": 18, ""STARFRUIT"": 1}",-28,5033,10001
6900,-10070,-195149,"(STARFRUIT, US << MARKET, 5035, 1, 6900)
(STARFRUIT, US << MARKET, 5035, 1, 6900)","{""AMETHYSTS"": 18, ""STARFRUIT"": 3}",-53,5032,10000
7200,-20076,-215225,"(AMETHYSTS, US << MARKET, 10004, 1, 7200)
(STARFRUIT, US << MARKET, 5036, 1, 7200)
(STARFRUIT, US << MARKET, 5036, 1, 7200)","{""AMETHYSTS"": 19, ""STARFRUIT"": 5}",-60,5033,10000
7300,25150,-190075,"(STARFRUIT, MARKET << US, 5030, 1, 7300)
(STARFRUIT, MARKET << US, 5030, 1, 7300)
(STARFRUIT, MARKET << US, 5030, 1, 7300)
(STARFRUIT, MARKET << US, 5030, 1, 7300)
(STARFRUIT, MARKET << US, 5030, 1, 7300)","{""AMETHYSTS"": 19, ""STARFRUIT"": 0}",-94,5033,9999
7400,20004,-170071,"(AMETHYSTS, MARKET << US, 10002, 1, 7400)
(AMETHYSTS, MARKET << US, 10002, 1, 7400)","{""AMETHYSTS"": 17, ""STARFRUIT"": 0}",-20,5032,10003
7700,14976,-155095,"(AMETHYSTS, MARKET << US, 10005, 1, 7700)
(AMETHYSTS, MARKET << US, 10005, 1, 7700)
(STARFRUIT, US << MARKET, 5035, 1, 7700)
(STARFRUIT, US << MARKET, 5035, 1, 7700)
(STARFRUIT, MARKET << US, 5036, 1, 7700)","{""AMETHYSTS"": 15, ""STARFRUIT"": 1}",-63,5032,10000
7800,5036,-150059,"(STARFRUIT, MARKET << US, 5036, 1, 7800)","{""AMETHYSTS"": 15, ""STARFRUIT"": 0}",-59,5036,10000
7900,9934,-140125,"(AMETHYSTS, MARKET << US, 10002, 1, 7900)
(AMETHYSTS, MARKET << US, 10002, 1, 7900)
(STARFRUIT, US << MARKET, 5035, 1, 7900)
(STARFRUIT, US << MARKET, 5035, 1, 7900)","{""AMETHYSTS"": 13, ""STARFRUIT"": 2}",-66,5036,9999
8100,20148,-119977,"(STARFRUIT, MARKET << US, 5037, 1, 8100)
(STARFRUIT, MARKET << US, 5037, 1, 8100)
(STARFRUIT, MARKET << US, 5037, 1, 8100)
(STARFRUIT, MARKET << US, 5037, 1, 8100)","{""AMETHYSTS"": 13, ""STARFRUIT"": -2}",-45,5034,10000
8200,9998,-109979,"(AMETHYSTS, MARKET << US, 9998, 1, 8200)","{""AMETHYSTS"": 12, ""STARFRUIT"": -2}",-91,5032,9996
8300,-30222,-140201,"(STARFRUIT, US << MARKET, 5037, 1, 8300)
(STARFRUIT, US << MARKET, 5037, 1, 8300)
(STARFRUIT, US << MARKET, 5037, 1, 8300)
(STARFRUIT, US << MARKET, 5037, 1, 8300)
(STARFRUIT, US << MARKET, 5037, 1, 8300)
(STARFRUIT, US << MARKET, 5037, 1, 8300)","{""AMETHYSTS"": 12, ""STARFRUIT"": 4}",-29,5034,10003
8900,-50010,-190211,"(AMETHYSTS, US << MARKET, 10002, 1, 8900)
(AMETHYSTS, US << MARKET, 10002, 1, 8900)
(AMETHYSTS, US << MARKET, 10002, 1, 8900)
(AMETHYSTS, US << MARKET, 10002, 1, 8900)
(AMETHYSTS, US << MARKET, 10002, 1, 8900)","{""AMETHYSTS"": 17, ""STARFRUIT"": 4}",-28,5033,10003
9300,-20136,-210347,"(STARFRUIT, US << MARKET, 5034, 1, 9300)
(STARFRUIT, US << MARKET, 5034, 1, 9300)
(STARFRUIT, US << MARKET, 5034, 1, 9300)
(STARFRUIT, US << MARKET, 5034, 1, 9300)","{""AMETHYSTS"": 17, ""STARFRUIT"": 8}",-67,5035,10000
9600,-10068,-220415,"(STARFRUIT, US << MARKET, 5034, 1, 9600)
(STARFRUIT, US << MARKET, 5034, 1, 9600)","{""AMETHYSTS"": 17, ""STARFRUIT"": 10}",-125,5029,10000
10100,-20132,-240547,"(STARFRUIT, US << MARKET, 5033, 1, 10100)
(STARFRUIT, US << MARKET, 5033, 1, 10100)
(STARFRUIT, US << MARKET, 5033, 1, 10100)
(STARFRUIT, US << MARKET, 5033, 1, 10100)","{""AMETHYSTS"": 17, ""STARFRUIT"": 14}",-71,5034,10000
10300,29946,-210601,"(AMETHYSTS, MARKET << US, 10004, 1, 10300)
(AMETHYSTS, MARKET << US, 10004, 1, 10300)
(AMETHYSTS, MARKET << US, 10004, 1, 10300)
(AMETHYSTS, MARKET << US, 10004, 1, 10300)
(STARFRUIT, US << MARKET, 5035, 1, 10300)
(STARFRUIT, US << MARKET, 5035, 1, 10300)","{""AMETHYSTS"": 13, ""STARFRUIT"": 16}",-89,5032,10000
10600,-39992,-250593,"(AMETHYSTS, US << MARKET, 9998, 1, 10600)
(AMETHYSTS, US << MARKET, 9998, 1, 10600)
(AMETHYSTS, US << MARKET, 9998, 1, 10600)
(AMETHYSTS, US << MARKET, 9998, 1, 10600)","{""AMETHYSTS"": 17, ""STARFRUIT"": 16}",-165,5031,9996
10700,30174,-220419,"(STARFRUIT, MARKET << US, 5029, 1, 10700)
(STARFRUIT, MARKET << US, 5029, 1, 10700)
(STARFRUIT, MARKET << US, 5029, 1, 10700)
(STARFRUIT, MARKET << US, 5029, 1, 10700)
(STARFRUIT, MARKET << US, 5029, 1, 10700)
(STARFRUIT, MARKET << US, 5029, 1, 10700)","{""AMETHYSTS"": 17, ""STARFRUIT"": 10}",-82,5032,10001
10800,14975,-205444,"(AMETHYSTS, MARKET << US, 10002, 1, 10800)
(AMETHYSTS, MARKET << US, 10002, 1, 10800)
(STARFRUIT, US << MARKET, 5029, 1, 10800)","{""AMETHYSTS"": 15, ""STARFRUIT"": 11}",-47,5032,10003
11100,-39984,-245428,"(AMETHYSTS, US << MARKET, 9996, 1, 11100)
(AMETHYSTS, US << MARKET, 9996, 1, 11100)
(AMETHYSTS, US << MARKET, 9996, 1, 11100)
(AMETHYSTS, US << MARKET, 9996, 1, 11100)","{""AMETHYSTS"": 19, ""STARFRUIT"": 11}",-106,5031,9999
11300,-20136,-265564,"(STARFRUIT, US << MARKET, 5034, 1, 11300)
(STARFRUIT, US << MARKET, 5034, 1, 11300)
(STARFRUIT, US << MARKET, 5034, 1, 11300)
(STARFRUIT, US << MARKET, 5034, 1, 11300)","{""AMETHYSTS"": 19, ""STARFRUIT"": 15}",-114,5030,10000
11400,9998,-255566,"(AMETHYSTS, MARKET << US, 9998, 1, 11400)","{""AMETHYSTS"": 18, ""STARFRUIT"": 15}",-98,5030,10001
12000,-20128,-275694,"(STARFRUIT, US << MARKET, 5032, 1, 12000)
(STARFRUIT, US << MARKET, 5032, 1, 12000)
(STARFRUIT, US << MARKET, 5032, 1, 12000)
(STARFRUIT, US << MARKET, 5032, 1, 12000)","{""AMETHYSTS"": 18, ""STARFRUIT"": 19}",-162,5028,10000
12100,14978,-260716,"(AMETHYSTS, MARKET << US, 10002, 1, 12100)
(AMETHYSTS, MARKET << US, 10002, 1, 12100)
(STARFRUIT, US << MARKET, 5026, 1, 12100)","{""AMETHYSTS"": 16, ""STARFRUIT"": 20}",-152,5029,9999
12300,-10002,-270718,"(AMETHYSTS, US << MARKET, 10002, 1, 12300)","{""AMETHYSTS"": 17, ""STARFRUIT"": 20}",-212,5027,9998
12500,-20004,-290722,"(AMETHYSTS, US << MARKET, 10002, 1, 12500)
(AMETHYSTS, US << MARKET, 10002, 1, 12500)","{""AMETHYSTS"": 19, ""STARFRUIT"": 20}",-105,5028,10003
13300,0,-290722,,"{""AMETHYSTS"": 19, ""STARFRUIT"": 20}",-122,5030,10000
13600,25165,-265557,"(STARFRUIT, MARKET << US, 5033, 1, 13600)
(STARFRUIT, MARKET << US, 5033, 1, 13600)
(STARFRUIT, MARKET << US, 5033, 1, 13600)
(STARFRUIT, MARKET << US, 5033, 1, 13600)
(STARFRUIT, MARKET << US, 5033, 1, 13600)","{""AMETHYSTS"": 19, ""STARFRUIT"": 15}",-47,5034,10000
13700,9998,-255559,"(AMETHYSTS, MARKET << US, 9998, 1, 13700)","{""AMETHYSTS"": 18, ""STARFRUIT"": 15}",-46,5033,10001
14000,-14957,-270516,"(AMETHYSTS, US << MARKET, 9996, 1, 14000)
(AMETHYSTS, US << MARKET, 9996, 1, 14000)
(STARFRUIT, MARKET << US, 5035, 1, 14000)","{""AMETHYSTS"": 20, ""STARFRUIT"": 14}",-26,5035,10000
14300,5029,-265487,"(STARFRUIT, MARKET << US, 5029, 1, 14300)","{""AMETHYSTS"": 20, ""STARFRUIT"": 13}",-71,5032,10000
14500,-5029,-270516,"(STARFRUIT, US << MARKET, 5029, 1, 14500)","{""AMETHYSTS"": 20, ""STARFRUIT"": 14}",-136,5030,9998
14800,-5029,-275545,"(STARFRUIT, US << MARKET, 5029, 1, 14800)","{""AMETHYSTS"": 20, ""STARFRUIT"": 15}",-80,5031,10000
15000,-5029,-280574,"(STARFRUIT, US << MARKET, 5029, 1, 15000)","{""AMETHYSTS"": 20, ""STARFRUIT"": 16}",-78,5031,10000
15100,14971,-265603,"(AMETHYSTS, MARKET << US, 10002, 1, 15100)
(AMETHYSTS, MARKET << US, 10002, 1, 15100)
(STARFRUIT, US << MARKET, 5033, 1, 15100)","{""AMETHYSTS"": 18, ""STARFRUIT"": 17}",29,5034,10003
15200,-15087,-280690,"(STARFRUIT, US << MARKET, 5029, 1, 15200)
(STARFRUIT, US << MARKET, 5029, 1, 15200)
(STARFRUIT, US << MARKET, 5029, 1, 15200)","{""AMETHYSTS"": 18, ""STARFRUIT"": 20}",-108,5030,9999
15400,-4969,-285659,"(AMETHYSTS, US << MARKET, 10002, 1, 15400)
(STARFRUIT, MARKET << US, 5033, 1, 15400)","{""AMETHYSTS"": 19, ""STARFRUIT"": 19}",-108,5030,9999
15500,5,-285654,"(STARFRUIT, US << MARKET, 5028, 1, 15500)
(STARFRUIT, MARKET << US, 5033, 1, 15500)","{""AMETHYSTS"": 19, ""STARFRUIT"": 19}",-65,5030,10001
15800,34964,-250690,"(AMETHYSTS, MARKET << US, 9998, 1, 15800)
(AMETHYSTS, MARKET << US, 9998, 1, 15800)
(AMETHYSTS, MARKET << US, 9998, 1, 15800)
(AMETHYSTS, MARKET << US, 9998, 1, 15800)
(STARFRUIT, US << MARKET, 5028, 1, 15800)","{""AMETHYSTS"": 15, ""STARFRUIT"": 20}",-75,5030,10001
16200,5033,-245657,"(STARFRUIT, MARKET << US, 5033, 1, 16200)","{""AMETHYSTS"": 15, ""STARFRUIT"": 19}",-30,5033,10000
16700,-5028,-250685,"(STARFRUIT, US << MARKET, 5028, 1, 16700)","{""AMETHYSTS"": 15, ""STARFRUIT"": 20}",-20,5031,10003
16800,40008,-210677,"(AMETHYSTS, MARKET << US, 10002, 1, 16800)
(AMETHYSTS, MARKET << US, 10002, 1, 16800)
(AMETHYSTS, MARKET << US, 10002, 1, 16800)
(AMETHYSTS, MARKET << US, 10002, 1, 16800)","{""AMETHYSTS"": 11, ""STARFRUIT"": 20}",-68,5031,9999
17100,0,-210677,,"{""AMETHYSTS"": 11, ""STARFRUIT"": 20}",-66,5030,10001
17300,9998,-200679,"(AMETHYSTS, MARKET << US, 9998, 1, 17300)","{""AMETHYSTS"": 10, ""STARFRUIT"": 20}",-159,5028,9996
18000,0,-200679,,"{""AMETHYSTS"": 10, ""STARFRUIT"": 20}",-49,5031,10001
18200,0,-200679,,"{""AMETHYSTS"": 10, ""STARFRUIT"": 20}",-39,5032,10000
18600,20004,-180675,"(AMETHYSTS, MARKET << US, 10002, 1, 18600)
(AMETHYSTS, MARKET << US, 10002, 1, 18600)","{""AMETHYSTS"": 8, ""STARFRUIT"": 20}",-83,5030,9999
18700,50330,-130345,"(STARFRUIT, MARKET << US, 5033, 1, 18700)
(STARFRUIT, MARKET << US, 5033, 1, 18700)
(STARFRUIT, MARKET << US, 5033, 1, 18700)
(STARFRUIT, MARKET << US, 5033, 1, 18700)
(STARFRUIT, MARKET << US, 5033, 1, 18700)
(STARFRUIT, MARKET << US, 5033, 1, 18700)
(STARFRUIT, MARKET << US, 5033, 1, 18700)
(STARFRUIT, MARKET << US, 5033, 1, 18700)
(STARFRUIT, MARKET << US, 5033, 1, 18700)
(STARFRUIT, MARKET << US, 5033, 1, 18700)","{""AMETHYSTS"": 8, ""STARFRUIT"": 10}",-11,5031,10003
18900,-20076,-150421,"(AMETHYSTS, US << MARKET, 10004, 1, 18900)
(STARFRUIT, US << MARKET, 5036, 1, 18900)
(STARFRUIT, US << MARKET, 5036, 1, 18900)","{""AMETHYSTS"": 9, ""STARFRUIT"": 12}",-25,5033,10000
19000,-5038,-155459,"(STARFRUIT, US << MARKET, 5034, 1, 19000)
(STARFRUIT, US << MARKET, 5034, 1, 19000)
(STARFRUIT, MARKET << US, 5030, 1, 19000)","{""AMETHYSTS"": 9, ""STARFRUIT"": 13}",-22,5035,9998
20100,35193,-120266,"(AMETHYSTS, MARKET << US, 9998, 1, 20100)
(STARFRUIT, US << MARKET, 5039, 1, 20100)
(STARFRUIT, US << MARKET, 5039, 1, 20100)
(STARFRUIT, MARKET << US, 5039, 1, 20100)
(STARFRUIT, MARKET << US, 5039, 1, 20100)
(STARFRUIT, MARKET << US, 5039, 1, 20100)
(STARFRUIT, MARKET << US, 5039, 1, 20100)
(STARFRUIT, MARKET << US, 5039, 1, 20100)
(STARFRUIT, MARKET << US, 5039, 1, 20100)
(STARFRUIT, MARKET << US, 5039, 1, 20100)","{""AMETHYSTS"": 8, ""STARFRUIT"": 8}",30,5036,10001
20500,30222,-90044,"(STARFRUIT, MARKET << US, 5037, 1, 20500)
(STARFRUIT, MARKET << US, 5037, 1, 20500)
(STARFRUIT, MARKET << US, 5037, 1, 20500)
(STARFRUIT, MARKET << US, 5037, 1, 20500)
(STARFRUIT, MARKET << US, 5037, 1, 20500)
(STARFRUIT, MARKET << US, 5037, 1, 20500)","{""AMETHYSTS"": 8, ""STARFRUIT"": 2}",32,5038,10000
20600,76,-89968,"(AMETHYSTS, US << MARKET, 10004, 1, 20600)
(STARFRUIT, MARKET << US, 5040, 1, 20600)
(STARFRUIT, MARKET << US, 5040, 1, 20600)","{""AMETHYSTS"": 9, ""STARFRUIT"": 0}",32,5036,10000
20800,10078,-79890,"(STARFRUIT, MARKET << US, 5039, 1, 20800)
(STARFRUIT, MARKET << US, 5039, 1, 20800)","{""AMETHYSTS"": 9, ""STARFRUIT"": -2}",32,5039,10000
20900,-10004,-89894,"(AMETHYSTS, US << MARKET, 10004, 1, 20900)","{""AMETHYSTS"": 10, ""STARFRUIT"": -2}",32,5037,10000
21100,-140,-90034,"(AMETHYSTS, MARKET << US, 9998, 1, 21100)
(AMETHYSTS, MARKET << US, 9998, 1, 21100)
(STARFRUIT, US << MARKET, 5034, 1, 21100)
(STARFRUIT, US << MARKET, 5034, 1, 21100)
(STARFRUIT, US << MARKET, 5034, 1, 21100)
(STARFRUIT, US << MARKET, 5034, 1, 21100)","{""AMETHYSTS"": 8, ""STARFRUIT"": 2}",48,5037,10001
21600,-20072,-110106,"(AMETHYSTS, US << MARKET, 10002, 1, 21600)
(STARFRUIT, US << MARKET, 5035, 1, 21600)
(STARFRUIT, US << MARKET, 5035, 1, 21600)","{""AMETHYSTS"": 9, ""STARFRUIT"": 4}",73,5038,10003
21900,-14956,-125062,"(AMETHYSTS, US << MARKET, 9996, 1, 21900)
(AMETHYSTS, US << MARKET, 9996, 1, 21900)
(STARFRUIT, MARKET << US, 5036, 1, 21900)","{""AMETHYSTS"": 11, ""STARFRUIT"": 3}",55,5039,10000
22000,-35110,-160172,"(AMETHYSTS, US << MARKET, 10000, 1, 22000)
(AMETHYSTS, US << MARKET, 10000, 1, 22000)
(STARFRUIT, US << MARKET, 5036, 1, 22000)
(STARFRUIT, US << MARKET, 5036, 1, 22000)
(STARFRUIT, US << MARKET, 5038, 1, 22000)","{""AMETHYSTS"": 13, ""STARFRUIT"": 6}",24,5037,9998
22100,15031,-145141,"(AMETHYSTS, MARKET << US, 9996, 1, 22100)
(STARFRUIT, MARKET << US, 5035, 1, 22100)","{""AMETHYSTS"": 12, ""STARFRUIT"": 5}",49,5038,10000
22400,0,-145141,"(AMETHYSTS, US << MARKET, 10002, 1, 22400)
(AMETHYSTS, US << MARKET, 10002, 1, 22400)
(AMETHYSTS, MARKET << US, 10002, 1, 22400)
(AMETHYSTS, MARKET << US, 10002, 1, 22400)","{""AMETHYSTS"": 12, ""STARFRUIT"": 5}",90,5039,10003
22500,-60012,-205153,"(AMETHYSTS, US << MARKET, 10002, 1, 22500)
(AMETHYSTS, US << MARKET, 10002, 1, 22500)
(AMETHYSTS, US << MARKET, 10002, 1, 22500)
(AMETHYSTS, US << MARKET, 10002, 1, 22500)
(AMETHYSTS, US << MARKET, 10002, 1, 22500)
(AMETHYSTS, US << MARKET, 10002, 1, 22500)","{""AMETHYSTS"": 18, ""STARFRUIT"": 5}",96,5039,10003
22700,-20172,-225325,"(STARFRUIT, US << MARKET, 5043, 1, 22700)
(STARFRUIT, US << MARKET, 5043, 1, 22700)
(STARFRUIT, US << MARKET, 5043, 1, 22700)
(STARFRUIT, US << MARKET, 5043, 1, 22700)","{""AMETHYSTS"": 18, ""STARFRUIT"": 9}",26,5039,10000
23200,9998,-215327,"(AMETHYSTS, MARKET << US, 9998, 1, 23200)","{""AMETHYSTS"": 17, ""STARFRUIT"": 9}",-44,5039,9996
23300,-10082,-225409,"(STARFRUIT, US << MARKET, 5041, 1, 23300)
(STARFRUIT, US << MARKET, 5041, 1, 23300)","{""AMETHYSTS"": 17, ""STARFRUIT"": 11}",9,5038,10000
23700,25220,-200189,"(STARFRUIT, MARKET << US, 5044, 1, 23700)
(STARFRUIT, MARKET << US, 5044, 1, 23700)
(STARFRUIT, MARKET << US, 5044, 1, 23700)
(STARFRUIT, MARKET << US, 5044, 1, 23700)
(STARFRUIT, MARKET << US, 5044, 1, 23700)","{""AMETHYSTS"": 17, ""STARFRUIT"": 6}",51,5040,10000
23900,5042,-195147,"(STARFRUIT, MARKET << US, 5042, 1, 23900)","{""AMETHYSTS"": 17, ""STARFRUIT"": 5}",68,5043,10000
24200,-19996,-215143,"(AMETHYSTS, US << MARKET, 9998, 1, 24200)
(AMETHYSTS, US << MARKET, 9998, 1, 24200)","{""AMETHYSTS"": 19, ""STARFRUIT"": 5}",91,5043,10001
24300,-10002,-225145,"(AMETHYSTS, US << MARKET, 10002, 1, 24300)","{""AMETHYSTS"": 20, ""STARFRUIT"": 5}",120,5041,10003
24500,-10074,-235219,"(STARFRUIT, US << MARKET, 5037, 1, 24500)
(STARFRUIT, US << MARKET, 5037, 1, 24500)","{""AMETHYSTS"": 20, ""STARFRUIT"": 7}",-12,5041,9996
24700,25052,-210167,"(AMETHYSTS, MARKET << US, 10004, 1, 24700)
(AMETHYSTS, MARKET << US, 10004, 1, 24700)
(STARFRUIT, MARKET << US, 5044, 1, 24700)","{""AMETHYSTS"": 18, ""STARFRUIT"": 6}",73,5040,10000
25100,-20091,-230258,"(AMETHYSTS, US << MARKET, 10005, 1, 25100)
(STARFRUIT, US << MARKET, 5043, 1, 25100)
(STARFRUIT, US << MARKET, 5043, 1, 25100)","{""AMETHYSTS"": 19, ""STARFRUIT"": 8}",54,5039,10000
25300,-4960,-235218,"(AMETHYSTS, US << MARKET, 9996, 1, 25300)
(STARFRUIT, MARKET << US, 5036, 1, 25300)","{""AMETHYSTS"": 20, ""STARFRUIT"": 7}",35,5039,9999
25400,5042,-230176,"(STARFRUIT, MARKET << US, 5042, 1, 25400)","{""AMETHYSTS"": 20, ""STARFRUIT"": 6}",72,5038,10001
26500,34966,-195210,"(AMETHYSTS, MARKET << US, 10002, 1, 26500)
(AMETHYSTS, MARKET << US, 10002, 1, 26500)
(AMETHYSTS, MARKET << US, 10002, 1, 26500)
(AMETHYSTS, MARKET << US, 10002, 1, 26500)
(STARFRUIT, US << MARKET, 5043, 1, 26500)
(STARFRUIT, US << MARKET, 5043, 1, 26500)
(STARFRUIT, MARKET << US, 5044, 1, 26500)","{""AMETHYSTS"": 16, ""STARFRUIT"": 7}",75,5043,9999
26600,60012,-135198,"(AMETHYSTS, MARKET << US, 10002, 1, 26600)
(AMETHYSTS, MARKET << US, 10002, 1, 26600)
(AMETHYSTS, MARKET << US, 10002, 1, 26600)
(AMETHYSTS, MARKET << US, 10002, 1, 26600)
(AMETHYSTS, MARKET << US, 10002, 1, 26600)
(AMETHYSTS, MARKET << US, 10002, 1, 26600)","{""AMETHYSTS"": 10, ""STARFRUIT"": 7}",112,5040,10003
26700,10082,-125116,"(STARFRUIT, MARKET << US, 5041, 1, 26700)
(STARFRUIT, MARKET << US, 5041, 1, 26700)","{""AMETHYSTS"": 10, ""STARFRUIT"": 5}",44,5038,9997
26900,9998,-115118,"(AMETHYSTS, MARKET << US, 9998, 1, 26900)","{""AMETHYSTS"": 9, ""STARFRUIT"": 5}",46,5040,9996
27400,20008,-95110,"(AMETHYSTS, MARKET << US, 10004, 1, 27400)
(AMETHYSTS, MARKET << US, 10004, 1, 27400)","{""AMETHYSTS"": 7, ""STARFRUIT"": 5}",85,5039,10000
27600,-19996,-115106,"(AMETHYSTS, US << MARKET, 9998, 1, 27600)
(AMETHYSTS, US << MARKET, 9998, 1, 27600)","{""AMETHYSTS"": 9, ""STARFRUIT"": 5}",72,5041,9997
27700,-15126,-130232,"(AMETHYSTS, US << MARKET, 9996, 1, 27700)
(AMETHYSTS, US << MARKET, 9996, 1, 27700)
(AMETHYSTS, US << MARKET, 9996, 1, 27700)
(AMETHYSTS, US << MARKET, 9996, 1, 27700)
(AMETHYSTS, MARKET << US, 9996, 1, 27700)
(AMETHYSTS, MARKET << US, 9996, 1, 27700)
(AMETHYSTS, MARKET << US, 9996, 1, 27700)
(AMETHYSTS, MARKET << US, 9996, 1, 27700)
(STARFRUIT, US << MARKET, 5042, 1, 27700)
(STARFRUIT, US << MARKET, 5042, 1, 27700)
(STARFRUIT, US << MARKET, 5042, 1, 27700)","{""AMETHYSTS"": 9, ""STARFRUIT"": 8}",112,5043,10000
27900,39992,-90240,"(AMETHYSTS, MARKET << US, 9998, 1, 27900)
(AMETHYSTS, MARKET << US, 9998, 1, 27900)
(AMETHYSTS, MARKET << US, 9998, 1, 27900)
(AMETHYSTS, MARKET << US, 9998, 1, 27900)","{""AMETHYSTS"": 5, ""STARFRUIT"": 8}",81,5042,9997
28000,25049,-65191,"(AMETHYSTS, MARKET << US, 10002, 1, 28000)
(AMETHYSTS, MARKET << US, 10002, 1, 28000)
(STARFRUIT, MARKET << US, 5045, 1, 28000)","{""AMETHYSTS"": 3, ""STARFRUIT"": 7}",90,5041,9998
28100,20076,-45115,"(AMETHYSTS, MARKET << US, 9995, 1, 28100)
(STARFRUIT, US << MARKET, 5039, 1, 28100)
(STARFRUIT, MARKET << US, 5040, 1, 28100)
(STARFRUIT, MARKET << US, 5040, 1, 28100)
(STARFRUIT, MARKET << US, 5040, 1, 28100)","{""AMETHYSTS"": 2, ""STARFRUIT"": 5}",80,5039,10000
28600,5039,-40076,"(STARFRUIT, MARKET << US, 5039, 1, 28600)","{""AMETHYSTS"": 2, ""STARFRUIT"": 4}",90,5041,10001
28700,-159936,-200012,"(AMETHYSTS, US << MARKET, 9996, 1, 28700)
(AMETHYSTS, US << MARKET, 9996, 1, 28700)
(AMETHYSTS, US << MARKET, 9996, 1, 28700)
(AMETHYSTS, US << MARKET, 9996, 1, 28700)
(AMETHYSTS, US << MARKET, 9996, 1, 28700)
(AMETHYSTS, US << MARKET, 9996, 1, 28700)
(AMETHYSTS, US << MARKET, 9996, 1, 28700)
(AMETHYSTS, US << MARKET, 9996, 1, 28700)
(AMETHYSTS, US << MARKET, 9996, 1, 28700)
(AMETHYSTS, US << MARKET, 9996, 1, 28700)
(AMETHYSTS, US << MARKET, 9996, 1, 28700)
(AMETHYSTS, US << MARKET, 9996, 1, 28700)
(AMETHYSTS, US << MARKET, 9996, 1, 28700)
(AMETHYSTS, US << MARKET, 9996, 1, 28700)
(AMETHYSTS, US << MARKET, 9996, 1, 28700)
(AMETHYSTS, US << MARKET, 9996, 1, 28700)","{""AMETHYSTS"": 18, ""STARFRUIT"": 4}",156,5042,10000
29000,9918,-190094,"(AMETHYSTS, MARKET << US, 10005, 1, 29000)
(AMETHYSTS, MARKET << US, 10005, 1, 29000)
(STARFRUIT, US << MARKET, 5046, 1, 29000)
(STARFRUIT, US << MARKET, 5046, 1, 29000)","{""AMETHYSTS"": 16, ""STARFRUIT"": 6}",158,5042,10000
29200,10002,-180092,"(AMETHYSTS, US << MARKET, 10002, 1, 29200)
(AMETHYSTS, MARKET << US, 10002, 1, 29200)
(AMETHYSTS, MARKET << US, 10002, 1, 29200)","{""AMETHYSTS"": 15, ""STARFRUIT"": 6}",124,5041,9998
29300,5040,-175052,"(STARFRUIT, MARKET << US, 5040, 1, 29300)","{""AMETHYSTS"": 15, ""STARFRUIT"": 5}",163,5043,10000
29900,-14793,-189845,"(AMETHYSTS, US << MARKET, 10002, 1, 29900)
(AMETHYSTS, US << MARKET, 10002, 1, 29900)
(AMETHYSTS, US << MARKET, 10002, 1, 29900)
(AMETHYSTS, US << MARKET, 10002, 1, 29900)
(STARFRUIT, MARKET << US, 5043, 1, 29900)
(STARFRUIT, MARKET << US, 5043, 1, 29900)
(STARFRUIT, MARKET << US, 5043, 1, 29900)
(STARFRUIT, MARKET << US, 5043, 1, 29900)
(STARFRUIT, MARKET << US, 5043, 1, 29900)","{""AMETHYSTS"": 19, ""STARFRUIT"": 0}",136,5041,9999
30000,-10092,-199937,"(STARFRUIT, US << MARKET, 5046, 1, 30000)
(STARFRUIT, US << MARKET, 5046, 1, 30000)","{""AMETHYSTS"": 19, ""STARFRUIT"": 2}",136,5046,9999
30100,-25225,-225162,"(STARFRUIT, US << MARKET, 5045, 1, 30100)
(STARFRUIT, US << MARKET, 5045, 1, 30100)
(STARFRUIT, US << MARKET, 5045, 1, 30100)
(STARFRUIT, US << MARKET, 5045, 1, 30100)
(STARFRUIT, US << MARKET, 5045, 1, 30100)","{""AMETHYSTS"": 19, ""STARFRUIT"": 7}",75,5042,9997
30700,5040,-220122,"(STARFRUIT, MARKET << US, 5040, 1, 30700)","{""AMETHYSTS"": 19, ""STARFRUIT"": 6}",112,5039,10000
31200,5038,-215084,"(STARFRUIT, MARKET << US, 5038, 1, 31200)","{""AMETHYSTS"": 19, ""STARFRUIT"": 5}",121,5041,10000
31500,-10076,-225160,"(STARFRUIT, US << MARKET, 5038, 1, 31500)
(STARFRUIT, US << MARKET, 5038, 1, 31500)","{""AMETHYSTS"": 19, ""STARFRUIT"": 7}",120,5040,10000
31700,-5045,-230205,"(AMETHYSTS, US << MARKET, 9998, 1, 31700)
(AMETHYSTS, MARKET << US, 9998, 1, 31700)
(STARFRUIT, US << MARKET, 5045, 1, 31700)","{""AMETHYSTS"": 19, ""STARFRUIT"": 8}",47,5041,9996
32000,20004,-210201,"(AMETHYSTS, MARKET << US, 10002, 1, 32000)
(AMETHYSTS, MARKET << US, 10002, 1, 32000)","{""AMETHYSTS"": 17, ""STARFRUIT"": 8}",77,5039,9998
32200,5043,-205158,"(STARFRUIT, MARKET << US, 5043, 1, 32200)","{""AMETHYSTS"": 17, ""STARFRUIT"": 7}",126,5043,9999
32300,20004,-185154,"(AMETHYSTS, MARKET << US, 10002, 1, 32300)
(AMETHYSTS, MARKET << US, 10002, 1, 32300)","{""AMETHYSTS"": 15, ""STARFRUIT"": 7}",118,5041,9999
32700,20004,-165150,"(AMETHYSTS, MARKET << US, 10002, 1, 32700)
(AMETHYSTS, MARKET << US, 10002, 1, 32700)","{""AMETHYSTS"": 13, ""STARFRUIT"": 7}",176,5041,10003
32800,25195,-139955,"(STARFRUIT, MARKET << US, 5039, 1, 32800)
(STARFRUIT, MARKET << US, 5039, 1, 32800)
(STARFRUIT, MARKET << US, 5039, 1, 32800)
(STARFRUIT, MARKET << US, 5039, 1, 32800)
(STARFRUIT, MARKET << US, 5039, 1, 32800)","{""AMETHYSTS"": 13, ""STARFRUIT"": 2}",121,5038,10000
33600,-10074,-150029,"(STARFRUIT, US << MARKET, 5037, 1, 33600)
(STARFRUIT, US << MARKET, 5037, 1, 33600)","{""AMETHYSTS"": 13, ""STARFRUIT"": 4}",131,5040,10000
33700,-19996,-170025,"(AMETHYSTS, US << MARKET, 9998, 1, 33700)
(AMETHYSTS, US << MARKET, 9998, 1, 33700)","{""AMETHYSTS"": 15, ""STARFRUIT"": 4}",150,5040,10001
33800,-10002,-180027,"(AMETHYSTS, US << MARKET, 10002, 1, 33800)","{""AMETHYSTS"": 16, ""STARFRUIT"": 4}",177,5039,10003
33900,24894,-155133,"(AMETHYSTS, MARKET << US, 10005, 1, 33900)
(AMETHYSTS, MARKET << US, 10005, 1, 33900)
(AMETHYSTS, MARKET << US, 10005, 1, 33900)
(AMETHYSTS, MARKET << US, 10005, 1, 33900)
(STARFRUIT, US << MARKET, 5042, 1, 33900)
(STARFRUIT, US << MARKET, 5042, 1, 33900)
(STARFRUIT, US << MARKET, 5042, 1, 33900)","{""AMETHYSTS"": 12, ""STARFRUIT"": 7}",140,5039,10000
34200,49978,-105155,"(AMETHYSTS, MARKET << US, 9996, 1, 34200)
(AMETHYSTS, MARKET << US, 9996, 1, 34200)
(AMETHYSTS, MARKET << US, 9996, 1, 34200)
(AMETHYSTS, MARKET << US, 9995, 1, 34200)
(AMETHYSTS, MARKET << US, 9995, 1, 34200)
(STARFRUIT, US << MARKET, 5037, 1, 34200)
(STARFRUIT, MARKET << US, 5037, 1, 34200)","{""AMETHYSTS"": 7, ""STARFRUIT"": 7}",125,5040,10000
34300,-20144,-125299,"(STARFRUIT, US << MARKET, 5036, 1, 34300)
(STARFRUIT, US << MARKET, 5036, 1, 34300)
(STARFRUIT, US << MARKET, 5036, 1, 34300)
(STARFRUIT, US << MARKET, 5036, 1, 34300)","{""AMETHYSTS"": 7, ""STARFRUIT"": 11}",130,5039,10000
34400,5037,-120262,"(STARFRUIT, MARKET << US, 5037, 1, 34400)","{""AMETHYSTS"": 7, ""STARFRUIT"": 10}",98,5036,10000
34700,49990,-70272,"(AMETHYSTS, MARKET << US, 9998, 1, 34700)
(AMETHYSTS, MARKET << US, 9998, 1, 34700)
(AMETHYSTS, MARKET << US, 9998, 1, 34700)
(AMETHYSTS, MARKET << US, 9998, 1, 34700)
(AMETHYSTS, MARKET << US, 9998, 1, 34700)","{""AMETHYSTS"": 2, ""STARFRUIT"": 10}",110,5039,9996
34800,-10002,-80274,"(AMETHYSTS, US << MARKET, 10002, 1, 34800)","{""AMETHYSTS"": 3, ""STARFRUIT"": 10}",145,5041,10003
34900,5037,-75237,"(STARFRUIT, MARKET << US, 5037, 1, 34900)","{""AMETHYSTS"": 3, ""STARFRUIT"": 9}",123,5040,10000
35200,-5037,-80274,"(STARFRUIT, US << MARKET, 5037, 1, 35200)","{""AMETHYSTS"": 3, ""STARFRUIT"": 10}",116,5039,10000
35500,5037,-75237,"(STARFRUIT, MARKET << US, 5037, 1, 35500)","{""AMETHYSTS"": 3, ""STARFRUIT"": 9}",132,5040,10003
35600,5038,-70199,"(STARFRUIT, MARKET << US, 5038, 1, 35600)","{""AMETHYSTS"": 3, ""STARFRUIT"": 8}",124,5040,10001
35700,10002,-60197,"(AMETHYSTS, US << MARKET, 10002, 1, 35700)
(AMETHYSTS, MARKET << US, 10002, 1, 35700)
(AMETHYSTS, MARKET << US, 10002, 1, 35700)","{""AMETHYSTS"": 2, ""STARFRUIT"": 8}",129,5040,10003
35900,-5041,-65238,"(STARFRUIT, US << MARKET, 5041, 1, 35900)","{""AMETHYSTS"": 2, ""STARFRUIT"": 9}",102,5038,9999
36000,9998,-55240,"(AMETHYSTS, MARKET << US, 9998, 1, 36000)","{""AMETHYSTS"": 1, ""STARFRUIT"": 9}",107,5039,9996
36500,-19992,-75232,"(AMETHYSTS, US << MARKET, 9996, 1, 36500)
(AMETHYSTS, US << MARKET, 9996, 1, 36500)","{""AMETHYSTS"": 3, ""STARFRUIT"": 9}",107,5038,9999
36700,-15037,-90269,"(AMETHYSTS, US << MARKET, 10002, 1, 36700)
(STARFRUIT, US << MARKET, 5035, 1, 36700)","{""AMETHYSTS"": 4, ""STARFRUIT"": 10}",123,5038,10003
36800,35124,-55145,"(AMETHYSTS, MARKET << US, 10002, 1, 36800)
(AMETHYSTS, MARKET << US, 10002, 1, 36800)
(STARFRUIT, MARKET << US, 5040, 1, 36800)
(STARFRUIT, MARKET << US, 5040, 1, 36800)
(STARFRUIT, MARKET << US, 5040, 1, 36800)","{""AMETHYSTS"": 2, ""STARFRUIT"": 7}",148,5041,10003
37100,-5041,-60186,"(STARFRUIT, US << MARKET, 5041, 1, 37100)","{""AMETHYSTS"": 2, ""STARFRUIT"": 8}",142,5041,10000
37200,9998,-50188,"(AMETHYSTS, MARKET << US, 9998, 1, 37200)","{""AMETHYSTS"": 1, ""STARFRUIT"": 8}",125,5039,10001
37300,90018,39830,"(AMETHYSTS, US << MARKET, 10002, 1, 37300)
(AMETHYSTS, US << MARKET, 10002, 1, 37300)
(AMETHYSTS, US << MARKET, 10002, 1, 37300)
(AMETHYSTS, US << MARKET, 10002, 1, 37300)
(AMETHYSTS, US << MARKET, 10002, 1, 37300)
(AMETHYSTS, MARKET << US, 10002, 1, 37300)
(AMETHYSTS, MARKET << US, 10002, 1, 37300)
(AMETHYSTS, MARKET << US, 10002, 1, 37300)
(AMETHYSTS, MARKET << US, 10002, 1, 37300)
(AMETHYSTS, MARKET << US, 10002, 1, 37300)
(AMETHYSTS, MARKET << US, 10002, 1, 37300)
(AMETHYSTS, MARKET << US, 10002, 1, 37300)
(AMETHYSTS, MARKET << US, 10002, 1, 37300)
(AMETHYSTS, MARKET << US, 10002, 1, 37300)
(AMETHYSTS, MARKET << US, 10002, 1, 37300)
(AMETHYSTS, MARKET << US, 10002, 1, 37300)
(AMETHYSTS, MARKET << US, 10002, 1, 37300)
(AMETHYSTS, MARKET << US, 10002, 1, 37300)
(AMETHYSTS, MARKET << US, 10002, 1, 37300)","{""AMETHYSTS"": -8, ""STARFRUIT"": 8}",126,5040,10003
37400,5038,44868,"(STARFRUIT, MARKET << US, 5038, 1, 37400)","{""AMETHYSTS"": -8, ""STARFRUIT"": 7}",155,5041,10000
37700,5042,49910,"(STARFRUIT, MARKET << US, 5042, 1, 37700)","{""AMETHYSTS"": -8, ""STARFRUIT"": 6}",162,5042,10000
37900,-10086,39824,"(STARFRUIT, US << MARKET, 5043, 1, 37900)
(STARFRUIT, US << MARKET, 5043, 1, 37900)","{""AMETHYSTS"": -8, ""STARFRUIT"": 8}",144,5038,9998
38100,-5038,34786,"(STARFRUIT, US << MARKET, 5038, 1, 38100)","{""AMETHYSTS"": -8, ""STARFRUIT"": 9}",155,5041,10000
38200,-79984,-45198,"(AMETHYSTS, US << MARKET, 9998, 1, 38200)
(AMETHYSTS, US << MARKET, 9998, 1, 38200)
(AMETHYSTS, US << MARKET, 9998, 1, 38200)
(AMETHYSTS, US << MARKET, 9998, 1, 38200)
(AMETHYSTS, US << MARKET, 9998, 1, 38200)
(AMETHYSTS, US << MARKET, 9998, 1, 38200)
(AMETHYSTS, US << MARKET, 9998, 1, 38200)
(AMETHYSTS, US << MARKET, 9998, 1, 38200)
(AMETHYSTS, US << MARKET, 9998, 1, 38200)
(AMETHYSTS, US << MARKET, 9998, 1, 38200)
(AMETHYSTS, MARKET << US, 9998, 1, 38200)
(AMETHYSTS, MARKET << US, 9998, 1, 38200)","{""AMETHYSTS"": 0, ""STARFRUIT"": 9}",171,5041,9996
38400,5039,-40159,"(STARFRUIT, MARKET << US, 5039, 1, 38400)","{""AMETHYSTS"": 0, ""STARFRUIT"": 8}",177,5042,10003
38500,25048,-15111,"(AMETHYSTS, MARKET << US, 10002, 1, 38500)
(AMETHYSTS, MARKET << US, 10002, 1, 38500)
(STARFRUIT, MARKET << US, 5044, 1, 38500)","{""AMETHYSTS"": -2, ""STARFRUIT"": 7}",191,5044,10003
38600,-50010,-65121,"(AMETHYSTS, US << MARKET, 10002, 1, 38600)
(AMETHYSTS, US << MARKET, 10002, 1, 38600)
(AMETHYSTS, US << MARKET, 10002, 1, 38600)
(AMETHYSTS, US << MARKET, 10002, 1, 38600)
(AMETHYSTS, US << MARKET, 10002, 1, 38600)","{""AMETHYSTS"": 3, ""STARFRUIT"": 7}",175,5041,10003
38800,-20168,-85289,"(STARFRUIT, US << MARKET, 5042, 1, 38800)
(STARFRUIT, US << MARKET, 5042, 1, 38800)
(STARFRUIT, US << MARKET, 5042, 1, 38800)
(STARFRUIT, US << MARKET, 5042, 1, 38800)","{""AMETHYSTS"": 3, ""STARFRUIT"": 11}",184,5043,10000
38900,80016,-5273,"(AMETHYSTS, MARKET << US, 10002, 1, 38900)
(AMETHYSTS, MARKET << US, 10002, 1, 38900)
(AMETHYSTS, MARKET << US, 10002, 1, 38900)
(AMETHYSTS, MARKET << US, 10002, 1, 38900)
(AMETHYSTS, MARKET << US, 10002, 1, 38900)
(AMETHYSTS, MARKET << US, 10002, 1, 38900)
(AMETHYSTS, MARKET << US, 10002, 1, 38900)
(AMETHYSTS, MARKET << US, 10002, 1, 38900)","{""AMETHYSTS"": -5, ""STARFRUIT"": 11}",167,5040,10000
39400,25052,19779,"(AMETHYSTS, MARKET << US, 10004, 1, 39400)
(AMETHYSTS, MARKET << US, 10004, 1, 39400)
(STARFRUIT, MARKET << US, 5044, 1, 39400)","{""AMETHYSTS"": -7, ""STARFRUIT"": 10}",189,5041,10000
39600,19868,39647,"(AMETHYSTS, MARKET << US, 10005, 1, 39600)
(AMETHYSTS, MARKET << US, 10005, 1, 39600)
(AMETHYSTS, MARKET << US, 10005, 1, 39600)
(AMETHYSTS, MARKET << US, 10005, 1, 39600)
(STARFRUIT, US << MARKET, 5038, 1, 39600)
(STARFRUIT, US << MARKET, 5038, 1, 39600)
(STARFRUIT, US << MARKET, 5038, 1, 39600)
(STARFRUIT, US << MARKET, 5038, 1, 39600)","{""AMETHYSTS"": -11, ""STARFRUIT"": 14}",221,5041,10000
39700,95090,134737,"(AMETHYSTS, MARKET << US, 10005, 1, 39700)
(AMETHYSTS, MARKET << US, 10005, 1, 39700)
(AMETHYSTS, MARKET << US, 10005, 1, 39700)
(AMETHYSTS, MARKET << US, 10005, 1, 39700)
(AMETHYSTS, MARKET << US, 10005, 1, 39700)
(AMETHYSTS, MARKET << US, 10005, 1, 39700)
(AMETHYSTS, MARKET << US, 10005, 1, 39700)
(AMETHYSTS, MARKET << US, 10005, 1, 39700)
(AMETHYSTS, MARKET << US, 10005, 1, 39700)
(STARFRUIT, MARKET << US, 5045, 1, 39700)","{""AMETHYSTS"": -20, ""STARFRUIT"": 13}",270,5041,10000
40100,-10002,124735,"(AMETHYSTS, US << MARKET, 10002, 1, 40100)","{""AMETHYSTS"": -19, ""STARFRUIT"": 13}",198,5040,10003
40300,-140108,-15373,"(AMETHYSTS, US << MARKET, 9996, 1, 40300)
(AMETHYSTS, US << MARKET, 9996, 1, 40300)
(AMETHYSTS, US << MARKET, 9996, 1, 40300)
(AMETHYSTS, US << MARKET, 9996, 1, 40300)
(AMETHYSTS, US << MARKET, 9996, 1, 40300)
(AMETHYSTS, US << MARKET, 9996, 1, 40300)
(AMETHYSTS, US << MARKET, 9996, 1, 40300)
(AMETHYSTS, US << MARKET, 9996, 1, 40300)
(AMETHYSTS, US << MARKET, 9996, 1, 40300)
(AMETHYSTS, US << MARKET, 9996, 1, 40300)
(AMETHYSTS, US << MARKET, 9996, 1, 40300)
(AMETHYSTS, US << MARKET, 9996, 1, 40300)
(STARFRUIT, US << MARKET, 5039, 1, 40300)
(STARFRUIT, US << MARKET, 5039, 1, 40300)
(STARFRUIT, US << MARKET, 5039, 1, 40300)
(STARFRUIT, US << MARKET, 5039, 1, 40300)","{""AMETHYSTS"": -7, ""STARFRUIT"": 17}",287,5038,9998
40800,-15135,-30508,"(STARFRUIT, US << MARKET, 5045, 1, 40800)
(STARFRUIT, US << MARKET, 5045, 1, 40800)
(STARFRUIT, US << MARKET, 5045, 1, 40800)","{""AMETHYSTS"": -7, ""STARFRUIT"": 20}",312,5041,10000
41200,15129,-15379,"(STARFRUIT, MARKET << US, 5043, 1, 41200)
(STARFRUIT, MARKET << US, 5043, 1, 41200)
(STARFRUIT, MARKET << US, 5043, 1, 41200)","{""AMETHYSTS"": -7, ""STARFRUIT"": 17}",390,5044,9997
41400,5039,-10340,"(STARFRUIT, MARKET << US, 5039, 1, 41400)","{""AMETHYSTS"": -7, ""STARFRUIT"": 16}",332,5042,10000
41500,-30076,-40416,"(AMETHYSTS, US << MARKET, 9998, 1, 41500)
(AMETHYSTS, US << MARKET, 9998, 1, 41500)
(STARFRUIT, US << MARKET, 5040, 1, 41500)
(STARFRUIT, US << MARKET, 5040, 1, 41500)","{""AMETHYSTS"": -5, ""STARFRUIT"": 18}",281,5039,10001
41900,10078,-30338,"(STARFRUIT, MARKET << US, 5039, 1, 41900)
(STARFRUIT, MARKET << US, 5039, 1, 41900)","{""AMETHYSTS"": -5, ""STARFRUIT"": 16}",265,5038,10001
42200,30068,-270,"(AMETHYSTS, MARKET << US, 9995, 1, 42200)
(AMETHYSTS, MARKET << US, 9995, 1, 42200)
(STARFRUIT, MARKET << US, 5039, 1, 42200)
(STARFRUIT, MARKET << US, 5039, 1, 42200)","{""AMETHYSTS"": -7, ""STARFRUIT"": 14}",332,5042,9998
42300,-166,-436,"(AMETHYSTS, MARKET << US, 10005, 1, 42300)
(AMETHYSTS, MARKET << US, 10005, 1, 42300)
(STARFRUIT, US << MARKET, 5044, 1, 42300)
(STARFRUIT, US << MARKET, 5044, 1, 42300)
(STARFRUIT, US << MARKET, 5044, 1, 42300)
(STARFRUIT, US << MARKET, 5044, 1, 42300)","{""AMETHYSTS"": -9, ""STARFRUIT"": 18}",320,5043,10002
42500,-5038,-5474,"(STARFRUIT, US << MARKET, 5038, 1, 42500)","{""AMETHYSTS"": -9, ""STARFRUIT"": 19}",286,5040,10000
42700,-5038,-10512,"(STARFRUIT, US << MARKET, 5038, 1, 42700)","{""AMETHYSTS"": -9, ""STARFRUIT"": 20}",308,5041,10000
43200,20004,9492,"(AMETHYSTS, MARKET << US, 10002, 1, 43200)
(AMETHYSTS, MARKET << US, 10002, 1, 43200)","{""AMETHYSTS"": -11, ""STARFRUIT"": 20}",294,5039,9998
43400,5037,14529,"(STARFRUIT, MARKET << US, 5037, 1, 43400)","{""AMETHYSTS"": -11, ""STARFRUIT"": 19}",300,5040,9999
43800,9998,24527,"(AMETHYSTS, MARKET << US, 9998, 1, 43800)","{""AMETHYSTS"": -12, ""STARFRUIT"": 19}",316,5039,9996
44000,70014,94541,"(AMETHYSTS, MARKET << US, 10002, 1, 44000)
(AMETHYSTS, MARKET << US, 10002, 1, 44000)
(AMETHYSTS, MARKET << US, 10002, 1, 44000)
(AMETHYSTS, MARKET << US, 10002, 1, 44000)
(AMETHYSTS, MARKET << US, 10002, 1, 44000)
(AMETHYSTS, MARKET << US, 10002, 1, 44000)
(AMETHYSTS, MARKET << US, 10002, 1, 44000)","{""AMETHYSTS"": -19, ""STARFRUIT"": 19}",225,5039,10003
44100,9996,104537,"(AMETHYSTS, MARKET << US, 9996, 1, 44100)
(STARFRUIT, US << MARKET, 5036, 1, 44100)
(STARFRUIT, MARKET << US, 5036, 1, 44100)","{""AMETHYSTS"": -20, ""STARFRUIT"": 19}",278,5039,10000
44200,-39992,64545,"(AMETHYSTS, US << MARKET, 9998, 1, 44200)
(AMETHYSTS, US << MARKET, 9998, 1, 44200)
(AMETHYSTS, US << MARKET, 9998, 1, 44200)
(AMETHYSTS, US << MARKET, 9998, 1, 44200)","{""AMETHYSTS"": -16, ""STARFRUIT"": 19}",270,5039,10001
44500,-14956,49589,"(AMETHYSTS, US << MARKET, 9996, 1, 44500)
(AMETHYSTS, US << MARKET, 9996, 1, 44500)
(STARFRUIT, MARKET << US, 5036, 1, 44500)","{""AMETHYSTS"": -14, ""STARFRUIT"": 18}",291,5039,10000
44700,4958,54547,"(AMETHYSTS, MARKET << US, 9996, 1, 44700)
(STARFRUIT, US << MARKET, 5038, 1, 44700)","{""AMETHYSTS"": -15, ""STARFRUIT"": 19}",341,5041,9999
44900,45369,99916,"(STARFRUIT, MARKET << US, 5041, 1, 44900)
(STARFRUIT, MARKET << US, 5041, 1, 44900)
(STARFRUIT, MARKET << US, 5041, 1, 44900)
(STARFRUIT, MARKET << US, 5041, 1, 44900)
(STARFRUIT, MARKET << US, 5041, 1, 44900)
(STARFRUIT, MARKET << US, 5041, 1, 44900)
(STARFRUIT, MARKET << US, 5041, 1, 44900)
(STARFRUIT, MARKET << US, 5041, 1, 44900)
(STARFRUIT, MARKET << US, 5041, 1, 44900)","{""AMETHYSTS"": -15, ""STARFRUIT"": 10}",366,5042,9998
45100,-30070,69846,"(AMETHYSTS, US << MARKET, 9998, 1, 45100)
(AMETHYSTS, US << MARKET, 9998, 1, 45100)
(STARFRUIT, US << MARKET, 5037, 1, 45100)
(STARFRUIT, US << MARKET, 5037, 1, 45100)
(STARFRUIT, US << MARKET, 5037, 1, 45100)
(STARFRUIT, US << MARKET, 5037, 1, 45100)
(STARFRUIT, MARKET << US, 5037, 1, 45100)
(STARFRUIT, MARKET << US, 5037, 1, 45100)","{""AMETHYSTS"": -13, ""STARFRUIT"": 12}",365,5040,9997
45300,-35135,34711,"(AMETHYSTS, US << MARKET, 9998, 1, 45300)
(AMETHYSTS, US << MARKET, 9998, 1, 45300)
(STARFRUIT, US << MARKET, 5044, 1, 45300)
(STARFRUIT, US << MARKET, 5044, 1, 45300)
(STARFRUIT, US << MARKET, 5044, 1, 45300)
(STARFRUIT, US << MARKET, 5044, 1, 45300)
(STARFRUIT, MARKET << US, 5037, 1, 45300)","{""AMETHYSTS"": -11, ""STARFRUIT"": 15}",344,5040,9997
45600,10084,44795,"(STARFRUIT, MARKET << US, 5042, 1, 45600)
(STARFRUIT, MARKET << US, 5042, 1, 45600)","{""AMETHYSTS"": -11, ""STARFRUIT"": 13}",302,5039,10000
46000,-99978,-55183,"(AMETHYSTS, US << MARKET, 9996, 1, 46000)
(AMETHYSTS, US << MARKET, 9996, 1, 46000)
(AMETHYSTS, US << MARKET, 9998, 1, 46000)
(AMETHYSTS, US << MARKET, 9998, 1, 46000)
(AMETHYSTS, US << MARKET, 9998, 1, 46000)
(AMETHYSTS, US << MARKET, 9998, 1, 46000)
(AMETHYSTS, US << MARKET, 9996, 1, 46000)
(AMETHYSTS, US << MARKET, 9998, 1, 46000)
(AMETHYSTS, US << MARKET, 9998, 1, 46000)
(AMETHYSTS, US << MARKET, 9998, 1, 46000)
(AMETHYSTS, US << MARKET, 9998, 1, 46000)
(AMETHYSTS, US << MARKET, 9998, 1, 46000)
(AMETHYSTS, MARKET << US, 9996, 1, 46000)
(AMETHYSTS, MARKET << US, 9996, 1, 46000)","{""AMETHYSTS"": -1, ""STARFRUIT"": 13}",340,5040,9997
46100,-5038,-60221,"(STARFRUIT, US << MARKET, 5038, 1, 46100)","{""AMETHYSTS"": -1, ""STARFRUIT"": 14}",353,5041,10000
46200,40344,-19877,"(STARFRUIT, MARKET << US, 5043, 1, 46200)
(STARFRUIT, MARKET << US, 5043, 1, 46200)
(STARFRUIT, MARKET << US, 5043, 1, 46200)
(STARFRUIT, MARKET << US, 5043, 1, 46200)
(STARFRUIT, MARKET << US, 5043, 1, 46200)
(STARFRUIT, MARKET << US, 5043, 1, 46200)
(STARFRUIT, MARKET << US, 5043, 1, 46200)
(STARFRUIT, MARKET << US, 5043, 1, 46200)","{""AMETHYSTS"": -1, ""STARFRUIT"": 6}",387,5044,10000
46300,5044,-14833,"(STARFRUIT, MARKET << US, 5044, 1, 46300)","{""AMETHYSTS"": -1, ""STARFRUIT"": 5}",372,5041,10000
46400,25215,10382,"(STARFRUIT, MARKET << US, 5043, 1, 46400)
(STARFRUIT, MARKET << US, 5043, 1, 46400)
(STARFRUIT, MARKET << US, 5043, 1, 46400)
(STARFRUIT, MARKET << US, 5043, 1, 46400)
(STARFRUIT, MARKET << US, 5043, 1, 46400)","{""AMETHYSTS"": -1, ""STARFRUIT"": 0}",382,5044,10000
46500,10076,20458,"(STARFRUIT, MARKET << US, 5038, 1, 46500)
(STARFRUIT, MARKET << US, 5038, 1, 46500)","{""AMETHYSTS"": -1, ""STARFRUIT"": -2}",377,5041,9999
46800,5204,25662,"(AMETHYSTS, US << MARKET, 9998, 1, 46800)
(AMETHYSTS, US << MARKET, 9998, 1, 46800)
(STARFRUIT, MARKET << US, 5040, 1, 46800)
(STARFRUIT, MARKET << US, 5040, 1, 46800)
(STARFRUIT, MARKET << US, 5040, 1, 46800)
(STARFRUIT, MARKET << US, 5040, 1, 46800)
(STARFRUIT, MARKET << US, 5040, 1, 46800)","{""AMETHYSTS"": 1, ""STARFRUIT"": -7}",390,5039,10001
46900,5044,30706,"(STARFRUIT, MARKET << US, 5044, 1, 46900)","{""AMETHYSTS"": 1, ""STARFRUIT"": -8}",354,5044,10000
47000,-166,30540,"(AMETHYSTS, MARKET << US, 9995, 1, 47000)
(AMETHYSTS, MARKET << US, 9995, 1, 47000)
(STARFRUIT, US << MARKET, 5039, 1, 47000)
(STARFRUIT, US << MARKET, 5039, 1, 47000)
(STARFRUIT, US << MARKET, 5039, 1, 47000)
(STARFRUIT, US << MARKET, 5039, 1, 47000)","{""AMETHYSTS"": -1, ""STARFRUIT"": -4}",374,5042,9998
47100,5039,35579,"(STARFRUIT, MARKET << US, 5039, 1, 47100)","{""AMETHYSTS"": -1, ""STARFRUIT"": -5}",373,5041,10001
47200,-35301,278,"(STARFRUIT, US << MARKET, 5043, 1, 47200)
(STARFRUIT, US << MARKET, 5043, 1, 47200)
(STARFRUIT, US << MARKET, 5043, 1, 47200)
(STARFRUIT, US << MARKET, 5043, 1, 47200)
(STARFRUIT, US << MARKET, 5043, 1, 47200)
(STARFRUIT, US << MARKET, 5043, 1, 47200)
(STARFRUIT, US << MARKET, 5043, 1, 47200)","{""AMETHYSTS"": -1, ""STARFRUIT"": 2}",366,5044,10000
47600,30064,30342,"(AMETHYSTS, MARKET << US, 9995, 1, 47600)
(AMETHYSTS, MARKET << US, 9995, 1, 47600)
(STARFRUIT, MARKET << US, 5037, 1, 47600)
(STARFRUIT, MARKET << US, 5037, 1, 47600)","{""AMETHYSTS"": -3, ""STARFRUIT"": 0}",342,5040,10000
47700,-19996,10346,"(AMETHYSTS, US << MARKET, 9998, 1, 47700)
(AMETHYSTS, US << MARKET, 9998, 1, 47700)","{""AMETHYSTS"": -1, ""STARFRUIT"": 0}",349,5039,9997
48300,5043,15389,"(STARFRUIT, MARKET << US, 5043, 1, 48300)","{""AMETHYSTS"": -1, ""STARFRUIT"": -1}",346,5043,10000
48400,15132,30521,"(STARFRUIT, MARKET << US, 5044, 1, 48400)
(STARFRUIT, MARKET << US, 5044, 1, 48400)
(STARFRUIT, MARKET << US, 5044, 1, 48400)","{""AMETHYSTS"": -1, ""STARFRUIT"": -4}",349,5043,10000
48700,40008,70529,"(AMETHYSTS, MARKET << US, 10002, 1, 48700)
(AMETHYSTS, MARKET << US, 10002, 1, 48700)
(AMETHYSTS, MARKET << US, 10002, 1, 48700)
(AMETHYSTS, MARKET << US, 10002, 1, 48700)","{""AMETHYSTS"": -5, ""STARFRUIT"": -4}",358,5039,10003
48900,5036,75565,"(STARFRUIT, MARKET << US, 5036, 1, 48900)","{""AMETHYSTS"": -5, ""STARFRUIT"": -5}",365,5039,10001
49100,-144,75421,"(AMETHYSTS, MARKET << US, 9998, 1, 49100)
(AMETHYSTS, MARKET << US, 9998, 1, 49100)
(STARFRUIT, US << MARKET, 5035, 1, 49100)
(STARFRUIT, US << MARKET, 5035, 1, 49100)
(STARFRUIT, US << MARKET, 5035, 1, 49100)
(STARFRUIT, US << MARKET, 5035, 1, 49100)","{""AMETHYSTS"": -7, ""STARFRUIT"": -1}",376,5038,10001
49300,5040,80461,"(STARFRUIT, MARKET << US, 5040, 1, 49300)","{""AMETHYSTS"": -7, ""STARFRUIT"": -2}",381,5040,10000
49700,-10002,70459,"(AMETHYSTS, US << MARKET, 10002, 1, 49700)","{""AMETHYSTS"": -6, ""STARFRUIT"": -2}",387,5039,9999
49800,9998,80457,"(AMETHYSTS, MARKET << US, 9998, 1, 49800)","{""AMETHYSTS"": -7, ""STARFRUIT"": -2}",400,5039,9997
49900,20004,100461,"(AMETHYSTS, MARKET << US, 10002, 1, 49900)
(AMETHYSTS, MARKET << US, 10002, 1, 49900)","{""AMETHYSTS"": -9, ""STARFRUIT"": -2}",381,5040,10000
50100,-50260,50201,"(AMETHYSTS, US << MARKET, 10004, 1, 50100)
(AMETHYSTS, US << MARKET, 10004, 1, 50100)
(STARFRUIT, US << MARKET, 5042, 1, 50100)
(STARFRUIT, US << MARKET, 5042, 1, 50100)
(STARFRUIT, US << MARKET, 5042, 1, 50100)
(STARFRUIT, US << MARKET, 5042, 1, 50100)
(STARFRUIT, US << MARKET, 5042, 1, 50100)
(STARFRUIT, US << MARKET, 5042, 1, 50100)","{""AMETHYSTS"": -7, ""STARFRUIT"": 4}",369,5042,10000
50300,20004,70205,"(AMETHYSTS, MARKET << US, 10002, 1, 50300)
(AMETHYSTS, MARKET << US, 10002, 1, 50300)","{""AMETHYSTS"": -9, ""STARFRUIT"": 4}",382,5042,9999
50400,-40008,30197,"(AMETHYSTS, US << MARKET, 10002, 1, 50400)
(AMETHYSTS, US << MARKET, 10002, 1, 50400)
(AMETHYSTS, US << MARKET, 10002, 1, 50400)
(AMETHYSTS, US << MARKET, 10002, 1, 50400)","{""AMETHYSTS"": -5, ""STARFRUIT"": 4}",338,5039,10003
50600,5041,35238,"(STARFRUIT, MARKET << US, 5041, 1, 50600)","{""AMETHYSTS"": -5, ""STARFRUIT"": 3}",364,5042,10000
50800,9998,45236,"(AMETHYSTS, MARKET << US, 9998, 1, 50800)","{""AMETHYSTS"": -6, ""STARFRUIT"": 3}",380,5040,9996
51300,-15114,30122,"(STARFRUIT, US << MARKET, 5038, 1, 51300)
(STARFRUIT, US << MARKET, 5038, 1, 51300)
(STARFRUIT, US << MARKET, 5038, 1, 51300)
(STARFRUIT, US << MARKET, 5038, 1, 51300)
(STARFRUIT, US << MARKET, 5038, 1, 51300)
(STARFRUIT, MARKET << US, 5038, 1, 51300)
(STARFRUIT, MARKET << US, 5038, 1, 51300)","{""AMETHYSTS"": -6, ""STARFRUIT"": 6}",368,5041,10000
51600,10076,40198,"(STARFRUIT, MARKET << US, 5038, 1, 51600)
(STARFRUIT, MARKET << US, 5038, 1, 51600)","{""AMETHYSTS"": -6, ""STARFRUIT"": 4}",358,5040,10000
52000,0,40198,"(STARFRUIT, US << MARKET, 5038, 1, 52000)
(STARFRUIT, US << MARKET, 5038, 1, 52000)
(STARFRUIT, US << MARKET, 5038, 1, 52000)
(STARFRUIT, US << MARKET, 5038, 1, 52000)
(STARFRUIT, MARKET << US, 5038, 1, 52000)
(STARFRUIT, MARKET << US, 5038, 1, 52000)
(STARFRUIT, MARKET << US, 5038, 1, 52000)
(STARFRUIT, MARKET << US, 5038, 1, 52000)","{""AMETHYSTS"": -6, ""STARFRUIT"": 4}",334,5037,10002
52300,2,40200,"(STARFRUIT, US << MARKET, 5042, 1, 52300)
(STARFRUIT, US << MARKET, 5042, 1, 52300)
(STARFRUIT, MARKET << US, 5043, 1, 52300)
(STARFRUIT, MARKET << US, 5043, 1, 52300)","{""AMETHYSTS"": -6, ""STARFRUIT"": 4}",360,5037,9998
52600,-20148,20052,"(STARFRUIT, US << MARKET, 5037, 1, 52600)
(STARFRUIT, US << MARKET, 5037, 1, 52600)
(STARFRUIT, US << MARKET, 5037, 1, 52600)
(STARFRUIT, US << MARKET, 5037, 1, 52600)","{""AMETHYSTS"": -6, ""STARFRUIT"": 8}",390,5040,9997
52700,10068,30120,"(AMETHYSTS, US << MARKET, 9998, 1, 52700)
(AMETHYSTS, US << MARKET, 9998, 1, 52700)
(AMETHYSTS, MARKET << US, 9995, 1, 52700)
(AMETHYSTS, MARKET << US, 9995, 1, 52700)
(STARFRUIT, MARKET << US, 5037, 1, 52700)
(STARFRUIT, MARKET << US, 5037, 1, 52700)","{""AMETHYSTS"": -6, ""STARFRUIT"": 6}",384,5040,9996
53200,25215,55335,"(STARFRUIT, MARKET << US, 5043, 1, 53200)
(STARFRUIT, MARKET << US, 5043, 1, 53200)
(STARFRUIT, MARKET << US, 5043, 1, 53200)
(STARFRUIT, MARKET << US, 5043, 1, 53200)
(STARFRUIT, MARKET << US, 5043, 1, 53200)","{""AMETHYSTS"": -6, ""STARFRUIT"": 1}",392,5039,9997
53400,-10074,45261,"(STARFRUIT, US << MARKET, 5037, 1, 53400)
(STARFRUIT, US << MARKET, 5037, 1, 53400)","{""AMETHYSTS"": -6, ""STARFRUIT"": 3}",381,5040,10000
53500,20148,65409,"(STARFRUIT, MARKET << US, 5037, 1, 53500)
(STARFRUIT, MARKET << US, 5037, 1, 53500)
(STARFRUIT, MARKET << US, 5037, 1, 53500)
(STARFRUIT, MARKET << US, 5037, 1, 53500)","{""AMETHYSTS"": -6, ""STARFRUIT"": -1}",376,5039,9999
53600,-50068,15341,"(AMETHYSTS, US << MARKET, 9998, 1, 53600)
(AMETHYSTS, US << MARKET, 9998, 1, 53600)
(AMETHYSTS, US << MARKET, 9998, 1, 53600)
(AMETHYSTS, US << MARKET, 9998, 1, 53600)
(STARFRUIT, US << MARKET, 5038, 1, 53600)
(STARFRUIT, US << MARKET, 5038, 1, 53600)","{""AMETHYSTS"": -2, ""STARFRUIT"": 1}",380,5041,10001
53900,5025,20366,"(STARFRUIT, US << MARKET, 5043, 1, 53900)
(STARFRUIT, US << MARKET, 5043, 1, 53900)
(STARFRUIT, MARKET << US, 5037, 1, 53900)
(STARFRUIT, MARKET << US, 5037, 1, 53900)
(STARFRUIT, MARKET << US, 5037, 1, 53900)","{""AMETHYSTS"": -2, ""STARFRUIT"": 0}",366,5039,10000
54400,-10076,10290,"(STARFRUIT, US << MARKET, 5038, 1, 54400)
(STARFRUIT, US << MARKET, 5038, 1, 54400)","{""AMETHYSTS"": -2, ""STARFRUIT"": 2}",372,5041,10000
54500,-10076,214,"(STARFRUIT, US << MARKET, 5038, 1, 54500)
(STARFRUIT, US << MARKET, 5038, 1, 54500)","{""AMETHYSTS"": -2, ""STARFRUIT"": 4}",382,5041,9998
54700,-19996,-19782,"(AMETHYSTS, US << MARKET, 9998, 1, 54700)
(AMETHYSTS, US << MARKET, 9998, 1, 54700)","{""AMETHYSTS"": 0, ""STARFRUIT"": 4}",382,5041,10001
55000,160,-19622,"(AMETHYSTS, US << MARKET, 9998, 1, 55000)
(AMETHYSTS, US << MARKET, 9998, 1, 55000)
(STARFRUIT, MARKET << US, 5039, 1, 55000)
(STARFRUIT, MARKET << US, 5039, 1, 55000)
(STARFRUIT, MARKET << US, 5039, 1, 55000)
(STARFRUIT, MARKET << US, 5039, 1, 55000)","{""AMETHYSTS"": 2, ""STARFRUIT"": 0}",370,5039,9996
56600,-10004,-29626,"(AMETHYSTS, US << MARKET, 10004, 1, 56600)","{""AMETHYSTS"": 3, ""STARFRUIT"": 0}",374,5041,10000
56700,5038,-24588,"(STARFRUIT, MARKET << US, 5038, 1, 56700)","{""AMETHYSTS"": 3, ""STARFRUIT"": -1}",375,5037,10000
56800,5038,-19550,"(STARFRUIT, MARKET << US, 5038, 1, 56800)","{""AMETHYSTS"": 3, ""STARFRUIT"": -2}",368,5041,10000
57000,-158,-19708,"(AMETHYSTS, MARKET << US, 9995, 1, 57000)
(AMETHYSTS, MARKET << US, 9995, 1, 57000)
(STARFRUIT, US << MARKET, 5037, 1, 57000)
(STARFRUIT, US << MARKET, 5037, 1, 57000)
(STARFRUIT, US << MARKET, 5037, 1, 57000)
(STARFRUIT, US << MARKET, 5037, 1, 57000)
(STARFRUIT, US << MARKET, 5037, 1, 57000)
(STARFRUIT, US << MARKET, 5037, 1, 57000)
(STARFRUIT, MARKET << US, 5037, 1, 57000)
(STARFRUIT, MARKET << US, 5037, 1, 57000)","{""AMETHYSTS"": 1, ""STARFRUIT"": 2}",372,5040,10000
57300,20004,296,"(AMETHYSTS, MARKET << US, 10002, 1, 57300)
(AMETHYSTS, MARKET << US, 10002, 1, 57300)","{""AMETHYSTS"": -1, ""STARFRUIT"": 2}",375,5041,10003
57400,5038,5334,"(STARFRUIT, MARKET << US, 5038, 1, 57400)","{""AMETHYSTS"": -1, ""STARFRUIT"": 1}",375,5040,9999
58000,-10082,-4748,"(STARFRUIT, US << MARKET, 5041, 1, 58000)
(STARFRUIT, US << MARKET, 5041, 1, 58000)","{""AMETHYSTS"": -1, ""STARFRUIT"": 3}",377,5042,10001
58100,-10074,-14822,"(STARFRUIT, US << MARKET, 5037, 1, 58100)
(STARFRUIT, US << MARKET, 5037, 1, 58100)","{""AMETHYSTS"": -1, ""STARFRUIT"": 5}",383,5041,10000
58400,20160,5338,"(STARFRUIT, MARKET << US, 5040, 1, 58400)
(STARFRUIT, MARKET << US, 5040, 1, 58400)
(STARFRUIT, MARKET << US, 5040, 1, 58400)
(STARFRUIT, MARKET << US, 5040, 1, 58400)","{""AMETHYSTS"": -1, ""STARFRUIT"": 1}",379,5038,9997
58800,-19996,-14658,"(AMETHYSTS, US << MARKET, 9998, 1, 58800)
(AMETHYSTS, US << MARKET, 9998, 1, 58800)","{""AMETHYSTS"": 1, ""STARFRUIT"": 1}",383,5040,10001
58900,9998,-4660,"(AMETHYSTS, MARKET << US, 9998, 1, 58900)","{""AMETHYSTS"": 0, ""STARFRUIT"": 1}",380,5040,9996
59000,89982,85322,"(AMETHYSTS, MARKET << US, 9998, 1, 59000)
(AMETHYSTS, MARKET << US, 9998, 1, 59000)
(AMETHYSTS, MARKET << US, 9998, 1, 59000)
(AMETHYSTS, MARKET << US, 9998, 1, 59000)
(AMETHYSTS, MARKET << US, 9998, 1, 59000)
(AMETHYSTS, MARKET << US, 9998, 1, 59000)
(AMETHYSTS, MARKET << US, 9998, 1, 59000)
(AMETHYSTS, MARKET << US, 9998, 1, 59000)
(AMETHYSTS, MARKET << US, 9998, 1, 59000)","{""AMETHYSTS"": -9, ""STARFRUIT"": 1}",363,5041,10000
59100,-39992,45330,"(AMETHYSTS, US << MARKET, 9998, 1, 59100)
(AMETHYSTS, US << MARKET, 9998, 1, 59100)
(AMETHYSTS, US << MARKET, 9998, 1, 59100)
(AMETHYSTS, US << MARKET, 9998, 1, 59100)","{""AMETHYSTS"": -5, ""STARFRUIT"": 1}",390,5040,9996
59300,-29994,15336,"(AMETHYSTS, US << MARKET, 9998, 1, 59300)
(AMETHYSTS, US << MARKET, 9998, 1, 59300)
(AMETHYSTS, US << MARKET, 9998, 1, 59300)
(AMETHYSTS, US << MARKET, 9998, 1, 59300)
(AMETHYSTS, MARKET << US, 9998, 1, 59300)","{""AMETHYSTS"": -2, ""STARFRUIT"": 1}",383,5041,9997
59400,60012,75348,"(AMETHYSTS, MARKET << US, 10002, 1, 59400)
(AMETHYSTS, MARKET << US, 10002, 1, 59400)
(AMETHYSTS, MARKET << US, 10002, 1, 59400)
(AMETHYSTS, MARKET << US, 10002, 1, 59400)
(AMETHYSTS, MARKET << US, 10002, 1, 59400)
(AMETHYSTS, MARKET << US, 10002, 1, 59400)","{""AMETHYSTS"": -8, ""STARFRUIT"": 1}",387,5039,10000
59800,-25200,50148,"(STARFRUIT, US << MARKET, 5040, 1, 59800)
(STARFRUIT, US << MARKET, 5040, 1, 59800)
(STARFRUIT, US << MARKET, 5040, 1, 59800)
(STARFRUIT, US << MARKET, 5040, 1, 59800)
(STARFRUIT, US << MARKET, 5040, 1, 59800)","{""AMETHYSTS"": -8, ""STARFRUIT"": 6}",382,5039,10000
59900,19926,70074,"(AMETHYSTS, US << MARKET, 10002, 1, 59900)
(AMETHYSTS, MARKET << US, 10004, 1, 59900)
(AMETHYSTS, MARKET << US, 10004, 1, 59900)
(AMETHYSTS, MARKET << US, 10004, 1, 59900)
(AMETHYSTS, MARKET << US, 10004, 1, 59900)
(STARFRUIT, US << MARKET, 5044, 1, 59900)
(STARFRUIT, US << MARKET, 5044, 1, 59900)","{""AMETHYSTS"": -11, ""STARFRUIT"": 8}",369,5041,10003
60100,40226,110300,"(AMETHYSTS, MARKET << US, 9998, 1, 60100)
(STARFRUIT, MARKET << US, 5038, 1, 60100)
(STARFRUIT, MARKET << US, 5038, 1, 60100)
(STARFRUIT, MARKET << US, 5038, 1, 60100)
(STARFRUIT, MARKET << US, 5038, 1, 60100)
(STARFRUIT, MARKET << US, 5038, 1, 60100)
(STARFRUIT, MARKET << US, 5038, 1, 60100)","{""AMETHYSTS"": -12, ""STARFRUIT"": 2}",422,5037,9996
60200,9998,120298,"(AMETHYSTS, MARKET << US, 9998, 1, 60200)","{""AMETHYSTS"": -13, ""STARFRUIT"": 2}",356,5042,10002
60400,-39992,80306,"(AMETHYSTS, US << MARKET, 9998, 1, 60400)
(AMETHYSTS, US << MARKET, 9998, 1, 60400)
(AMETHYSTS, US << MARKET, 9998, 1, 60400)
(AMETHYSTS, US << MARKET, 9998, 1, 60400)","{""AMETHYSTS"": -9, ""STARFRUIT"": 2}",370,5041,10002
60500,-15189,65117,"(AMETHYSTS, MARKET << US, 9996, 1, 60500)
(STARFRUIT, US << MARKET, 5037, 1, 60500)
(STARFRUIT, US << MARKET, 5037, 1, 60500)
(STARFRUIT, US << MARKET, 5037, 1, 60500)
(STARFRUIT, US << MARKET, 5037, 1, 60500)
(STARFRUIT, US << MARKET, 5037, 1, 60500)","{""AMETHYSTS"": -10, ""STARFRUIT"": 7}",397,5040,10000
61000,-4966,60151,"(AMETHYSTS, US << MARKET, 10004, 1, 61000)
(STARFRUIT, MARKET << US, 5038, 1, 61000)","{""AMETHYSTS"": -9, ""STARFRUIT"": 6}",373,5037,10000
61100,-20176,39975,"(STARFRUIT, US << MARKET, 5044, 1, 61100)
(STARFRUIT, US << MARKET, 5044, 1, 61100)
(STARFRUIT, US << MARKET, 5044, 1, 61100)
(STARFRUIT, US << MARKET, 5044, 1, 61100)","{""AMETHYSTS"": -9, ""STARFRUIT"": 10}",375,5040,10000
61500,-60012,-20037,"(AMETHYSTS, US << MARKET, 10002, 1, 61500)
(AMETHYSTS, US << MARKET, 10002, 1, 61500)
(AMETHYSTS, US << MARKET, 10002, 1, 61500)
(AMETHYSTS, US << MARKET, 10002, 1, 61500)
(AMETHYSTS, US << MARKET, 10002, 1, 61500)
(AMETHYSTS, US << MARKET, 10002, 1, 61500)","{""AMETHYSTS"": -3, ""STARFRUIT"": 10}",354,5040,10003
62200,5038,-14999,"(STARFRUIT, MARKET << US, 5038, 1, 62200)","{""AMETHYSTS"": -3, ""STARFRUIT"": 9}",331,5037,10001
62800,49980,34981,"(AMETHYSTS, US << MARKET, 9996, 1, 62800)
(AMETHYSTS, US << MARKET, 9996, 1, 62800)
(AMETHYSTS, MARKET << US, 9996, 1, 62800)
(AMETHYSTS, MARKET << US, 9996, 1, 62800)
(AMETHYSTS, MARKET << US, 9996, 1, 62800)
(AMETHYSTS, MARKET << US, 9996, 1, 62800)
(AMETHYSTS, MARKET << US, 9996, 1, 62800)
(AMETHYSTS, MARKET << US, 9996, 1, 62800)
(AMETHYSTS, MARKET << US, 9996, 1, 62800)","{""AMETHYSTS"": -8, ""STARFRUIT"": 9}",341,5040,10000
62900,14966,49947,"(AMETHYSTS, MARKET << US, 10004, 1, 62900)
(AMETHYSTS, MARKET << US, 10004, 1, 62900)
(STARFRUIT, US << MARKET, 5042, 1, 62900)","{""AMETHYSTS"": -10, ""STARFRUIT"": 10}",337,5039,10000
63500,-19996,29951,"(AMETHYSTS, US << MARKET, 9998, 1, 63500)
(AMETHYSTS, US << MARKET, 9998, 1, 63500)","{""AMETHYSTS"": -8, ""STARFRUIT"": 10}",375,5040,9997
63700,-14959,14992,"(AMETHYSTS, US << MARKET, 9998, 1, 63700)
(AMETHYSTS, US << MARKET, 9998, 1, 63700)
(STARFRUIT, MARKET << US, 5037, 1, 63700)","{""AMETHYSTS"": -6, ""STARFRUIT"": 9}",346,5040,10001
63800,-5036,9956,"(STARFRUIT, US << MARKET, 5036, 1, 63800)","{""AMETHYSTS"": -6, ""STARFRUIT"": 10}",346,5039,10000
63900,5036,14992,"(STARFRUIT, MARKET << US, 5036, 1, 63900)","{""AMETHYSTS"": -6, ""STARFRUIT"": 9}",364,5040,9998
64600,-5036,9956,"(STARFRUIT, US << MARKET, 5036, 1, 64600)","{""AMETHYSTS"": -6, ""STARFRUIT"": 10}",336,5038,10000
64900,-5036,4920,"(STARFRUIT, US << MARKET, 5036, 1, 64900)","{""AMETHYSTS"": -6, ""STARFRUIT"": 11}",349,5039,10000
65100,25048,29968,"(AMETHYSTS, MARKET << US, 10004, 1, 65100)
(AMETHYSTS, MARKET << US, 10004, 1, 65100)
(STARFRUIT, MARKET << US, 5040, 1, 65100)","{""AMETHYSTS"": -8, ""STARFRUIT"": 10}",340,5038,10001
65300,-25121,4847,"(AMETHYSTS, US << MARKET, 10002, 1, 65300)
(STARFRUIT, US << MARKET, 5040, 1, 65300)
(STARFRUIT, US << MARKET, 5040, 1, 65300)
(STARFRUIT, US << MARKET, 5040, 1, 65300)
(STARFRUIT, US << MARKET, 5040, 1, 65300)
(STARFRUIT, MARKET << US, 5041, 1, 65300)","{""AMETHYSTS"": -7, ""STARFRUIT"": 13}",359,5041,10003
65400,9998,14845,"(AMETHYSTS, MARKET << US, 9998, 1, 65400)","{""AMETHYSTS"": -8, ""STARFRUIT"": 13}",363,5038,9997
66000,20070,34915,"(AMETHYSTS, MARKET << US, 9996, 1, 66000)
(STARFRUIT, MARKET << US, 5037, 1, 66000)
(STARFRUIT, MARKET << US, 5037, 1, 66000)","{""AMETHYSTS"": -9, ""STARFRUIT"": 11}",382,5040,9997
66100,-140116,-105201,"(AMETHYSTS, US << MARKET, 9995, 1, 66100)
(AMETHYSTS, US << MARKET, 9995, 1, 66100)
(AMETHYSTS, US << MARKET, 9995, 1, 66100)
(AMETHYSTS, US << MARKET, 9995, 1, 66100)
(AMETHYSTS, US << MARKET, 9995, 1, 66100)
(AMETHYSTS, US << MARKET, 9995, 1, 66100)
(AMETHYSTS, US << MARKET, 9995, 1, 66100)
(AMETHYSTS, US << MARKET, 9995, 1, 66100)
(AMETHYSTS, US << MARKET, 9995, 1, 66100)
(AMETHYSTS, US << MARKET, 9995, 1, 66100)
(AMETHYSTS, US << MARKET, 9995, 1, 66100)
(AMETHYSTS, US << MARKET, 9995, 1, 66100)
(STARFRUIT, US << MARKET, 5044, 1, 66100)
(STARFRUIT, US << MARKET, 5044, 1, 66100)
(STARFRUIT, US << MARKET, 5044, 1, 66100)
(STARFRUIT, US << MARKET, 5044, 1, 66100)","{""AMETHYSTS"": 3, ""STARFRUIT"": 15}",399,5040,10000
66500,-5037,-110238,"(STARFRUIT, US << MARKET, 5037, 1, 66500)","{""AMETHYSTS"": 3, ""STARFRUIT"": 16}",402,5040,10000
66600,35266,-74972,"(STARFRUIT, US << MARKET, 5038, 1, 66600)
(STARFRUIT, MARKET << US, 5038, 1, 66600)
(STARFRUIT, MARKET << US, 5038, 1, 66600)
(STARFRUIT, MARKET << US, 5038, 1, 66600)
(STARFRUIT, MARKET << US, 5038, 1, 66600)
(STARFRUIT, MARKET << US, 5038, 1, 66600)
(STARFRUIT, MARKET << US, 5038, 1, 66600)
(STARFRUIT, MARKET << US, 5038, 1, 66600)
(STARFRUIT, MARKET << US, 5038, 1, 66600)","{""AMETHYSTS"": 3, ""STARFRUIT"": 9}",391,5041,9998
67000,80016,5044,"(AMETHYSTS, MARKET << US, 10002, 1, 67000)
(AMETHYSTS, MARKET << US, 10002, 1, 67000)
(AMETHYSTS, MARKET << US, 10002, 1, 67000)
(AMETHYSTS, MARKET << US, 10002, 1, 67000)
(AMETHYSTS, MARKET << US, 10002, 1, 67000)
(AMETHYSTS, MARKET << US, 10002, 1, 67000)
(AMETHYSTS, MARKET << US, 10002, 1, 67000)
(AMETHYSTS, MARKET << US, 10002, 1, 67000)","{""AMETHYSTS"": -5, ""STARFRUIT"": 9}",380,5039,10003
67100,-19992,-14948,"(AMETHYSTS, US << MARKET, 9996, 1, 67100)
(AMETHYSTS, US << MARKET, 9996, 1, 67100)","{""AMETHYSTS"": -3, ""STARFRUIT"": 9}",379,5036,9999
67700,50268,35320,"(AMETHYSTS, MARKET << US, 10002, 1, 67700)
(AMETHYSTS, MARKET << US, 10002, 1, 67700)
(STARFRUIT, MARKET << US, 5044, 1, 67700)
(STARFRUIT, MARKET << US, 5044, 1, 67700)
(STARFRUIT, MARKET << US, 5044, 1, 67700)
(STARFRUIT, MARKET << US, 5044, 1, 67700)
(STARFRUIT, MARKET << US, 5044, 1, 67700)
(STARFRUIT, MARKET << US, 5044, 1, 67700)","{""AMETHYSTS"": -5, ""STARFRUIT"": 3}",425,5040,10003
67900,-25205,10115,"(STARFRUIT, US << MARKET, 5041, 1, 67900)
(STARFRUIT, US << MARKET, 5041, 1, 67900)
(STARFRUIT, US << MARKET, 5041, 1, 67900)
(STARFRUIT, US << MARKET, 5041, 1, 67900)
(STARFRUIT, US << MARKET, 5041, 1, 67900)","{""AMETHYSTS"": -5, ""STARFRUIT"": 8}",456,5042,9999
69200,-20144,-10029,"(STARFRUIT, US << MARKET, 5036, 1, 69200)
(STARFRUIT, US << MARKET, 5036, 1, 69200)
(STARFRUIT, US << MARKET, 5036, 1, 69200)
(STARFRUIT, US << MARKET, 5036, 1, 69200)","{""AMETHYSTS"": -5, ""STARFRUIT"": 12}",396,5035,9999
69400,80016,69987,"(AMETHYSTS, MARKET << US, 10002, 1, 69400)
(AMETHYSTS, MARKET << US, 10002, 1, 69400)
(AMETHYSTS, MARKET << US, 10002, 1, 69400)
(AMETHYSTS, MARKET << US, 10002, 1, 69400)
(AMETHYSTS, MARKET << US, 10002, 1, 69400)
(AMETHYSTS, MARKET << US, 10002, 1, 69400)
(AMETHYSTS, MARKET << US, 10002, 1, 69400)
(AMETHYSTS, MARKET << US, 10002, 1, 69400)","{""AMETHYSTS"": -13, ""STARFRUIT"": 12}",392,5037,10003
69500,10002,79989,"(AMETHYSTS, US << MARKET, 10002, 1, 69500)
(AMETHYSTS, MARKET << US, 10002, 1, 69500)
(AMETHYSTS, MARKET << US, 10002, 1, 69500)","{""AMETHYSTS"": -14, ""STARFRUIT"": 12}",367,5035,10003
69600,4912,84901,"(AMETHYSTS, MARKET << US, 10002, 1, 69600)
(AMETHYSTS, MARKET << US, 10002, 1, 69600)
(STARFRUIT, US << MARKET, 5033, 1, 69600)
(STARFRUIT, US << MARKET, 5033, 1, 69600)
(STARFRUIT, US << MARKET, 5033, 1, 69600)
(STARFRUIT, US << MARKET, 5033, 1, 69600)
(STARFRUIT, MARKET << US, 5040, 1, 69600)","{""AMETHYSTS"": -16, ""STARFRUIT"": 15}",457,5036,9999
69800,-5034,79867,"(STARFRUIT, US << MARKET, 5034, 1, 69800)","{""AMETHYSTS"": -16, ""STARFRUIT"": 16}",459,5037,10000
69900,-20164,59703,"(STARFRUIT, US << MARKET, 5041, 1, 69900)
(STARFRUIT, US << MARKET, 5041, 1, 69900)
(STARFRUIT, US << MARKET, 5041, 1, 69900)
(STARFRUIT, US << MARKET, 5041, 1, 69900)","{""AMETHYSTS"": -16, ""STARFRUIT"": 20}",463,5038,10000
70200,15108,74811,"(STARFRUIT, MARKET << US, 5036, 1, 70200)
(STARFRUIT, MARKET << US, 5036, 1, 70200)
(STARFRUIT, MARKET << US, 5036, 1, 70200)","{""AMETHYSTS"": -16, ""STARFRUIT"": 17}",421,5034,9998
70400,-50010,24801,"(AMETHYSTS, US << MARKET, 10002, 1, 70400)
(AMETHYSTS, US << MARKET, 10002, 1, 70400)
(AMETHYSTS, US << MARKET, 10002, 1, 70400)
(AMETHYSTS, US << MARKET, 10002, 1, 70400)
(AMETHYSTS, US << MARKET, 10002, 1, 70400)","{""AMETHYSTS"": -11, ""STARFRUIT"": 17}",424,5036,9999
70600,19992,44793,"(AMETHYSTS, MARKET << US, 9996, 1, 70600)
(AMETHYSTS, MARKET << US, 9996, 1, 70600)","{""AMETHYSTS"": -13, ""STARFRUIT"": 17}",456,5039,10000
70700,29928,74721,"(AMETHYSTS, MARKET << US, 10002, 1, 70700)
(AMETHYSTS, MARKET << US, 10002, 1, 70700)
(AMETHYSTS, MARKET << US, 10002, 1, 70700)
(AMETHYSTS, MARKET << US, 10002, 1, 70700)
(STARFRUIT, US << MARKET, 5040, 1, 70700)
(STARFRUIT, US << MARKET, 5040, 1, 70700)","{""AMETHYSTS"": -17, ""STARFRUIT"": 19}",439,5036,9998
70800,-5033,69688,"(STARFRUIT, US << MARKET, 5033, 1, 70800)","{""AMETHYSTS"": -17, ""STARFRUIT"": 20}",459,5036,9997
70900,30015,99703,"(AMETHYSTS, MARKET << US, 10005, 1, 70900)
(AMETHYSTS, MARKET << US, 10005, 1, 70900)
(AMETHYSTS, MARKET << US, 10005, 1, 70900)","{""AMETHYSTS"": -20, ""STARFRUIT"": 20}",423,5036,10000
71000,5039,104742,"(STARFRUIT, MARKET << US, 5039, 1, 71000)","{""AMETHYSTS"": -20, ""STARFRUIT"": 19}",483,5039,10000
71400,-4,104738,"(STARFRUIT, US << MARKET, 5040, 1, 71400)
(STARFRUIT, MARKET << US, 5036, 1, 71400)","{""AMETHYSTS"": -20, ""STARFRUIT"": 19}",421,5037,10001
72400,-5036,99702,"(STARFRUIT, US << MARKET, 5036, 1, 72400)","{""AMETHYSTS"": -20, ""STARFRUIT"": 20}",462,5038,10000
72500,-10004,89698,"(AMETHYSTS, US << MARKET, 10004, 1, 72500)","{""AMETHYSTS"": -19, ""STARFRUIT"": 20}",498,5040,10000
73200,30228,119926,"(STARFRUIT, MARKET << US, 5038, 1, 73200)
(STARFRUIT, MARKET << US, 5038, 1, 73200)
(STARFRUIT, MARKET << US, 5038, 1, 73200)
(STARFRUIT, MARKET << US, 5038, 1, 73200)
(STARFRUIT, MARKET << US, 5038, 1, 73200)
(STARFRUIT, MARKET << US, 5038, 1, 73200)","{""AMETHYSTS"": -19, ""STARFRUIT"": 14}",500,5041,10000
73400,-19996,99930,"(AMETHYSTS, US << MARKET, 9998, 1, 73400)
(AMETHYSTS, US << MARKET, 9998, 1, 73400)","{""AMETHYSTS"": -17, ""STARFRUIT"": 14}",555,5041,9997
73700,-5043,94887,"(STARFRUIT, US << MARKET, 5043, 1, 73700)","{""AMETHYSTS"": -17, ""STARFRUIT"": 15}",615,5044,9996
74300,5044,99931,"(STARFRUIT, MARKET << US, 5044, 1, 74300)","{""AMETHYSTS"": -17, ""STARFRUIT"": 14}",547,5044,10000
74400,15129,115060,"(STARFRUIT, MARKET << US, 5043, 1, 74400)
(STARFRUIT, MARKET << US, 5043, 1, 74400)
(STARFRUIT, MARKET << US, 5043, 1, 74400)","{""AMETHYSTS"": -17, ""STARFRUIT"": 11}",544,5044,10000
74600,35051,150111,"(AMETHYSTS, MARKET << US, 10004, 1, 74600)
(AMETHYSTS, MARKET << US, 10004, 1, 74600)
(AMETHYSTS, MARKET << US, 10004, 1, 74600)
(STARFRUIT, MARKET << US, 5039, 1, 74600)","{""AMETHYSTS"": -20, ""STARFRUIT"": 10}",531,5042,10000
74800,-39992,110119,"(AMETHYSTS, US << MARKET, 9998, 1, 74800)
(AMETHYSTS, US << MARKET, 9998, 1, 74800)
(AMETHYSTS, US << MARKET, 9998, 1, 74800)
(AMETHYSTS, US << MARKET, 9998, 1, 74800)","{""AMETHYSTS"": -16, ""STARFRUIT"": 10}",587,5042,9997
74900,9998,120117,"(AMETHYSTS, MARKET << US, 9998, 1, 74900)","{""AMETHYSTS"": -17, ""STARFRUIT"": 10}",588,5042,9997
75300,5040,125157,"(STARFRUIT, MARKET << US, 5040, 1, 75300)","{""AMETHYSTS"": -17, ""STARFRUIT"": 9}",535,5042,10000
75600,-20184,104973,"(STARFRUIT, US << MARKET, 5046, 1, 75600)
(STARFRUIT, US << MARKET, 5046, 1, 75600)
(STARFRUIT, US << MARKET, 5046, 1, 75600)
(STARFRUIT, US << MARKET, 5046, 1, 75600)","{""AMETHYSTS"": -17, ""STARFRUIT"": 13}",579,5044,9998
75800,14962,119935,"(AMETHYSTS, MARKET << US, 10004, 1, 75800)
(AMETHYSTS, MARKET << US, 10004, 1, 75800)
(STARFRUIT, US << MARKET, 5046, 1, 75800)","{""AMETHYSTS"": -19, ""STARFRUIT"": 14}",537,5043,10000
76300,5037,124972,"(STARFRUIT, MARKET << US, 5037, 1, 76300)","{""AMETHYSTS"": -19, ""STARFRUIT"": 13}",536,5039,9997
76400,15114,140086,"(STARFRUIT, MARKET << US, 5038, 1, 76400)
(STARFRUIT, MARKET << US, 5038, 1, 76400)
(STARFRUIT, MARKET << US, 5038, 1, 76400)","{""AMETHYSTS"": -19, ""STARFRUIT"": 10}",456,5037,10000
76800,-5039,135047,"(STARFRUIT, US << MARKET, 5039, 1, 76800)","{""AMETHYSTS"": -19, ""STARFRUIT"": 11}",509,5042,10000
76900,20164,155211,"(STARFRUIT, MARKET << US, 5041, 1, 76900)
(STARFRUIT, MARKET << US, 5041, 1, 76900)
(STARFRUIT, MARKET << US, 5041, 1, 76900)
(STARFRUIT, MARKET << US, 5041, 1, 76900)","{""AMETHYSTS"": -19, ""STARFRUIT"": 7}",512,5043,10000
77100,5041,160252,"(STARFRUIT, MARKET << US, 5041, 1, 77100)","{""AMETHYSTS"": -19, ""STARFRUIT"": 6}",516,5044,10000
77400,-20168,140084,"(STARFRUIT, US << MARKET, 5042, 1, 77400)
(STARFRUIT, US << MARKET, 5042, 1, 77400)
(STARFRUIT, US << MARKET, 5042, 1, 77400)
(STARFRUIT, US << MARKET, 5042, 1, 77400)","{""AMETHYSTS"": -19, ""STARFRUIT"": 10}",494,5041,10000
77700,9998,150082,"(AMETHYSTS, MARKET << US, 9998, 1, 77700)","{""AMETHYSTS"": -20, ""STARFRUIT"": 10}",512,5045,10001
78000,-5043,145039,"(STARFRUIT, US << MARKET, 5043, 1, 78000)","{""AMETHYSTS"": -20, ""STARFRUIT"": 11}",525,5046,10001
78100,0,145039,,"{""AMETHYSTS"": -20, ""STARFRUIT"": 11}",474,5045,10003
78400,-20008,125031,"(AMETHYSTS, US << MARKET, 10004, 1, 78400)
(AMETHYSTS, US << MARKET, 10004, 1, 78400)","{""AMETHYSTS"": -18, ""STARFRUIT"": 11}",537,5046,10000
78600,-39984,85047,"(AMETHYSTS, US << MARKET, 9996, 1, 78600)
(AMETHYSTS, US << MARKET, 9996, 1, 78600)
(AMETHYSTS, US << MARKET, 9996, 1, 78600)
(AMETHYSTS, US << MARKET, 9996, 1, 78600)","{""AMETHYSTS"": -14, ""STARFRUIT"": 11}",542,5045,10000
78700,-20196,64851,"(STARFRUIT, US << MARKET, 5049, 1, 78700)
(STARFRUIT, US << MARKET, 5049, 1, 78700)
(STARFRUIT, US << MARKET, 5049, 1, 78700)
(STARFRUIT, US << MARKET, 5049, 1, 78700)","{""AMETHYSTS"": -14, ""STARFRUIT"": 15}",526,5045,10000
78800,5047,69898,"(STARFRUIT, MARKET << US, 5047, 1, 78800)","{""AMETHYSTS"": -14, ""STARFRUIT"": 14}",528,5048,10003
79100,20188,90086,"(STARFRUIT, MARKET << US, 5047, 1, 79100)
(STARFRUIT, MARKET << US, 5047, 1, 79100)
(STARFRUIT, MARKET << US, 5047, 1, 79100)
(STARFRUIT, MARKET << US, 5047, 1, 79100)","{""AMETHYSTS"": -14, ""STARFRUIT"": 10}",566,5048,10000
79300,4953,95039,"(AMETHYSTS, MARKET << US, 9996, 1, 79300)
(STARFRUIT, US << MARKET, 5043, 1, 79300)","{""AMETHYSTS"": -15, ""STARFRUIT"": 11}",545,5046,10000
79500,-15053,79986,"(AMETHYSTS, US << MARKET, 10004, 1, 79500)
(STARFRUIT, US << MARKET, 5049, 1, 79500)","{""AMETHYSTS"": -14, ""STARFRUIT"": 12}",538,5046,10000
79800,5050,85036,"(STARFRUIT, MARKET << US, 5050, 1, 79800)","{""AMETHYSTS"": -14, ""STARFRUIT"": 11}",586,5050,10000
79900,9906,94942,"(AMETHYSTS, MARKET << US, 9998, 1, 79900)
(AMETHYSTS, MARKET << US, 9998, 1, 79900)
(STARFRUIT, US << MARKET, 5045, 1, 79900)
(STARFRUIT, US << MARKET, 5045, 1, 79900)","{""AMETHYSTS"": -16, ""STARFRUIT"": 13}",550,5048,10001
80300,-59988,34954,"(AMETHYSTS, US << MARKET, 9998, 1, 80300)
(AMETHYSTS, US << MARKET, 9998, 1, 80300)
(AMETHYSTS, US << MARKET, 9998, 1, 80300)
(AMETHYSTS, US << MARKET, 9998, 1, 80300)
(AMETHYSTS, US << MARKET, 9998, 1, 80300)
(AMETHYSTS, US << MARKET, 9998, 1, 80300)","{""AMETHYSTS"": -10, ""STARFRUIT"": 13}",578,5048,10000
80400,-14949,20005,"(AMETHYSTS, US << MARKET, 9998, 1, 80400)
(AMETHYSTS, US << MARKET, 9998, 1, 80400)
(STARFRUIT, US << MARKET, 5047, 1, 80400)
(STARFRUIT, MARKET << US, 5047, 1, 80400)
(STARFRUIT, MARKET << US, 5047, 1, 80400)","{""AMETHYSTS"": -8, ""STARFRUIT"": 12}",581,5046,9997
80600,9998,30003,"(AMETHYSTS, MARKET << US, 9998, 1, 80600)","{""AMETHYSTS"": -9, ""STARFRUIT"": 12}",639,5050,9996
80700,9998,40001,"(AMETHYSTS, MARKET << US, 9998, 1, 80700)","{""AMETHYSTS"": -10, ""STARFRUIT"": 12}",619,5049,9997
81500,25048,65049,"(AMETHYSTS, MARKET << US, 10002, 1, 81500)
(AMETHYSTS, MARKET << US, 10002, 1, 81500)
(STARFRUIT, MARKET << US, 5044, 1, 81500)","{""AMETHYSTS"": -12, ""STARFRUIT"": 11}",530,5047,10003
81700,5044,70093,"(STARFRUIT, MARKET << US, 5044, 1, 81700)","{""AMETHYSTS"": -12, ""STARFRUIT"": 10}",541,5046,10001
81800,-5049,65044,"(STARFRUIT, US << MARKET, 5049, 1, 81800)","{""AMETHYSTS"": -12, ""STARFRUIT"": 11}",594,5050,10000
81900,-20184,44860,"(STARFRUIT, US << MARKET, 5046, 1, 81900)
(STARFRUIT, US << MARKET, 5046, 1, 81900)
(STARFRUIT, US << MARKET, 5046, 1, 81900)
(STARFRUIT, US << MARKET, 5046, 1, 81900)","{""AMETHYSTS"": -12, ""STARFRUIT"": 15}",535,5045,10000
82000,-5045,39815,"(STARFRUIT, US << MARKET, 5045, 1, 82000)","{""AMETHYSTS"": -12, ""STARFRUIT"": 16}",567,5047,10000
82100,-20180,19635,"(STARFRUIT, US << MARKET, 5045, 1, 82100)
(STARFRUIT, US << MARKET, 5045, 1, 82100)
(STARFRUIT, US << MARKET, 5045, 1, 82100)
(STARFRUIT, US << MARKET, 5045, 1, 82100)","{""AMETHYSTS"": -12, ""STARFRUIT"": 20}",583,5048,10001
82200,-79984,-60349,"(AMETHYSTS, US << MARKET, 9998, 1, 82200)
(AMETHYSTS, US << MARKET, 9998, 1, 82200)
(AMETHYSTS, US << MARKET, 9998, 1, 82200)
(AMETHYSTS, US << MARKET, 9998, 1, 82200)
(AMETHYSTS, US << MARKET, 9998, 1, 82200)
(AMETHYSTS, US << MARKET, 9998, 1, 82200)
(AMETHYSTS, US << MARKET, 9998, 1, 82200)
(AMETHYSTS, US << MARKET, 9998, 1, 82200)","{""AMETHYSTS"": -4, ""STARFRUIT"": 20}",611,5048,10000
82500,5050,-55299,"(STARFRUIT, MARKET << US, 5050, 1, 82500)","{""AMETHYSTS"": -4, ""STARFRUIT"": 19}",670,5051,10000
82700,5046,-50253,"(STARFRUIT, MARKET << US, 5046, 1, 82700)","{""AMETHYSTS"": -4, ""STARFRUIT"": 18}",629,5049,10000
83000,9998,-40255,"(AMETHYSTS, MARKET << US, 9998, 1, 83000)","{""AMETHYSTS"": -5, ""STARFRUIT"": 18}",622,5049,10001
83400,55326,15071,"(AMETHYSTS, MARKET << US, 10002, 1, 83400)
(AMETHYSTS, MARKET << US, 10002, 1, 83400)
(STARFRUIT, MARKET << US, 5046, 1, 83400)
(STARFRUIT, MARKET << US, 5046, 1, 83400)
(STARFRUIT, MARKET << US, 5046, 1, 83400)
(STARFRUIT, MARKET << US, 5046, 1, 83400)
(STARFRUIT, MARKET << US, 5046, 1, 83400)
(STARFRUIT, MARKET << US, 5046, 1, 83400)
(STARFRUIT, MARKET << US, 5046, 1, 83400)","{""AMETHYSTS"": -7, ""STARFRUIT"": 11}",545,5045,10003
83800,-4951,10120,"(AMETHYSTS, US << MARKET, 10005, 1, 83800)
(STARFRUIT, MARKET << US, 5054, 1, 83800)","{""AMETHYSTS"": -6, ""STARFRUIT"": 10}",620,5050,10000
84100,-4951,5169,"(AMETHYSTS, US << MARKET, 10002, 1, 84100)
(STARFRUIT, MARKET << US, 5051, 1, 84100)","{""AMETHYSTS"": -5, ""STARFRUIT"": 9}",613,5051,10003
84500,192,5361,"(AMETHYSTS, US << MARKET, 9996, 1, 84500)
(AMETHYSTS, US << MARKET, 9996, 1, 84500)
(STARFRUIT, MARKET << US, 5046, 1, 84500)
(STARFRUIT, MARKET << US, 5046, 1, 84500)
(STARFRUIT, MARKET << US, 5046, 1, 84500)
(STARFRUIT, MARKET << US, 5046, 1, 84500)","{""AMETHYSTS"": -3, ""STARFRUIT"": 5}",604,5048,9999
84600,-20212,-14851,"(STARFRUIT, US << MARKET, 5053, 1, 84600)
(STARFRUIT, US << MARKET, 5053, 1, 84600)
(STARFRUIT, US << MARKET, 5053, 1, 84600)
(STARFRUIT, US << MARKET, 5053, 1, 84600)","{""AMETHYSTS"": -3, ""STARFRUIT"": 9}",590,5049,10000
84800,-15053,-29904,"(AMETHYSTS, US << MARKET, 10002, 1, 84800)
(STARFRUIT, US << MARKET, 5051, 1, 84800)","{""AMETHYSTS"": -2, ""STARFRUIT"": 10}",610,5052,10003
85200,-15053,-44957,"(AMETHYSTS, US << MARKET, 10002, 1, 85200)
(STARFRUIT, US << MARKET, 5051, 1, 85200)","{""AMETHYSTS"": -1, ""STARFRUIT"": 11}",583,5049,9999
85400,5052,-39905,"(STARFRUIT, MARKET << US, 5052, 1, 85400)","{""AMETHYSTS"": -1, ""STARFRUIT"": 10}",625,5053,10000
85500,-139972,-179877,"(AMETHYSTS, US << MARKET, 9998, 1, 85500)
(AMETHYSTS, US << MARKET, 9998, 1, 85500)
(AMETHYSTS, US << MARKET, 9998, 1, 85500)
(AMETHYSTS, US << MARKET, 9998, 1, 85500)
(AMETHYSTS, US << MARKET, 9998, 1, 85500)
(AMETHYSTS, US << MARKET, 9998, 1, 85500)
(AMETHYSTS, US << MARKET, 9998, 1, 85500)
(AMETHYSTS, US << MARKET, 9998, 1, 85500)
(AMETHYSTS, US << MARKET, 9998, 1, 85500)
(AMETHYSTS, US << MARKET, 9998, 1, 85500)
(AMETHYSTS, US << MARKET, 9998, 1, 85500)
(AMETHYSTS, US << MARKET, 9998, 1, 85500)
(AMETHYSTS, US << MARKET, 9998, 1, 85500)
(AMETHYSTS, US << MARKET, 9998, 1, 85500)","{""AMETHYSTS"": 13, ""STARFRUIT"": 10}",636,5050,10001
85600,-39984,-219861,"(AMETHYSTS, US << MARKET, 9996, 1, 85600)
(AMETHYSTS, US << MARKET, 9996, 1, 85600)
(AMETHYSTS, US << MARKET, 9996, 1, 85600)
(AMETHYSTS, US << MARKET, 9996, 1, 85600)","{""AMETHYSTS"": 17, ""STARFRUIT"": 10}",622,5050,9999
85800,-10002,-229863,"(AMETHYSTS, US << MARKET, 10002, 1, 85800)","{""AMETHYSTS"": 18, ""STARFRUIT"": 10}",701,5051,10003
85900,9996,-219867,"(AMETHYSTS, MARKET << US, 9996, 1, 85900)","{""AMETHYSTS"": 17, ""STARFRUIT"": 10}",633,5050,10000
86200,-29994,-249861,"(AMETHYSTS, US << MARKET, 9998, 1, 86200)
(AMETHYSTS, US << MARKET, 9998, 1, 86200)
(AMETHYSTS, US << MARKET, 9998, 1, 86200)","{""AMETHYSTS"": 20, ""STARFRUIT"": 10}",559,5050,9996
86600,-5054,-254915,"(STARFRUIT, US << MARKET, 5054, 1, 86600)","{""AMETHYSTS"": 20, ""STARFRUIT"": 11}",595,5050,9998
86900,10105,-244810,"(STARFRUIT, MARKET << US, 5054, 1, 86900)
(STARFRUIT, MARKET << US, 5051, 1, 86900)","{""AMETHYSTS"": 20, ""STARFRUIT"": 9}",611,5049,9999
87100,35258,-209552,"(AMETHYSTS, MARKET << US, 9998, 1, 87100)
(STARFRUIT, MARKET << US, 5052, 1, 87100)
(STARFRUIT, MARKET << US, 5052, 1, 87100)
(STARFRUIT, MARKET << US, 5052, 1, 87100)
(STARFRUIT, MARKET << US, 5052, 1, 87100)
(STARFRUIT, MARKET << US, 5052, 1, 87100)","{""AMETHYSTS"": 19, ""STARFRUIT"": 4}",591,5050,9997
87200,-20200,-229752,"(STARFRUIT, US << MARKET, 5050, 1, 87200)
(STARFRUIT, US << MARKET, 5050, 1, 87200)
(STARFRUIT, US << MARKET, 5050, 1, 87200)
(STARFRUIT, US << MARKET, 5050, 1, 87200)","{""AMETHYSTS"": 19, ""STARFRUIT"": 8}",672,5053,10000
87300,5054,-224698,"(STARFRUIT, MARKET << US, 5054, 1, 87300)","{""AMETHYSTS"": 19, ""STARFRUIT"": 7}",659,5051,10000
87500,-5054,-229752,"(STARFRUIT, US << MARKET, 5054, 1, 87500)","{""AMETHYSTS"": 19, ""STARFRUIT"": 8}",656,5051,10000
87900,5055,-224697,"(STARFRUIT, MARKET << US, 5055, 1, 87900)","{""AMETHYSTS"": 19, ""STARFRUIT"": 7}",688,5055,10000
88400,-20220,-244917,"(STARFRUIT, US << MARKET, 5055, 1, 88400)
(STARFRUIT, US << MARKET, 5055, 1, 88400)
(STARFRUIT, US << MARKET, 5055, 1, 88400)
(STARFRUIT, US << MARKET, 5055, 1, 88400)","{""AMETHYSTS"": 19, ""STARFRUIT"": 11}",680,5056,9999
88500,20004,-224913,"(AMETHYSTS, MARKET << US, 10002, 1, 88500)
(AMETHYSTS, MARKET << US, 10002, 1, 88500)","{""AMETHYSTS"": 17, ""STARFRUIT"": 11}",732,5054,10003
88600,-10002,-234915,"(AMETHYSTS, US << MARKET, 10002, 1, 88600)","{""AMETHYSTS"": 18, ""STARFRUIT"": 11}",722,5053,10003
88700,79960,-154955,"(AMETHYSTS, MARKET << US, 9995, 1, 88700)
(AMETHYSTS, MARKET << US, 9995, 1, 88700)
(AMETHYSTS, MARKET << US, 9995, 1, 88700)
(AMETHYSTS, MARKET << US, 9995, 1, 88700)
(AMETHYSTS, MARKET << US, 9995, 1, 88700)
(AMETHYSTS, MARKET << US, 9995, 1, 88700)
(AMETHYSTS, MARKET << US, 9995, 1, 88700)
(AMETHYSTS, MARKET << US, 9995, 1, 88700)","{""AMETHYSTS"": 10, ""STARFRUIT"": 11}",617,5052,10000
88900,100020,-54935,"(AMETHYSTS, MARKET << US, 10002, 1, 88900)
(AMETHYSTS, MARKET << US, 10002, 1, 88900)
(AMETHYSTS, MARKET << US, 10002, 1, 88900)
(AMETHYSTS, MARKET << US, 10002, 1, 88900)
(AMETHYSTS, MARKET << US, 10002, 1, 88900)
(AMETHYSTS, MARKET << US, 10002, 1, 88900)
(AMETHYSTS, MARKET << US, 10002, 1, 88900)
(AMETHYSTS, MARKET << US, 10002, 1, 88900)
(AMETHYSTS, MARKET << US, 10002, 1, 88900)
(AMETHYSTS, MARKET << US, 10002, 1, 88900)","{""AMETHYSTS"": 0, ""STARFRUIT"": 11}",637,5052,10003
89100,-9896,-64831,"(AMETHYSTS, US << MARKET, 10005, 1, 89100)
(AMETHYSTS, US << MARKET, 10005, 1, 89100)
(STARFRUIT, MARKET << US, 5057, 1, 89100)
(STARFRUIT, MARKET << US, 5057, 1, 89100)","{""AMETHYSTS"": 2, ""STARFRUIT"": 9}",673,5056,10000
89300,30090,-34741,"(AMETHYSTS, MARKET << US, 9996, 1, 89300)
(AMETHYSTS, MARKET << US, 9996, 1, 89300)
(STARFRUIT, MARKET << US, 5049, 1, 89300)
(STARFRUIT, MARKET << US, 5049, 1, 89300)","{""AMETHYSTS"": 0, ""STARFRUIT"": 7}",623,5052,10000
89500,-5054,-39795,"(STARFRUIT, US << MARKET, 5054, 1, 89500)","{""AMETHYSTS"": 0, ""STARFRUIT"": 8}",645,5055,10000
89800,-116,-39911,"(AMETHYSTS, US << MARKET, 10005, 1, 89800)
(AMETHYSTS, US << MARKET, 10005, 1, 89800)
(AMETHYSTS, MARKET << US, 10004, 1, 89800)
(AMETHYSTS, MARKET << US, 10004, 1, 89800)
(AMETHYSTS, MARKET << US, 9998, 1, 89800)
(STARFRUIT, US << MARKET, 5056, 1, 89800)
(STARFRUIT, US << MARKET, 5056, 1, 89800)","{""AMETHYSTS"": -1, ""STARFRUIT"": 10}",627,5054,10002
90200,-29994,-69905,"(AMETHYSTS, US << MARKET, 9998, 1, 90200)
(AMETHYSTS, US << MARKET, 9998, 1, 90200)
(AMETHYSTS, US << MARKET, 9998, 1, 90200)
(AMETHYSTS, US << MARKET, 9998, 1, 90200)
(AMETHYSTS, MARKET << US, 9998, 1, 90200)","{""AMETHYSTS"": 2, ""STARFRUIT"": 10}",627,5053,10001
90400,-19992,-89897,"(AMETHYSTS, US << MARKET, 9996, 1, 90400)
(AMETHYSTS, US << MARKET, 9996, 1, 90400)","{""AMETHYSTS"": 4, ""STARFRUIT"": 10}",633,5053,10000
90800,-20212,-110109,"(STARFRUIT, US << MARKET, 5053, 1, 90800)
(STARFRUIT, US << MARKET, 5053, 1, 90800)
(STARFRUIT, US << MARKET, 5053, 1, 90800)
(STARFRUIT, US << MARKET, 5053, 1, 90800)","{""AMETHYSTS"": 4, ""STARFRUIT"": 14}",619,5052,10000
91200,-4950,-115059,"(AMETHYSTS, US << MARKET, 10002, 1, 91200)
(STARFRUIT, US << MARKET, 5058, 1, 91200)
(STARFRUIT, MARKET << US, 5055, 1, 91200)
(STARFRUIT, MARKET << US, 5055, 1, 91200)","{""AMETHYSTS"": 5, ""STARFRUIT"": 13}",633,5054,9998
91300,99980,-15079,"(AMETHYSTS, MARKET << US, 9998, 1, 91300)
(AMETHYSTS, MARKET << US, 9998, 1, 91300)
(AMETHYSTS, MARKET << US, 9998, 1, 91300)
(AMETHYSTS, MARKET << US, 9998, 1, 91300)
(AMETHYSTS, MARKET << US, 9998, 1, 91300)
(AMETHYSTS, MARKET << US, 9998, 1, 91300)
(AMETHYSTS, MARKET << US, 9998, 1, 91300)
(AMETHYSTS, MARKET << US, 9998, 1, 91300)
(AMETHYSTS, MARKET << US, 9998, 1, 91300)
(AMETHYSTS, MARKET << US, 9998, 1, 91300)","{""AMETHYSTS"": -5, ""STARFRUIT"": 13}",664,5056,9997
91400,5054,-10025,"(STARFRUIT, MARKET << US, 5054, 1, 91400)","{""AMETHYSTS"": -5, ""STARFRUIT"": 12}",644,5057,10003
91600,4944,-5081,"(AMETHYSTS, MARKET << US, 9998, 1, 91600)
(STARFRUIT, US << MARKET, 5054, 1, 91600)","{""AMETHYSTS"": -6, ""STARFRUIT"": 13}",632,5053,9996
91800,-59988,-65069,"(AMETHYSTS, US << MARKET, 9998, 1, 91800)
(AMETHYSTS, US << MARKET, 9998, 1, 91800)
(AMETHYSTS, US << MARKET, 9998, 1, 91800)
(AMETHYSTS, US << MARKET, 9998, 1, 91800)
(AMETHYSTS, US << MARKET, 9998, 1, 91800)
(AMETHYSTS, US << MARKET, 9998, 1, 91800)","{""AMETHYSTS"": 0, ""STARFRUIT"": 13}",672,5057,9997
91900,9998,-55071,"(AMETHYSTS, MARKET << US, 9998, 1, 91900)","{""AMETHYSTS"": -1, ""STARFRUIT"": 13}",708,5060,10001
92400,-5060,-60131,"(STARFRUIT, US << MARKET, 5060, 1, 92400)","{""AMETHYSTS"": -1, ""STARFRUIT"": 14}",709,5060,10000
92900,40432,-19699,"(STARFRUIT, MARKET << US, 5054, 1, 92900)
(STARFRUIT, MARKET << US, 5054, 1, 92900)
(STARFRUIT, MARKET << US, 5054, 1, 92900)
(STARFRUIT, MARKET << US, 5054, 1, 92900)
(STARFRUIT, MARKET << US, 5054, 1, 92900)
(STARFRUIT, MARKET << US, 5054, 1, 92900)
(STARFRUIT, MARKET << US, 5054, 1, 92900)
(STARFRUIT, MARKET << US, 5054, 1, 92900)","{""AMETHYSTS"": -1, ""STARFRUIT"": 6}",651,5058,9998
93200,190201,170502,"(AMETHYSTS, MARKET << US, 10005, 1, 93200)
(AMETHYSTS, MARKET << US, 10005, 1, 93200)
(AMETHYSTS, MARKET << US, 10005, 1, 93200)
(AMETHYSTS, MARKET << US, 10005, 1, 93200)
(AMETHYSTS, MARKET << US, 10004, 1, 93200)
(AMETHYSTS, MARKET << US, 10004, 1, 93200)
(AMETHYSTS, MARKET << US, 10004, 1, 93200)
(AMETHYSTS, MARKET << US, 10004, 1, 93200)
(AMETHYSTS, MARKET << US, 10004, 1, 93200)
(AMETHYSTS, MARKET << US, 10004, 1, 93200)
(AMETHYSTS, MARKET << US, 10004, 1, 93200)
(AMETHYSTS, MARKET << US, 10004, 1, 93200)
(AMETHYSTS, MARKET << US, 10004, 1, 93200)
(AMETHYSTS, MARKET << US, 10004, 1, 93200)
(AMETHYSTS, MARKET << US, 10005, 1, 93200)
(AMETHYSTS, MARKET << US, 10005, 1, 93200)
(AMETHYSTS, MARKET << US, 10004, 1, 93200)
(AMETHYSTS, MARKET << US, 10005, 1, 93200)
(STARFRUIT, MARKET << US, 5061, 1, 93200)
(STARFRUIT, MARKET << US, 5061, 1, 93200)","{""AMETHYSTS"": -19, ""STARFRUIT"": 4}",677,5058,10003
93300,-10002,160500,"(AMETHYSTS, US << MARKET, 10002, 1, 93300)","{""AMETHYSTS"": -18, ""STARFRUIT"": 4}",750,5058,9999
93700,-10122,150378,"(STARFRUIT, US << MARKET, 5061, 1, 93700)
(STARFRUIT, US << MARKET, 5061, 1, 93700)","{""AMETHYSTS"": -18, ""STARFRUIT"": 6}",726,5058,10000
94000,5062,155440,"(STARFRUIT, MARKET << US, 5062, 1, 94000)","{""AMETHYSTS"": -18, ""STARFRUIT"": 5}",750,5062,10000
94400,-10234,145206,"(AMETHYSTS, MARKET << US, 9998, 1, 94400)
(STARFRUIT, US << MARKET, 5058, 1, 94400)
(STARFRUIT, US << MARKET, 5058, 1, 94400)
(STARFRUIT, US << MARKET, 5058, 1, 94400)
(STARFRUIT, US << MARKET, 5058, 1, 94400)","{""AMETHYSTS"": -19, ""STARFRUIT"": 9}",700,5057,10001
94700,10128,155334,"(STARFRUIT, US << MARKET, 5064, 1, 94700)
(STARFRUIT, US << MARKET, 5064, 1, 94700)
(STARFRUIT, US << MARKET, 5064, 1, 94700)
(STARFRUIT, US << MARKET, 5064, 1, 94700)
(STARFRUIT, MARKET << US, 5064, 1, 94700)
(STARFRUIT, MARKET << US, 5064, 1, 94700)
(STARFRUIT, MARKET << US, 5064, 1, 94700)
(STARFRUIT, MARKET << US, 5064, 1, 94700)
(STARFRUIT, MARKET << US, 5064, 1, 94700)
(STARFRUIT, MARKET << US, 5064, 1, 94700)","{""AMETHYSTS"": -19, ""STARFRUIT"": 7}",754,5060,10000
95500,9998,165332,"(AMETHYSTS, MARKET << US, 9998, 1, 95500)","{""AMETHYSTS"": -20, ""STARFRUIT"": 7}",725,5059,10001
95700,0,165332,,"{""AMETHYSTS"": -20, ""STARFRUIT"": 7}",805,5059,9997
95800,-49866,115466,"(AMETHYSTS, US << MARKET, 9996, 1, 95800)
(AMETHYSTS, US << MARKET, 9996, 1, 95800)
(AMETHYSTS, US << MARKET, 9996, 1, 95800)
(AMETHYSTS, US << MARKET, 9996, 1, 95800)
(AMETHYSTS, US << MARKET, 9996, 1, 95800)
(AMETHYSTS, US << MARKET, 9998, 1, 95800)
(STARFRUIT, MARKET << US, 5056, 1, 95800)
(STARFRUIT, MARKET << US, 5056, 1, 95800)","{""AMETHYSTS"": -14, ""STARFRUIT"": 5}",803,5059,9997
96600,-20114,95352,"(AMETHYSTS, US << MARKET, 10002, 1, 96600)
(STARFRUIT, US << MARKET, 5056, 1, 96600)
(STARFRUIT, US << MARKET, 5056, 1, 96600)","{""AMETHYSTS"": -13, ""STARFRUIT"": 7}",733,5060,10003
96900,-5060,90292,"(STARFRUIT, US << MARKET, 5060, 1, 96900)","{""AMETHYSTS"": -13, ""STARFRUIT"": 8}",780,5061,10000
97100,-15063,75229,"(AMETHYSTS, US << MARKET, 10004, 1, 97100)
(STARFRUIT, US << MARKET, 5059, 1, 97100)","{""AMETHYSTS"": -12, ""STARFRUIT"": 9}",751,5058,10000
97200,10108,85337,"(STARFRUIT, MARKET << US, 5054, 1, 97200)
(STARFRUIT, MARKET << US, 5054, 1, 97200)","{""AMETHYSTS"": -12, ""STARFRUIT"": 7}",748,5057,9999
97800,-15064,70273,"(AMETHYSTS, US << MARKET, 10005, 1, 97800)
(STARFRUIT, US << MARKET, 5059, 1, 97800)","{""AMETHYSTS"": -11, ""STARFRUIT"": 8}",713,5055,10000
98700,29902,100175,"(AMETHYSTS, MARKET << US, 10004, 1, 98700)
(AMETHYSTS, MARKET << US, 10004, 1, 98700)
(AMETHYSTS, MARKET << US, 10004, 1, 98700)
(AMETHYSTS, MARKET << US, 10004, 1, 98700)
(STARFRUIT, US << MARKET, 5057, 1, 98700)
(STARFRUIT, US << MARKET, 5057, 1, 98700)","{""AMETHYSTS"": -15, ""STARFRUIT"": 10}",715,5054,10000
98800,-19882,80293,"(AMETHYSTS, US << MARKET, 9996, 1, 98800)
(AMETHYSTS, US << MARKET, 9996, 1, 98800)
(AMETHYSTS, US << MARKET, 9996, 1, 98800)
(AMETHYSTS, US << MARKET, 9996, 1, 98800)
(AMETHYSTS, MARKET << US, 9998, 1, 98800)
(STARFRUIT, MARKET << US, 5052, 1, 98800)
(STARFRUIT, MARKET << US, 5052, 1, 98800)","{""AMETHYSTS"": -12, ""STARFRUIT"": 8}",769,5055,9997
98900,-20220,60073,"(STARFRUIT, US << MARKET, 5055, 1, 98900)
(STARFRUIT, US << MARKET, 5055, 1, 98900)
(STARFRUIT, US << MARKET, 5055, 1, 98900)
(STARFRUIT, US << MARKET, 5055, 1, 98900)","{""AMETHYSTS"": -12, ""STARFRUIT"": 12}",745,5056,10000
99400,-5055,55018,"(STARFRUIT, US << MARKET, 5055, 1, 99400)","{""AMETHYSTS"": -12, ""STARFRUIT"": 13}",729,5051,9996
99800,211,55229,"(AMETHYSTS, US << MARKET, 9998, 1, 99800)
(AMETHYSTS, US << MARKET, 9998, 1, 99800)
(STARFRUIT, MARKET << US, 5052, 1, 99800)
(STARFRUIT, MARKET << US, 5052, 1, 99800)
(STARFRUIT, MARKET << US, 5052, 1, 99800)
(STARFRUIT, MARKET << US, 5051, 1, 99800)","{""AMETHYSTS"": -10, ""STARFRUIT"": 9}",678,5051,10001
100100,5050,60279,"(STARFRUIT, MARKET << US, 5050, 1, 100100)","{""AMETHYSTS"": -10, ""STARFRUIT"": 8}",703,5053,10000
100400,-14946,45333,"(AMETHYSTS, US << MARKET, 9998, 1, 100400)
(AMETHYSTS, US << MARKET, 9998, 1, 100400)
(STARFRUIT, MARKET << US, 5050, 1, 100400)","{""AMETHYSTS"": -8, ""STARFRUIT"": 7}",728,5053,9997
100600,20106,65439,"(AMETHYSTS, MARKET << US, 9998, 1, 100600)
(STARFRUIT, MARKET << US, 5054, 1, 100600)
(STARFRUIT, MARKET << US, 5054, 1, 100600)","{""AMETHYSTS"": -9, ""STARFRUIT"": 5}",736,5054,9997
100900,20004,85443,"(AMETHYSTS, MARKET << US, 10002, 1, 100900)
(AMETHYSTS, MARKET << US, 10002, 1, 100900)","{""AMETHYSTS"": -11, ""STARFRUIT"": 5}",720,5051,9998
101100,-20212,65231,"(STARFRUIT, US << MARKET, 5053, 1, 101100)
(STARFRUIT, US << MARKET, 5053, 1, 101100)
(STARFRUIT, US << MARKET, 5053, 1, 101100)
(STARFRUIT, US << MARKET, 5053, 1, 101100)","{""AMETHYSTS"": -11, ""STARFRUIT"": 9}",717,5054,10000
101700,25050,90281,"(AMETHYSTS, MARKET << US, 10002, 1, 101700)
(AMETHYSTS, MARKET << US, 10002, 1, 101700)
(STARFRUIT, MARKET << US, 5046, 1, 101700)","{""AMETHYSTS"": -13, ""STARFRUIT"": 8}",634,5049,10003
101900,-20184,70097,"(STARFRUIT, US << MARKET, 5046, 1, 101900)
(STARFRUIT, US << MARKET, 5046, 1, 101900)
(STARFRUIT, US << MARKET, 5046, 1, 101900)
(STARFRUIT, US << MARKET, 5046, 1, 101900)","{""AMETHYSTS"": -13, ""STARFRUIT"": 12}",637,5045,10000
102300,25056,95153,"(AMETHYSTS, MARKET << US, 10005, 1, 102300)
(AMETHYSTS, MARKET << US, 10005, 1, 102300)
(STARFRUIT, MARKET << US, 5046, 1, 102300)","{""AMETHYSTS"": -15, ""STARFRUIT"": 11}",633,5045,10001
102400,25235,120388,"(STARFRUIT, MARKET << US, 5047, 1, 102400)
(STARFRUIT, MARKET << US, 5047, 1, 102400)
(STARFRUIT, MARKET << US, 5047, 1, 102400)
(STARFRUIT, MARKET << US, 5047, 1, 102400)
(STARFRUIT, MARKET << US, 5047, 1, 102400)","{""AMETHYSTS"": -15, ""STARFRUIT"": 6}",664,5046,10000
102600,-10190,110198,"(AMETHYSTS, MARKET << US, 9998, 1, 102600)
(STARFRUIT, US << MARKET, 5047, 1, 102600)
(STARFRUIT, US << MARKET, 5047, 1, 102600)
(STARFRUIT, US << MARKET, 5047, 1, 102600)
(STARFRUIT, US << MARKET, 5047, 1, 102600)","{""AMETHYSTS"": -16, ""STARFRUIT"": 10}",682,5050,10001
102900,-5052,105146,"(STARFRUIT, US << MARKET, 5052, 1, 102900)","{""AMETHYSTS"": -16, ""STARFRUIT"": 11}",734,5052,9999
103100,-20196,84950,"(STARFRUIT, US << MARKET, 5049, 1, 103100)
(STARFRUIT, US << MARKET, 5049, 1, 103100)
(STARFRUIT, US << MARKET, 5049, 1, 103100)
(STARFRUIT, US << MARKET, 5049, 1, 103100)","{""AMETHYSTS"": -16, ""STARFRUIT"": 15}",687,5047,9998
103700,-19996,64954,"(AMETHYSTS, US << MARKET, 9998, 1, 103700)
(AMETHYSTS, US << MARKET, 9998, 1, 103700)","{""AMETHYSTS"": -14, ""STARFRUIT"": 15}",730,5048,9996
103900,-19996,44958,"(AMETHYSTS, US << MARKET, 9998, 1, 103900)
(AMETHYSTS, US << MARKET, 9998, 1, 103900)","{""AMETHYSTS"": -12, ""STARFRUIT"": 15}",666,5048,10001
104000,19996,64954,"(AMETHYSTS, MARKET << US, 9998, 1, 104000)
(AMETHYSTS, MARKET << US, 9998, 1, 104000)","{""AMETHYSTS"": -14, ""STARFRUIT"": 15}",716,5048,9997
104800,-39992,24962,"(AMETHYSTS, US << MARKET, 9998, 1, 104800)
(AMETHYSTS, US << MARKET, 9998, 1, 104800)
(AMETHYSTS, US << MARKET, 9998, 1, 104800)
(AMETHYSTS, US << MARKET, 9998, 1, 104800)","{""AMETHYSTS"": -10, ""STARFRUIT"": 15}",687,5049,10001
105000,-99950,-74988,"(AMETHYSTS, US << MARKET, 9995, 1, 105000)
(AMETHYSTS, US << MARKET, 9995, 1, 105000)
(AMETHYSTS, US << MARKET, 9995, 1, 105000)
(AMETHYSTS, US << MARKET, 9995, 1, 105000)
(AMETHYSTS, US << MARKET, 9995, 1, 105000)
(AMETHYSTS, US << MARKET, 9995, 1, 105000)
(AMETHYSTS, US << MARKET, 9995, 1, 105000)
(AMETHYSTS, US << MARKET, 9995, 1, 105000)
(AMETHYSTS, US << MARKET, 9995, 1, 105000)
(AMETHYSTS, US << MARKET, 9995, 1, 105000)","{""AMETHYSTS"": 0, ""STARFRUIT"": 15}",762,5050,10000
105500,5049,-69939,"(STARFRUIT, MARKET << US, 5049, 1, 105500)","{""AMETHYSTS"": 0, ""STARFRUIT"": 14}",775,5051,10000
105700,29994,-39945,"(AMETHYSTS, MARKET << US, 9998, 1, 105700)
(AMETHYSTS, MARKET << US, 9998, 1, 105700)
(AMETHYSTS, MARKET << US, 9998, 1, 105700)","{""AMETHYSTS"": -3, ""STARFRUIT"": 14}",803,5053,9998
105800,-20200,-60145,"(STARFRUIT, US << MARKET, 5050, 1, 105800)
(STARFRUIT, US << MARKET, 5050, 1, 105800)
(STARFRUIT, US << MARKET, 5050, 1, 105800)
(STARFRUIT, US << MARKET, 5050, 1, 105800)","{""AMETHYSTS"": -3, ""STARFRUIT"": 18}",737,5049,10000
106100,-10002,-70147,"(AMETHYSTS, US << MARKET, 10002, 1, 106100)","{""AMETHYSTS"": -2, ""STARFRUIT"": 18}",773,5051,9999
106300,5047,-65100,"(STARFRUIT, MARKET << US, 5047, 1, 106300)","{""AMETHYSTS"": -2, ""STARFRUIT"": 17}",750,5050,10000
106400,-10094,-75194,"(STARFRUIT, US << MARKET, 5047, 1, 106400)
(STARFRUIT, US << MARKET, 5047, 1, 106400)
(STARFRUIT, US << MARKET, 5047, 1, 106400)
(STARFRUIT, MARKET << US, 5047, 1, 106400)","{""AMETHYSTS"": -2, ""STARFRUIT"": 19}",756,5050,10000
106500,14957,-60237,"(AMETHYSTS, MARKET << US, 10005, 1, 106500)
(AMETHYSTS, MARKET << US, 10005, 1, 106500)
(STARFRUIT, US << MARKET, 5053, 1, 106500)","{""AMETHYSTS"": -4, ""STARFRUIT"": 20}",759,5050,10001
106800,9998,-50239,"(AMETHYSTS, MARKET << US, 9998, 1, 106800)","{""AMETHYSTS"": -5, ""STARFRUIT"": 20}",736,5049,10001
107600,0,-50239,,"{""AMETHYSTS"": -5, ""STARFRUIT"": 20}",771,5050,9998
107800,-14946,-65185,"(AMETHYSTS, US << MARKET, 9996, 1, 107800)
(AMETHYSTS, US << MARKET, 9996, 1, 107800)
(STARFRUIT, MARKET << US, 5046, 1, 107800)","{""AMETHYSTS"": -3, ""STARFRUIT"": 19}",727,5048,10000
107900,5051,-60134,"(STARFRUIT, MARKET << US, 5051, 1, 107900)","{""AMETHYSTS"": -3, ""STARFRUIT"": 18}",790,5051,9998
108000,-10094,-70228,"(STARFRUIT, US << MARKET, 5047, 1, 108000)
(STARFRUIT, US << MARKET, 5047, 1, 108000)","{""AMETHYSTS"": -3, ""STARFRUIT"": 20}",769,5050,10001
108300,-19996,-90224,"(AMETHYSTS, US << MARKET, 9998, 1, 108300)
(AMETHYSTS, US << MARKET, 9998, 1, 108300)","{""AMETHYSTS"": -1, ""STARFRUIT"": 20}",673,5045,10003
108600,49990,-40234,"(AMETHYSTS, MARKET << US, 9998, 1, 108600)
(AMETHYSTS, MARKET << US, 9998, 1, 108600)
(AMETHYSTS, MARKET << US, 9998, 1, 108600)
(AMETHYSTS, MARKET << US, 9998, 1, 108600)
(AMETHYSTS, MARKET << US, 9998, 1, 108600)","{""AMETHYSTS"": -6, ""STARFRUIT"": 20}",764,5049,9997
108800,50120,9886,"(AMETHYSTS, MARKET << US, 10004, 1, 108800)
(AMETHYSTS, MARKET << US, 10004, 1, 108800)
(AMETHYSTS, MARKET << US, 10004, 1, 108800)
(AMETHYSTS, MARKET << US, 10004, 1, 108800)
(STARFRUIT, MARKET << US, 5052, 1, 108800)
(STARFRUIT, MARKET << US, 5052, 1, 108800)","{""AMETHYSTS"": -10, ""STARFRUIT"": 18}",804,5051,10000
108900,-89964,-80078,"(AMETHYSTS, US << MARKET, 9996, 1, 108900)
(AMETHYSTS, US << MARKET, 9996, 1, 108900)
(AMETHYSTS, US << MARKET, 9996, 1, 108900)
(AMETHYSTS, US << MARKET, 9996, 1, 108900)
(AMETHYSTS, US << MARKET, 9996, 1, 108900)
(AMETHYSTS, US << MARKET, 9996, 1, 108900)
(AMETHYSTS, US << MARKET, 9996, 1, 108900)
(AMETHYSTS, US << MARKET, 9996, 1, 108900)
(AMETHYSTS, US << MARKET, 9996, 1, 108900)
(AMETHYSTS, US << MARKET, 9996, 1, 108900)
(AMETHYSTS, MARKET << US, 9996, 1, 108900)","{""AMETHYSTS"": -1, ""STARFRUIT"": 18}",787,5048,9999
109000,5046,-75032,"(STARFRUIT, MARKET << US, 5046, 1, 109000)","{""AMETHYSTS"": -1, ""STARFRUIT"": 17}",800,5049,10001
109100,25250,-49782,"(STARFRUIT, MARKET << US, 5050, 1, 109100)
(STARFRUIT, MARKET << US, 5050, 1, 109100)
(STARFRUIT, MARKET << US, 5050, 1, 109100)
(STARFRUIT, MARKET << US, 5050, 1, 109100)
(STARFRUIT, MARKET << US, 5050, 1, 109100)","{""AMETHYSTS"": -1, ""STARFRUIT"": 12}",783,5047,9999
109200,35350,-14432,"(STARFRUIT, MARKET << US, 5050, 1, 109200)
(STARFRUIT, MARKET << US, 5050, 1, 109200)
(STARFRUIT, MARKET << US, 5050, 1, 109200)
(STARFRUIT, MARKET << US, 5050, 1, 109200)
(STARFRUIT, MARKET << US, 5050, 1, 109200)
(STARFRUIT, MARKET << US, 5050, 1, 109200)
(STARFRUIT, MARKET << US, 5050, 1, 109200)","{""AMETHYSTS"": -1, ""STARFRUIT"": 5}",823,5051,10000
109600,-10090,-24522,"(STARFRUIT, US << MARKET, 5045, 1, 109600)
(STARFRUIT, US << MARKET, 5045, 1, 109600)","{""AMETHYSTS"": -1, ""STARFRUIT"": 7}",806,5047,10001
109700,14957,-9565,"(AMETHYSTS, MARKET << US, 10004, 1, 109700)
(AMETHYSTS, MARKET << US, 10004, 1, 109700)
(STARFRUIT, US << MARKET, 5051, 1, 109700)","{""AMETHYSTS"": -3, ""STARFRUIT"": 8}",819,5048,10000
110200,5044,-4521,"(STARFRUIT, MARKET << US, 5044, 1, 110200)","{""AMETHYSTS"": -3, ""STARFRUIT"": 7}",808,5047,10000
110500,-20176,-24697,"(STARFRUIT, US << MARKET, 5044, 1, 110500)
(STARFRUIT, US << MARKET, 5044, 1, 110500)
(STARFRUIT, US << MARKET, 5044, 1, 110500)
(STARFRUIT, US << MARKET, 5044, 1, 110500)","{""AMETHYSTS"": -3, ""STARFRUIT"": 11}",809,5046,10000
110600,-19996,-44693,"(AMETHYSTS, US << MARKET, 9998, 1, 110600)
(AMETHYSTS, US << MARKET, 9998, 1, 110600)","{""AMETHYSTS"": -1, ""STARFRUIT"": 11}",827,5047,9997
110700,-10002,-54695,"(AMETHYSTS, US << MARKET, 10002, 1, 110700)","{""AMETHYSTS"": 0, ""STARFRUIT"": 11}",822,5047,10003
111000,35343,-19352,"(STARFRUIT, MARKET << US, 5049, 1, 111000)
(STARFRUIT, MARKET << US, 5049, 1, 111000)
(STARFRUIT, MARKET << US, 5049, 1, 111000)
(STARFRUIT, MARKET << US, 5049, 1, 111000)
(STARFRUIT, MARKET << US, 5049, 1, 111000)
(STARFRUIT, MARKET << US, 5049, 1, 111000)
(STARFRUIT, MARKET << US, 5049, 1, 111000)","{""AMETHYSTS"": 0, ""STARFRUIT"": 4}",848,5050,10000
111100,-10088,-29440,"(STARFRUIT, US << MARKET, 5044, 1, 111100)
(STARFRUIT, US << MARKET, 5044, 1, 111100)","{""AMETHYSTS"": 0, ""STARFRUIT"": 6}",842,5047,10000
111200,5044,-24396,"(STARFRUIT, MARKET << US, 5044, 1, 111200)","{""AMETHYSTS"": 0, ""STARFRUIT"": 5}",819,5043,10001
111300,-10086,-34482,"(STARFRUIT, US << MARKET, 5043, 1, 111300)
(STARFRUIT, US << MARKET, 5043, 1, 111300)","{""AMETHYSTS"": 0, ""STARFRUIT"": 7}",833,5045,9999
111800,14959,-19523,"(AMETHYSTS, MARKET << US, 10004, 1, 111800)
(AMETHYSTS, MARKET << US, 10004, 1, 111800)
(STARFRUIT, US << MARKET, 5049, 1, 111800)","{""AMETHYSTS"": -2, ""STARFRUIT"": 8}",845,5046,10000
112000,-10096,-29619,"(STARFRUIT, US << MARKET, 5048, 1, 112000)
(STARFRUIT, US << MARKET, 5048, 1, 112000)","{""AMETHYSTS"": -2, ""STARFRUIT"": 10}",841,5046,10000
112300,5043,-24576,"(STARFRUIT, MARKET << US, 5043, 1, 112300)","{""AMETHYSTS"": -2, ""STARFRUIT"": 9}",847,5047,10000
112800,-20188,-44764,"(STARFRUIT, US << MARKET, 5047, 1, 112800)
(STARFRUIT, US << MARKET, 5047, 1, 112800)
(STARFRUIT, US << MARKET, 5047, 1, 112800)
(STARFRUIT, US << MARKET, 5047, 1, 112800)","{""AMETHYSTS"": -2, ""STARFRUIT"": 13}",864,5048,9998
113500,5048,-39716,"(STARFRUIT, MARKET << US, 5048, 1, 113500)","{""AMETHYSTS"": -2, ""STARFRUIT"": 12}",858,5048,10001
113900,20004,-19712,"(AMETHYSTS, MARKET << US, 10002, 1, 113900)
(AMETHYSTS, MARKET << US, 10002, 1, 113900)","{""AMETHYSTS"": -4, ""STARFRUIT"": 12}",828,5045,10000
114300,14962,-4750,"(AMETHYSTS, MARKET << US, 10004, 1, 114300)
(AMETHYSTS, MARKET << US, 10004, 1, 114300)
(STARFRUIT, US << MARKET, 5046, 1, 114300)","{""AMETHYSTS"": -6, ""STARFRUIT"": 13}",822,5044,10000
114500,104914,100164,"(AMETHYSTS, MARKET << US, 9996, 1, 114500)
(AMETHYSTS, MARKET << US, 9996, 1, 114500)
(AMETHYSTS, MARKET << US, 9996, 1, 114500)
(AMETHYSTS, MARKET << US, 9996, 1, 114500)
(AMETHYSTS, MARKET << US, 9996, 1, 114500)
(AMETHYSTS, MARKET << US, 9996, 1, 114500)
(AMETHYSTS, MARKET << US, 9996, 1, 114500)
(AMETHYSTS, MARKET << US, 9996, 1, 114500)
(AMETHYSTS, MARKET << US, 9996, 1, 114500)
(AMETHYSTS, MARKET << US, 9996, 1, 114500)
(AMETHYSTS, MARKET << US, 9996, 1, 114500)
(STARFRUIT, US << MARKET, 5042, 1, 114500)","{""AMETHYSTS"": -17, ""STARFRUIT"": 14}",794,5045,10000
114600,20192,120356,"(STARFRUIT, MARKET << US, 5048, 1, 114600)
(STARFRUIT, MARKET << US, 5048, 1, 114600)
(STARFRUIT, MARKET << US, 5048, 1, 114600)
(STARFRUIT, MARKET << US, 5048, 1, 114600)","{""AMETHYSTS"": -17, ""STARFRUIT"": 10}",806,5045,10000
115100,25235,145591,"(STARFRUIT, US << MARKET, 5041, 1, 115100)
(STARFRUIT, MARKET << US, 5046, 1, 115100)
(STARFRUIT, MARKET << US, 5046, 1, 115100)
(STARFRUIT, MARKET << US, 5046, 1, 115100)
(STARFRUIT, MARKET << US, 5046, 1, 115100)
(STARFRUIT, MARKET << US, 5046, 1, 115100)
(STARFRUIT, MARKET << US, 5046, 1, 115100)","{""AMETHYSTS"": -17, ""STARFRUIT"": 5}",821,5046,10000
116100,25056,170647,"(AMETHYSTS, MARKET << US, 10005, 1, 116100)
(AMETHYSTS, MARKET << US, 10005, 1, 116100)
(STARFRUIT, MARKET << US, 5046, 1, 116100)","{""AMETHYSTS"": -19, ""STARFRUIT"": 4}",819,5043,10000
116300,9996,180643,"(AMETHYSTS, MARKET << US, 9996, 1, 116300)","{""AMETHYSTS"": -20, ""STARFRUIT"": 4}",875,5043,9997
116400,10094,190737,"(STARFRUIT, MARKET << US, 5047, 1, 116400)
(STARFRUIT, MARKET << US, 5047, 1, 116400)","{""AMETHYSTS"": -20, ""STARFRUIT"": 2}",885,5044,9997
116600,20171,210908,"(STARFRUIT, MARKET << US, 5043, 1, 116600)
(STARFRUIT, MARKET << US, 5043, 1, 116600)
(STARFRUIT, MARKET << US, 5043, 1, 116600)
(STARFRUIT, MARKET << US, 5042, 1, 116600)","{""AMETHYSTS"": -20, ""STARFRUIT"": -2}",826,5041,10000
116800,-20160,190748,"(STARFRUIT, US << MARKET, 5040, 1, 116800)
(STARFRUIT, US << MARKET, 5040, 1, 116800)
(STARFRUIT, US << MARKET, 5040, 1, 116800)
(STARFRUIT, US << MARKET, 5040, 1, 116800)","{""AMETHYSTS"": -20, ""STARFRUIT"": 2}",834,5043,10000
116900,-25205,165543,"(STARFRUIT, US << MARKET, 5041, 1, 116900)
(STARFRUIT, US << MARKET, 5041, 1, 116900)
(STARFRUIT, US << MARKET, 5041, 1, 116900)
(STARFRUIT, US << MARKET, 5041, 1, 116900)
(STARFRUIT, US << MARKET, 5041, 1, 116900)","{""AMETHYSTS"": -20, ""STARFRUIT"": 7}",823,5040,10000
117100,-5045,160498,"(STARFRUIT, US << MARKET, 5045, 1, 117100)","{""AMETHYSTS"": -20, ""STARFRUIT"": 8}",854,5042,9999
117300,25200,185698,"(STARFRUIT, US << MARKET, 5046, 1, 117300)
(STARFRUIT, MARKET << US, 5041, 1, 117300)
(STARFRUIT, MARKET << US, 5041, 1, 117300)
(STARFRUIT, MARKET << US, 5041, 1, 117300)
(STARFRUIT, MARKET << US, 5041, 1, 117300)
(STARFRUIT, MARKET << US, 5041, 1, 117300)
(STARFRUIT, MARKET << US, 5041, 1, 117300)","{""AMETHYSTS"": -20, ""STARFRUIT"": 3}",818,5040,10000
117500,0,185698,,"{""AMETHYSTS"": -20, ""STARFRUIT"": 3}",844,5042,9999
117800,15126,200824,"(STARFRUIT, MARKET << US, 5042, 1, 117800)
(STARFRUIT, MARKET << US, 5042, 1, 117800)
(STARFRUIT, MARKET << US, 5042, 1, 117800)","{""AMETHYSTS"": -20, ""STARFRUIT"": 0}",844,5041,9999
117900,0,200824,,"{""AMETHYSTS"": -20, ""STARFRUIT"": 0}",884,5045,9997
118100,-30102,170722,"(AMETHYSTS, US << MARKET, 10005, 1, 118100)
(AMETHYSTS, US << MARKET, 10005, 1, 118100)
(STARFRUIT, US << MARKET, 5046, 1, 118100)
(STARFRUIT, US << MARKET, 5046, 1, 118100)","{""AMETHYSTS"": -18, ""STARFRUIT"": 2}",754,5043,10003
118200,30092,200814,"(AMETHYSTS, MARKET << US, 10002, 1, 118200)
(AMETHYSTS, MARKET << US, 10002, 1, 118200)
(STARFRUIT, US << MARKET, 5047, 1, 118200)
(STARFRUIT, US << MARKET, 5047, 1, 118200)
(STARFRUIT, MARKET << US, 5047, 1, 118200)
(STARFRUIT, MARKET << US, 5045, 1, 118200)
(STARFRUIT, MARKET << US, 5045, 1, 118200)
(STARFRUIT, MARKET << US, 5045, 1, 118200)","{""AMETHYSTS"": -20, ""STARFRUIT"": 0}",834,5046,9999
118300,-14886,185928,"(AMETHYSTS, US << MARKET, 10002, 1, 118300)
(AMETHYSTS, US << MARKET, 10002, 1, 118300)
(AMETHYSTS, US << MARKET, 10002, 1, 118300)
(STARFRUIT, MARKET << US, 5040, 1, 118300)
(STARFRUIT, MARKET << US, 5040, 1, 118300)
(STARFRUIT, MARKET << US, 5040, 1, 118300)","{""AMETHYSTS"": -17, ""STARFRUIT"": -3}",757,5040,10003
119000,2,185930,"(AMETHYSTS, US << MARKET, 9996, 1, 119000)
(AMETHYSTS, US << MARKET, 9996, 1, 119000)
(AMETHYSTS, MARKET << US, 9998, 1, 119000)
(AMETHYSTS, MARKET << US, 9996, 1, 119000)","{""AMETHYSTS"": -17, ""STARFRUIT"": -3}",846,5045,9997
119100,-10002,175928,"(AMETHYSTS, US << MARKET, 10002, 1, 119100)","{""AMETHYSTS"": -16, ""STARFRUIT"": -3}",748,5044,10003
119200,14950,190878,"(AMETHYSTS, MARKET << US, 9996, 1, 119200)
(AMETHYSTS, MARKET << US, 9996, 1, 119200)
(STARFRUIT, US << MARKET, 5042, 1, 119200)
(STARFRUIT, US << MARKET, 5042, 1, 119200)
(STARFRUIT, MARKET << US, 5042, 1, 119200)","{""AMETHYSTS"": -18, ""STARFRUIT"": -2}",788,5045,10000
119800,5042,195920,"(STARFRUIT, MARKET << US, 5042, 1, 119800)","{""AMETHYSTS"": -18, ""STARFRUIT"": -3}",782,5046,10000
119900,-10096,185824,"(STARFRUIT, US << MARKET, 5048, 1, 119900)
(STARFRUIT, US << MARKET, 5048, 1, 119900)","{""AMETHYSTS"": -18, ""STARFRUIT"": -1}",797,5045,9999
120100,-15141,170683,"(STARFRUIT, US << MARKET, 5047, 1, 120100)
(STARFRUIT, US << MARKET, 5047, 1, 120100)
(STARFRUIT, US << MARKET, 5047, 1, 120100)
(STARFRUIT, US << MARKET, 5047, 1, 120100)
(STARFRUIT, US << MARKET, 5047, 1, 120100)
(STARFRUIT, US << MARKET, 5047, 1, 120100)
(STARFRUIT, MARKET << US, 5047, 1, 120100)
(STARFRUIT, MARKET << US, 5047, 1, 120100)
(STARFRUIT, MARKET << US, 5047, 1, 120100)","{""AMETHYSTS"": -18, ""STARFRUIT"": 2}",777,5047,10000
120200,-4960,165723,"(AMETHYSTS, US << MARKET, 10002, 1, 120200)
(STARFRUIT, MARKET << US, 5042, 1, 120200)","{""AMETHYSTS"": -17, ""STARFRUIT"": 1}",716,5044,10003
120900,30006,195729,"(AMETHYSTS, MARKET << US, 10002, 1, 120900)
(AMETHYSTS, MARKET << US, 10002, 1, 120900)
(AMETHYSTS, MARKET << US, 10002, 1, 120900)","{""AMETHYSTS"": -20, ""STARFRUIT"": 1}",712,5043,10003
121000,-4954,190775,"(AMETHYSTS, US << MARKET, 10004, 1, 121000)
(STARFRUIT, MARKET << US, 5050, 1, 121000)","{""AMETHYSTS"": -19, ""STARFRUIT"": 0}",775,5046,10000
121300,15049,205824,"(AMETHYSTS, MARKET << US, 10004, 1, 121300)
(STARFRUIT, MARKET << US, 5045, 1, 121300)","{""AMETHYSTS"": -20, ""STARFRUIT"": -1}",780,5044,10000
121600,4,205828,"(STARFRUIT, US << MARKET, 5050, 1, 121600)
(STARFRUIT, US << MARKET, 5050, 1, 121600)
(STARFRUIT, MARKET << US, 5052, 1, 121600)
(STARFRUIT, MARKET << US, 5052, 1, 121600)","{""AMETHYSTS"": -20, ""STARFRUIT"": -1}",797,5051,9999
121700,-10100,195728,"(STARFRUIT, US << MARKET, 5050, 1, 121700)
(STARFRUIT, US << MARKET, 5050, 1, 121700)","{""AMETHYSTS"": -20, ""STARFRUIT"": 1}",778,5050,10000
121800,-30078,165650,"(AMETHYSTS, US << MARKET, 9995, 1, 121800)
(AMETHYSTS, US << MARKET, 9995, 1, 121800)
(STARFRUIT, US << MARKET, 5044, 1, 121800)
(STARFRUIT, US << MARKET, 5044, 1, 121800)","{""AMETHYSTS"": -18, ""STARFRUIT"": 3}",827,5047,9998
122200,-96,165554,"(AMETHYSTS, MARKET << US, 9996, 1, 122200)
(STARFRUIT, US << MARKET, 5046, 1, 122200)
(STARFRUIT, US << MARKET, 5046, 1, 122200)","{""AMETHYSTS"": -19, ""STARFRUIT"": 5}",799,5049,10000
122500,-39900,125654,"(AMETHYSTS, US << MARKET, 10002, 1, 122500)
(AMETHYSTS, US << MARKET, 10002, 1, 122500)
(AMETHYSTS, US << MARKET, 10002, 1, 122500)
(AMETHYSTS, US << MARKET, 10002, 1, 122500)
(AMETHYSTS, US << MARKET, 10002, 1, 122500)
(AMETHYSTS, US << MARKET, 10002, 1, 122500)
(AMETHYSTS, MARKET << US, 10004, 1, 122500)
(STARFRUIT, MARKET << US, 5054, 1, 122500)
(STARFRUIT, MARKET << US, 5054, 1, 122500)","{""AMETHYSTS"": -14, ""STARFRUIT"": 3}",821,5051,9999
122600,-79984,45670,"(AMETHYSTS, US << MARKET, 9998, 1, 122600)
(AMETHYSTS, US << MARKET, 9998, 1, 122600)
(AMETHYSTS, US << MARKET, 9998, 1, 122600)
(AMETHYSTS, US << MARKET, 9998, 1, 122600)
(AMETHYSTS, US << MARKET, 9998, 1, 122600)
(AMETHYSTS, US << MARKET, 9998, 1, 122600)
(AMETHYSTS, US << MARKET, 9998, 1, 122600)
(AMETHYSTS, US << MARKET, 9998, 1, 122600)","{""AMETHYSTS"": -6, ""STARFRUIT"": 3}",826,5054,10001
122700,-50010,-4340,"(AMETHYSTS, US << MARKET, 10002, 1, 122700)
(AMETHYSTS, US << MARKET, 10002, 1, 122700)
(AMETHYSTS, US << MARKET, 10002, 1, 122700)
(AMETHYSTS, US << MARKET, 10002, 1, 122700)
(AMETHYSTS, US << MARKET, 10002, 1, 122700)","{""AMETHYSTS"": -1, ""STARFRUIT"": 3}",807,5050,10003
122800,-10096,-14436,"(STARFRUIT, US << MARKET, 5048, 1, 122800)
(STARFRUIT, US << MARKET, 5048, 1, 122800)","{""AMETHYSTS"": -1, ""STARFRUIT"": 5}",819,5051,10000
123100,-10002,-24438,"(AMETHYSTS, US << MARKET, 10002, 1, 123100)","{""AMETHYSTS"": 0, ""STARFRUIT"": 5}",822,5052,10003
123200,5052,-19386,"(STARFRUIT, US << MARKET, 5052, 1, 123200)
(STARFRUIT, US << MARKET, 5052, 1, 123200)
(STARFRUIT, MARKET << US, 5052, 1, 123200)
(STARFRUIT, MARKET << US, 5052, 1, 123200)
(STARFRUIT, MARKET << US, 5052, 1, 123200)","{""AMETHYSTS"": 0, ""STARFRUIT"": 4}",814,5050,9997
123500,9904,-9482,"(AMETHYSTS, MARKET << US, 9998, 1, 123500)
(AMETHYSTS, MARKET << US, 9998, 1, 123500)
(STARFRUIT, US << MARKET, 5046, 1, 123500)
(STARFRUIT, US << MARKET, 5046, 1, 123500)","{""AMETHYSTS"": -2, ""STARFRUIT"": 6}",816,5050,10001
123700,-30084,-39566,"(AMETHYSTS, US << MARKET, 9996, 1, 123700)
(AMETHYSTS, US << MARKET, 9996, 1, 123700)
(STARFRUIT, US << MARKET, 5046, 1, 123700)
(STARFRUIT, US << MARKET, 5046, 1, 123700)","{""AMETHYSTS"": 0, ""STARFRUIT"": 8}",826,5049,10000
123900,-25042,-64608,"(AMETHYSTS, US << MARKET, 9998, 1, 123900)
(AMETHYSTS, US << MARKET, 9998, 1, 123900)
(STARFRUIT, US << MARKET, 5046, 1, 123900)","{""AMETHYSTS"": 2, ""STARFRUIT"": 9}",797,5045,10000
124000,20004,-44604,"(AMETHYSTS, MARKET << US, 10002, 1, 124000)
(AMETHYSTS, MARKET << US, 10002, 1, 124000)","{""AMETHYSTS"": 0, ""STARFRUIT"": 9}",828,5048,10003
124200,-79780,-124384,"(AMETHYSTS, US << MARKET, 9998, 1, 124200)
(AMETHYSTS, US << MARKET, 9998, 1, 124200)
(AMETHYSTS, US << MARKET, 9998, 1, 124200)
(AMETHYSTS, US << MARKET, 9998, 1, 124200)
(AMETHYSTS, US << MARKET, 9998, 1, 124200)
(AMETHYSTS, US << MARKET, 9998, 1, 124200)
(AMETHYSTS, US << MARKET, 9998, 1, 124200)
(AMETHYSTS, US << MARKET, 9998, 1, 124200)
(AMETHYSTS, US << MARKET, 9998, 1, 124200)
(AMETHYSTS, US << MARKET, 9998, 1, 124200)
(STARFRUIT, MARKET << US, 5050, 1, 124200)
(STARFRUIT, MARKET << US, 5050, 1, 124200)
(STARFRUIT, MARKET << US, 5050, 1, 124200)
(STARFRUIT, MARKET << US, 5050, 1, 124200)","{""AMETHYSTS"": 10, ""STARFRUIT"": 5}",841,5051,9997
125200,5055,-119329,"(STARFRUIT, MARKET << US, 5055, 1, 125200)","{""AMETHYSTS"": 10, ""STARFRUIT"": 4}",901,5055,10001
125400,25065,-94264,"(AMETHYSTS, MARKET << US, 10004, 1, 125400)
(AMETHYSTS, MARKET << US, 10004, 1, 125400)
(STARFRUIT, MARKET << US, 5057, 1, 125400)","{""AMETHYSTS"": 8, ""STARFRUIT"": 3}",895,5053,10000
125900,-102,-94366,"(AMETHYSTS, MARKET << US, 9998, 1, 125900)
(STARFRUIT, US << MARKET, 5050, 1, 125900)
(STARFRUIT, US << MARKET, 5050, 1, 125900)","{""AMETHYSTS"": 7, ""STARFRUIT"": 5}",918,5054,10002
126200,5049,-89317,"(STARFRUIT, MARKET << US, 5049, 1, 126200)","{""AMETHYSTS"": 7, ""STARFRUIT"": 4}",894,5051,10001
126400,9884,-79433,"(AMETHYSTS, MARKET << US, 9998, 1, 126400)
(AMETHYSTS, MARKET << US, 9998, 1, 126400)
(STARFRUIT, US << MARKET, 5056, 1, 126400)
(STARFRUIT, US << MARKET, 5056, 1, 126400)","{""AMETHYSTS"": 5, ""STARFRUIT"": 6}",870,5053,9997
126600,5050,-74383,"(STARFRUIT, MARKET << US, 5050, 1, 126600)","{""AMETHYSTS"": 5, ""STARFRUIT"": 5}",887,5053,10001
126700,19996,-54387,"(AMETHYSTS, MARKET << US, 9998, 1, 126700)
(AMETHYSTS, MARKET << US, 9998, 1, 126700)","{""AMETHYSTS"": 3, ""STARFRUIT"": 5}",859,5051,9997
126900,9894,-44493,"(AMETHYSTS, MARKET << US, 10002, 1, 126900)
(AMETHYSTS, MARKET << US, 10002, 1, 126900)
(STARFRUIT, US << MARKET, 5055, 1, 126900)
(STARFRUIT, US << MARKET, 5055, 1, 126900)","{""AMETHYSTS"": 1, ""STARFRUIT"": 7}",862,5051,9998
127000,30006,-14487,"(AMETHYSTS, US << MARKET, 10002, 1, 127000)
(AMETHYSTS, MARKET << US, 10002, 1, 127000)
(AMETHYSTS, MARKET << US, 10002, 1, 127000)
(AMETHYSTS, MARKET << US, 10002, 1, 127000)
(AMETHYSTS, MARKET << US, 10002, 1, 127000)","{""AMETHYSTS"": -2, ""STARFRUIT"": 7}",871,5052,10003
127100,-19996,-34483,"(AMETHYSTS, US << MARKET, 9998, 1, 127100)
(AMETHYSTS, US << MARKET, 9998, 1, 127100)","{""AMETHYSTS"": 0, ""STARFRUIT"": 7}",881,5052,9997
127500,-40116,-74599,"(AMETHYSTS, US << MARKET, 10002, 1, 127500)
(AMETHYSTS, US << MARKET, 10002, 1, 127500)
(AMETHYSTS, US << MARKET, 10002, 1, 127500)
(STARFRUIT, US << MARKET, 5055, 1, 127500)
(STARFRUIT, US << MARKET, 5055, 1, 127500)","{""AMETHYSTS"": 3, ""STARFRUIT"": 9}",866,5052,9999
127800,25250,-49349,"(STARFRUIT, MARKET << US, 5050, 1, 127800)
(STARFRUIT, MARKET << US, 5050, 1, 127800)
(STARFRUIT, MARKET << US, 5050, 1, 127800)
(STARFRUIT, MARKET << US, 5050, 1, 127800)
(STARFRUIT, MARKET << US, 5050, 1, 127800)","{""AMETHYSTS"": 3, ""STARFRUIT"": 4}",837,5048,9998
128000,-20004,-69353,"(AMETHYSTS, US << MARKET, 10002, 1, 128000)
(AMETHYSTS, US << MARKET, 10002, 1, 128000)","{""AMETHYSTS"": 5, ""STARFRUIT"": 4}",862,5050,10003
128100,-15150,-84503,"(STARFRUIT, US << MARKET, 5050, 1, 128100)
(STARFRUIT, US << MARKET, 5050, 1, 128100)
(STARFRUIT, US << MARKET, 5050, 1, 128100)","{""AMETHYSTS"": 5, ""STARFRUIT"": 7}",828,5048,9999
128400,30102,-54401,"(AMETHYSTS, MARKET << US, 10002, 1, 128400)
(AMETHYSTS, MARKET << US, 10002, 1, 128400)
(STARFRUIT, MARKET << US, 5049, 1, 128400)
(STARFRUIT, MARKET << US, 5049, 1, 128400)","{""AMETHYSTS"": 3, ""STARFRUIT"": 5}",863,5051,10003
128800,25270,-29131,"(STARFRUIT, MARKET << US, 5054, 1, 128800)
(STARFRUIT, MARKET << US, 5054, 1, 128800)
(STARFRUIT, MARKET << US, 5054, 1, 128800)
(STARFRUIT, MARKET << US, 5054, 1, 128800)
(STARFRUIT, MARKET << US, 5054, 1, 128800)","{""AMETHYSTS"": 3, ""STARFRUIT"": 0}",872,5050,10001
129000,-10094,-39225,"(STARFRUIT, US << MARKET, 5047, 1, 129000)
(STARFRUIT, US << MARKET, 5047, 1, 129000)","{""AMETHYSTS"": 3, ""STARFRUIT"": 2}",877,5051,10000
129200,5049,-34176,"(STARFRUIT, MARKET << US, 5049, 1, 129200)","{""AMETHYSTS"": 3, ""STARFRUIT"": 1}",866,5048,9998
129400,-4828,-39004,"(AMETHYSTS, US << MARKET, 9998, 1, 129400)
(AMETHYSTS, US << MARKET, 9998, 1, 129400)
(STARFRUIT, MARKET << US, 5056, 1, 129400)
(STARFRUIT, MARKET << US, 5056, 1, 129400)
(STARFRUIT, MARKET << US, 5056, 1, 129400)","{""AMETHYSTS"": 5, ""STARFRUIT"": -2}",872,5052,9996
129500,-19996,-59000,"(AMETHYSTS, US << MARKET, 9998, 1, 129500)
(AMETHYSTS, US << MARKET, 9998, 1, 129500)","{""AMETHYSTS"": 7, ""STARFRUIT"": -2}",875,5052,9997
129700,10102,-48898,"(STARFRUIT, MARKET << US, 5051, 1, 129700)
(STARFRUIT, MARKET << US, 5051, 1, 129700)","{""AMETHYSTS"": 7, ""STARFRUIT"": -4}",888,5050,9998
129800,-40230,-89128,"(AMETHYSTS, US << MARKET, 10005, 1, 129800)
(AMETHYSTS, US << MARKET, 10005, 1, 129800)
(STARFRUIT, US << MARKET, 5055, 1, 129800)
(STARFRUIT, US << MARKET, 5055, 1, 129800)
(STARFRUIT, US << MARKET, 5055, 1, 129800)
(STARFRUIT, US << MARKET, 5055, 1, 129800)","{""AMETHYSTS"": 9, ""STARFRUIT"": 0}",872,5051,10000
130100,5055,-84073,"(STARFRUIT, MARKET << US, 5055, 1, 130100)","{""AMETHYSTS"": 9, ""STARFRUIT"": -1}",863,5055,9999
130300,-20010,-104083,"(AMETHYSTS, US << MARKET, 10005, 1, 130300)
(AMETHYSTS, US << MARKET, 10005, 1, 130300)","{""AMETHYSTS"": 11, ""STARFRUIT"": -1}",865,5052,10000
130400,-5242,-109325,"(AMETHYSTS, MARKET << US, 10004, 1, 130400)
(AMETHYSTS, MARKET << US, 10004, 1, 130400)
(STARFRUIT, US << MARKET, 5050, 1, 130400)
(STARFRUIT, US << MARKET, 5050, 1, 130400)
(STARFRUIT, US << MARKET, 5050, 1, 130400)
(STARFRUIT, US << MARKET, 5050, 1, 130400)
(STARFRUIT, US << MARKET, 5050, 1, 130400)","{""AMETHYSTS"": 9, ""STARFRUIT"": 4}",918,5054,10003
130700,-20200,-129525,"(STARFRUIT, US << MARKET, 5050, 1, 130700)
(STARFRUIT, US << MARKET, 5050, 1, 130700)
(STARFRUIT, US << MARKET, 5050, 1, 130700)
(STARFRUIT, US << MARKET, 5050, 1, 130700)","{""AMETHYSTS"": 9, ""STARFRUIT"": 8}",899,5053,10000
130900,-5049,-134574,"(STARFRUIT, US << MARKET, 5049, 1, 130900)","{""AMETHYSTS"": 9, ""STARFRUIT"": 9}",894,5052,10000
131100,5051,-129523,"(STARFRUIT, MARKET << US, 5051, 1, 131100)","{""AMETHYSTS"": 9, ""STARFRUIT"": 8}",877,5050,10000
131200,5050,-124473,"(STARFRUIT, MARKET << US, 5050, 1, 131200)","{""AMETHYSTS"": 9, ""STARFRUIT"": 7}",891,5052,10000
131500,-102,-124575,"(AMETHYSTS, MARKET << US, 9996, 1, 131500)
(STARFRUIT, US << MARKET, 5049, 1, 131500)
(STARFRUIT, US << MARKET, 5049, 1, 131500)","{""AMETHYSTS"": 8, ""STARFRUIT"": 9}",893,5052,10000
131900,-20098,-144673,"(AMETHYSTS, US << MARKET, 9996, 1, 131900)
(AMETHYSTS, US << MARKET, 9996, 1, 131900)
(AMETHYSTS, MARKET << US, 9996, 1, 131900)
(STARFRUIT, US << MARKET, 5051, 1, 131900)
(STARFRUIT, US << MARKET, 5051, 1, 131900)","{""AMETHYSTS"": 9, ""STARFRUIT"": 11}",921,5054,10000
132100,20004,-124669,"(AMETHYSTS, MARKET << US, 10002, 1, 132100)
(AMETHYSTS, MARKET << US, 10002, 1, 132100)","{""AMETHYSTS"": 7, ""STARFRUIT"": 11}",935,5053,10003
132200,25063,-99606,"(AMETHYSTS, MARKET << US, 10004, 1, 132200)
(AMETHYSTS, MARKET << US, 10004, 1, 132200)
(STARFRUIT, MARKET << US, 5055, 1, 132200)","{""AMETHYSTS"": 5, ""STARFRUIT"": 10}",914,5052,10000
132300,25163,-74443,"(AMETHYSTS, US << MARKET, 9995, 1, 132300)
(AMETHYSTS, US << MARKET, 9995, 1, 132300)
(AMETHYSTS, MARKET << US, 9998, 1, 132300)
(AMETHYSTS, MARKET << US, 9998, 1, 132300)
(AMETHYSTS, MARKET << US, 9998, 1, 132300)
(STARFRUIT, MARKET << US, 5053, 1, 132300)
(STARFRUIT, MARKET << US, 5053, 1, 132300)
(STARFRUIT, MARKET << US, 5053, 1, 132300)","{""AMETHYSTS"": 4, ""STARFRUIT"": 7}",919,5054,9996
132600,-25046,-99489,"(AMETHYSTS, US << MARKET, 9998, 1, 132600)
(AMETHYSTS, US << MARKET, 9998, 1, 132600)
(STARFRUIT, US << MARKET, 5050, 1, 132600)","{""AMETHYSTS"": 6, ""STARFRUIT"": 8}",941,5053,10001
132800,-5051,-104540,"(STARFRUIT, US << MARKET, 5051, 1, 132800)","{""AMETHYSTS"": 6, ""STARFRUIT"": 9}",946,5054,10000
132900,-5055,-109595,"(STARFRUIT, US << MARKET, 5055, 1, 132900)","{""AMETHYSTS"": 6, ""STARFRUIT"": 10}",925,5052,10000
133000,-39992,-149587,"(AMETHYSTS, US << MARKET, 9998, 1, 133000)
(AMETHYSTS, US << MARKET, 9998, 1, 133000)
(AMETHYSTS, US << MARKET, 9998, 1, 133000)
(AMETHYSTS, US << MARKET, 9998, 1, 133000)","{""AMETHYSTS"": 10, ""STARFRUIT"": 10}",913,5053,9997
133200,5056,-144531,"(STARFRUIT, MARKET << US, 5056, 1, 133200)","{""AMETHYSTS"": 10, ""STARFRUIT"": 9}",992,5057,10001
133500,-50046,-194577,"(AMETHYSTS, US << MARKET, 10005, 1, 133500)
(AMETHYSTS, US << MARKET, 10005, 1, 133500)
(AMETHYSTS, US << MARKET, 10005, 1, 133500)
(AMETHYSTS, US << MARKET, 10005, 1, 133500)
(AMETHYSTS, US << MARKET, 10005, 1, 133500)
(AMETHYSTS, US << MARKET, 10005, 1, 133500)
(AMETHYSTS, US << MARKET, 10005, 1, 133500)
(AMETHYSTS, US << MARKET, 10005, 1, 133500)
(AMETHYSTS, MARKET << US, 9998, 1, 133500)
(AMETHYSTS, MARKET << US, 9998, 1, 133500)
(AMETHYSTS, MARKET << US, 9998, 1, 133500)","{""AMETHYSTS"": 15, ""STARFRUIT"": 9}",924,5054,10001
133600,5052,-189525,"(STARFRUIT, MARKET << US, 5052, 1, 133600)","{""AMETHYSTS"": 15, ""STARFRUIT"": 8}",868,5051,9999
134000,-5051,-194576,"(STARFRUIT, US << MARKET, 5051, 1, 134000)","{""AMETHYSTS"": 15, ""STARFRUIT"": 9}",901,5053,10000
134500,5056,-189520,"(STARFRUIT, MARKET << US, 5056, 1, 134500)","{""AMETHYSTS"": 15, ""STARFRUIT"": 8}",898,5056,9998
134700,9998,-179522,"(AMETHYSTS, MARKET << US, 9998, 1, 134700)","{""AMETHYSTS"": 14, ""STARFRUIT"": 8}",924,5054,10001
134800,-20208,-199730,"(STARFRUIT, US << MARKET, 5052, 1, 134800)
(STARFRUIT, US << MARKET, 5052, 1, 134800)
(STARFRUIT, US << MARKET, 5052, 1, 134800)
(STARFRUIT, US << MARKET, 5052, 1, 134800)","{""AMETHYSTS"": 14, ""STARFRUIT"": 12}",916,5055,9999
134900,-20208,-219938,"(STARFRUIT, US << MARKET, 5052, 1, 134900)
(STARFRUIT, US << MARKET, 5052, 1, 134900)
(STARFRUIT, US << MARKET, 5052, 1, 134900)
(STARFRUIT, US << MARKET, 5052, 1, 134900)","{""AMETHYSTS"": 14, ""STARFRUIT"": 16}",912,5054,9999
135600,25295,-194643,"(STARFRUIT, MARKET << US, 5059, 1, 135600)
(STARFRUIT, MARKET << US, 5059, 1, 135600)
(STARFRUIT, MARKET << US, 5059, 1, 135600)
(STARFRUIT, MARKET << US, 5059, 1, 135600)
(STARFRUIT, MARKET << US, 5059, 1, 135600)","{""AMETHYSTS"": 14, ""STARFRUIT"": 11}",962,5055,10000
135800,-5058,-199701,"(STARFRUIT, US << MARKET, 5058, 1, 135800)","{""AMETHYSTS"": 14, ""STARFRUIT"": 12}",945,5055,9999
136100,5054,-194647,"(STARFRUIT, MARKET << US, 5054, 1, 136100)","{""AMETHYSTS"": 14, ""STARFRUIT"": 11}",969,5056,10000
136500,5053,-189594,"(STARFRUIT, MARKET << US, 5053, 1, 136500)","{""AMETHYSTS"": 14, ""STARFRUIT"": 10}",952,5056,9999
137000,20004,-169590,"(AMETHYSTS, MARKET << US, 10002, 1, 137000)
(AMETHYSTS, MARKET << US, 10002, 1, 137000)","{""AMETHYSTS"": 12, ""STARFRUIT"": 10}",996,5055,10003
137100,-5053,-174643,"(STARFRUIT, US << MARKET, 5053, 1, 137100)","{""AMETHYSTS"": 12, ""STARFRUIT"": 11}",1009,5056,10003
137200,-20216,-194859,"(STARFRUIT, US << MARKET, 5054, 1, 137200)
(STARFRUIT, US << MARKET, 5054, 1, 137200)
(STARFRUIT, US << MARKET, 5054, 1, 137200)
(STARFRUIT, US << MARKET, 5054, 1, 137200)","{""AMETHYSTS"": 12, ""STARFRUIT"": 15}",936,5053,10000
137400,-14938,-209797,"(AMETHYSTS, US << MARKET, 9995, 1, 137400)
(AMETHYSTS, US << MARKET, 9995, 1, 137400)
(STARFRUIT, MARKET << US, 5052, 1, 137400)","{""AMETHYSTS"": 14, ""STARFRUIT"": 14}",959,5054,10000
137700,30098,-179699,"(AMETHYSTS, MARKET << US, 9996, 1, 137700)
(AMETHYSTS, MARKET << US, 9996, 1, 137700)
(STARFRUIT, MARKET << US, 5053, 1, 137700)
(STARFRUIT, MARKET << US, 5053, 1, 137700)","{""AMETHYSTS"": 12, ""STARFRUIT"": 12}",973,5056,10000
137800,9888,-169811,"(AMETHYSTS, MARKET << US, 9996, 1, 137800)
(AMETHYSTS, MARKET << US, 9996, 1, 137800)
(STARFRUIT, US << MARKET, 5052, 1, 137800)
(STARFRUIT, US << MARKET, 5052, 1, 137800)","{""AMETHYSTS"": 10, ""STARFRUIT"": 14}",959,5055,10000
138200,-14938,-184749,"(AMETHYSTS, US << MARKET, 9998, 1, 138200)
(AMETHYSTS, US << MARKET, 9998, 1, 138200)
(STARFRUIT, MARKET << US, 5058, 1, 138200)","{""AMETHYSTS"": 12, ""STARFRUIT"": 13}",969,5058,9997
138300,5053,-179696,"(STARFRUIT, MARKET << US, 5053, 1, 138300)","{""AMETHYSTS"": 12, ""STARFRUIT"": 12}",976,5056,10000
138600,20014,-159682,"(AMETHYSTS, MARKET << US, 10004, 1, 138600)
(AMETHYSTS, MARKET << US, 10004, 1, 138600)
(STARFRUIT, US << MARKET, 5053, 1, 138600)
(STARFRUIT, MARKET << US, 5059, 1, 138600)","{""AMETHYSTS"": 10, ""STARFRUIT"": 12}",978,5055,10000
139300,10118,-149564,"(STARFRUIT, MARKET << US, 5059, 1, 139300)
(STARFRUIT, MARKET << US, 5059, 1, 139300)","{""AMETHYSTS"": 10, ""STARFRUIT"": 10}",1026,5059,10000
139400,-10244,-159808,"(AMETHYSTS, MARKET << US, 9996, 1, 139400)
(STARFRUIT, US << MARKET, 5060, 1, 139400)
(STARFRUIT, US << MARKET, 5060, 1, 139400)
(STARFRUIT, US << MARKET, 5060, 1, 139400)
(STARFRUIT, US << MARKET, 5060, 1, 139400)","{""AMETHYSTS"": 9, ""STARFRUIT"": 14}",991,5059,9997
140500,9998,-149810,"(AMETHYSTS, MARKET << US, 9998, 1, 140500)","{""AMETHYSTS"": 8, ""STARFRUIT"": 14}",936,5055,9997
140600,5053,-144757,"(STARFRUIT, MARKET << US, 5053, 1, 140600)","{""AMETHYSTS"": 8, ""STARFRUIT"": 13}",971,5056,10000
141400,-109945,-254702,"(AMETHYSTS, US << MARKET, 9995, 1, 141400)
(AMETHYSTS, US << MARKET, 9995, 1, 141400)
(AMETHYSTS, US << MARKET, 9995, 1, 141400)
(AMETHYSTS, US << MARKET, 9995, 1, 141400)
(AMETHYSTS, US << MARKET, 9995, 1, 141400)
(AMETHYSTS, US << MARKET, 9995, 1, 141400)
(AMETHYSTS, US << MARKET, 9995, 1, 141400)
(AMETHYSTS, US << MARKET, 9995, 1, 141400)
(AMETHYSTS, US << MARKET, 9995, 1, 141400)
(AMETHYSTS, US << MARKET, 9995, 1, 141400)
(AMETHYSTS, US << MARKET, 9995, 1, 141400)","{""AMETHYSTS"": 19, ""STARFRUIT"": 13}",937,5055,9996
141500,5052,-249650,"(STARFRUIT, MARKET << US, 5052, 1, 141500)","{""AMETHYSTS"": 19, ""STARFRUIT"": 12}",1010,5055,10000
141600,-10226,-259876,"(AMETHYSTS, US << MARKET, 10002, 1, 141600)
(AMETHYSTS, MARKET << US, 10002, 1, 141600)
(AMETHYSTS, MARKET << US, 10002, 1, 141600)
(STARFRUIT, US << MARKET, 5057, 1, 141600)
(STARFRUIT, US << MARKET, 5057, 1, 141600)
(STARFRUIT, US << MARKET, 5057, 1, 141600)
(STARFRUIT, US << MARKET, 5057, 1, 141600)","{""AMETHYSTS"": 18, ""STARFRUIT"": 16}",1034,5058,9999
142000,40424,-219452,"(STARFRUIT, MARKET << US, 5053, 1, 142000)
(STARFRUIT, MARKET << US, 5053, 1, 142000)
(STARFRUIT, MARKET << US, 5053, 1, 142000)
(STARFRUIT, MARKET << US, 5053, 1, 142000)
(STARFRUIT, MARKET << US, 5053, 1, 142000)
(STARFRUIT, MARKET << US, 5053, 1, 142000)
(STARFRUIT, MARKET << US, 5053, 1, 142000)
(STARFRUIT, MARKET << US, 5053, 1, 142000)","{""AMETHYSTS"": 18, ""STARFRUIT"": 8}",988,5055,10000
142100,5059,-214393,"(STARFRUIT, MARKET << US, 5059, 1, 142100)","{""AMETHYSTS"": 18, ""STARFRUIT"": 7}",984,5059,9998
142200,5054,-209339,"(STARFRUIT, MARKET << US, 5054, 1, 142200)","{""AMETHYSTS"": 18, ""STARFRUIT"": 6}",1003,5057,10000
142500,9998,-199341,"(AMETHYSTS, MARKET << US, 9998, 1, 142500)","{""AMETHYSTS"": 17, ""STARFRUIT"": 6}",933,5057,9996
143300,-19996,-219337,"(AMETHYSTS, US << MARKET, 9998, 1, 143300)
(AMETHYSTS, US << MARKET, 9998, 1, 143300)","{""AMETHYSTS"": 19, ""STARFRUIT"": 6}",1024,5057,10001
143600,-15162,-234499,"(STARFRUIT, US << MARKET, 5054, 1, 143600)
(STARFRUIT, US << MARKET, 5054, 1, 143600)
(STARFRUIT, US << MARKET, 5054, 1, 143600)","{""AMETHYSTS"": 19, ""STARFRUIT"": 9}",978,5053,10000
143800,-5052,-239551,"(STARFRUIT, US << MARKET, 5052, 1, 143800)","{""AMETHYSTS"": 19, ""STARFRUIT"": 10}",1028,5056,10001
143900,15050,-224501,"(AMETHYSTS, MARKET << US, 9998, 1, 143900)
(STARFRUIT, MARKET << US, 5052, 1, 143900)","{""AMETHYSTS"": 18, ""STARFRUIT"": 9}",1039,5056,10002
144100,-5057,-229558,"(STARFRUIT, US << MARKET, 5057, 1, 144100)","{""AMETHYSTS"": 18, ""STARFRUIT"": 10}",1012,5057,10000
144400,5053,-224505,"(STARFRUIT, MARKET << US, 5053, 1, 144400)","{""AMETHYSTS"": 18, ""STARFRUIT"": 9}",999,5056,10000
144500,240096,15591,"(AMETHYSTS, MARKET << US, 10004, 1, 144500)
(AMETHYSTS, MARKET << US, 10004, 1, 144500)
(AMETHYSTS, MARKET << US, 10004, 1, 144500)
(AMETHYSTS, MARKET << US, 10004, 1, 144500)
(AMETHYSTS, MARKET << US, 10004, 1, 144500)
(AMETHYSTS, MARKET << US, 10004, 1, 144500)
(AMETHYSTS, MARKET << US, 10004, 1, 144500)
(AMETHYSTS, MARKET << US, 10004, 1, 144500)
(AMETHYSTS, MARKET << US, 10004, 1, 144500)
(AMETHYSTS, MARKET << US, 10004, 1, 144500)
(AMETHYSTS, MARKET << US, 10004, 1, 144500)
(AMETHYSTS, MARKET << US, 10004, 1, 144500)
(AMETHYSTS, MARKET << US, 10004, 1, 144500)
(AMETHYSTS, MARKET << US, 10004, 1, 144500)
(AMETHYSTS, MARKET << US, 10004, 1, 144500)
(AMETHYSTS, MARKET << US, 10004, 1, 144500)
(AMETHYSTS, MARKET << US, 10004, 1, 144500)
(AMETHYSTS, MARKET << US, 10004, 1, 144500)
(AMETHYSTS, MARKET << US, 10004, 1, 144500)
(AMETHYSTS, MARKET << US, 10004, 1, 144500)
(AMETHYSTS, MARKET << US, 10004, 1, 144500)
(AMETHYSTS, MARKET << US, 10004, 1, 144500)
(AMETHYSTS, MARKET << US, 10004, 1, 144500)
(AMETHYSTS, MARKET << US, 10004, 1, 144500)","{""AMETHYSTS"": -6, ""STARFRUIT"": 9}",1086,5055,10000
144600,-50098,-34507,"(AMETHYSTS, US << MARKET, 9998, 1, 144600)
(AMETHYSTS, US << MARKET, 9998, 1, 144600)
(AMETHYSTS, US << MARKET, 9998, 1, 144600)
(AMETHYSTS, US << MARKET, 9998, 1, 144600)
(STARFRUIT, US << MARKET, 5053, 1, 144600)
(STARFRUIT, US << MARKET, 5053, 1, 144600)","{""AMETHYSTS"": -2, ""STARFRUIT"": 11}",1096,5055,10001
144800,-10002,-44509,"(AMETHYSTS, US << MARKET, 10002, 1, 144800)","{""AMETHYSTS"": -1, ""STARFRUIT"": 11}",1082,5054,10003
145100,74940,30431,"(AMETHYSTS, MARKET << US, 10005, 1, 145100)
(AMETHYSTS, MARKET << US, 10005, 1, 145100)
(AMETHYSTS, MARKET << US, 9998, 1, 145100)
(AMETHYSTS, MARKET << US, 9998, 1, 145100)
(AMETHYSTS, MARKET << US, 9998, 1, 145100)
(AMETHYSTS, MARKET << US, 9998, 1, 145100)
(AMETHYSTS, MARKET << US, 9998, 1, 145100)
(AMETHYSTS, MARKET << US, 9998, 1, 145100)
(STARFRUIT, US << MARKET, 5058, 1, 145100)","{""AMETHYSTS"": -9, ""STARFRUIT"": 12}",1070,5054,10001
145600,25060,55491,"(AMETHYSTS, MARKET << US, 10002, 1, 145600)
(AMETHYSTS, MARKET << US, 10002, 1, 145600)
(STARFRUIT, MARKET << US, 5056, 1, 145600)","{""AMETHYSTS"": -11, ""STARFRUIT"": 11}",1096,5053,9998
145900,29904,85395,"(AMETHYSTS, MARKET << US, 10002, 1, 145900)
(AMETHYSTS, MARKET << US, 10002, 1, 145900)
(AMETHYSTS, MARKET << US, 10002, 1, 145900)
(AMETHYSTS, MARKET << US, 10002, 1, 145900)
(STARFRUIT, US << MARKET, 5052, 1, 145900)
(STARFRUIT, US << MARKET, 5052, 1, 145900)","{""AMETHYSTS"": -15, ""STARFRUIT"": 13}",1065,5055,10003
146400,20101,105496,"(AMETHYSTS, MARKET << US, 9998, 1, 146400)
(STARFRUIT, MARKET << US, 5052, 1, 146400)
(STARFRUIT, MARKET << US, 5051, 1, 146400)","{""AMETHYSTS"": -16, ""STARFRUIT"": 11}",1041,5051,10001
147000,14952,120448,"(AMETHYSTS, US << MARKET, 10004, 1, 147000)
(AMETHYSTS, MARKET << US, 10004, 1, 147000)
(AMETHYSTS, MARKET << US, 10004, 1, 147000)
(AMETHYSTS, MARKET << US, 10004, 1, 147000)
(STARFRUIT, US << MARKET, 5056, 1, 147000)","{""AMETHYSTS"": -18, ""STARFRUIT"": 12}",1078,5057,10003
147200,5057,125505,"(STARFRUIT, MARKET << US, 5057, 1, 147200)","{""AMETHYSTS"": -18, ""STARFRUIT"": 11}",1132,5057,10000
147400,5051,130556,"(STARFRUIT, MARKET << US, 5051, 1, 147400)","{""AMETHYSTS"": -18, ""STARFRUIT"": 10}",1086,5053,10000
147500,-5056,125500,"(STARFRUIT, US << MARKET, 5056, 1, 147500)","{""AMETHYSTS"": -18, ""STARFRUIT"": 11}",1083,5053,10000
148200,-55050,70450,"(AMETHYSTS, US << MARKET, 9998, 1, 148200)
(AMETHYSTS, US << MARKET, 9998, 1, 148200)
(AMETHYSTS, US << MARKET, 9998, 1, 148200)
(AMETHYSTS, US << MARKET, 9998, 1, 148200)
(AMETHYSTS, US << MARKET, 9998, 1, 148200)
(AMETHYSTS, US << MARKET, 9998, 1, 148200)
(AMETHYSTS, MARKET << US, 9998, 1, 148200)
(STARFRUIT, US << MARKET, 5058, 1, 148200)
(STARFRUIT, US << MARKET, 5058, 1, 148200)
(STARFRUIT, MARKET << US, 5056, 1, 148200)","{""AMETHYSTS"": -13, ""STARFRUIT"": 12}",1173,5057,9997
148700,-24979,45471,"(AMETHYSTS, US << MARKET, 10005, 1, 148700)
(AMETHYSTS, US << MARKET, 10005, 1, 148700)
(AMETHYSTS, US << MARKET, 10005, 1, 148700)
(AMETHYSTS, US << MARKET, 10005, 1, 148700)
(AMETHYSTS, US << MARKET, 10005, 1, 148700)
(AMETHYSTS, MARKET << US, 9995, 1, 148700)
(AMETHYSTS, MARKET << US, 9995, 1, 148700)
(STARFRUIT, MARKET << US, 5056, 1, 148700)","{""AMETHYSTS"": -10, ""STARFRUIT"": 11}",1087,5056,10000
148900,-15165,30306,"(STARFRUIT, US << MARKET, 5055, 1, 148900)
(STARFRUIT, US << MARKET, 5055, 1, 148900)
(STARFRUIT, US << MARKET, 5055, 1, 148900)","{""AMETHYSTS"": -10, ""STARFRUIT"": 14}",1090,5056,10000
149000,25055,55361,"(AMETHYSTS, MARKET << US, 10002, 1, 149000)
(AMETHYSTS, MARKET << US, 10002, 1, 149000)
(STARFRUIT, MARKET << US, 5051, 1, 149000)","{""AMETHYSTS"": -12, ""STARFRUIT"": 13}",1062,5053,9999
149100,-5051,50310,"(STARFRUIT, US << MARKET, 5051, 1, 149100)","{""AMETHYSTS"": -12, ""STARFRUIT"": 14}",1054,5054,10001
149500,5054,55364,"(STARFRUIT, MARKET << US, 5054, 1, 149500)","{""AMETHYSTS"": -12, ""STARFRUIT"": 13}",1077,5053,9998
150300,20004,75368,"(AMETHYSTS, MARKET << US, 10002, 1, 150300)
(AMETHYSTS, MARKET << US, 10002, 1, 150300)","{""AMETHYSTS"": -14, ""STARFRUIT"": 13}",1054,5056,10003
150600,-10002,65366,"(AMETHYSTS, US << MARKET, 10002, 1, 150600)","{""AMETHYSTS"": -13, ""STARFRUIT"": 13}",1042,5055,10003
151100,60012,125378,"(AMETHYSTS, MARKET << US, 10002, 1, 151100)
(AMETHYSTS, MARKET << US, 10002, 1, 151100)
(AMETHYSTS, MARKET << US, 10002, 1, 151100)
(AMETHYSTS, MARKET << US, 10002, 1, 151100)
(AMETHYSTS, MARKET << US, 10002, 1, 151100)
(AMETHYSTS, MARKET << US, 10002, 1, 151100)","{""AMETHYSTS"": -19, ""STARFRUIT"": 13}",1118,5054,9998
151200,-20008,105370,"(AMETHYSTS, US << MARKET, 10004, 1, 151200)
(AMETHYSTS, US << MARKET, 10004, 1, 151200)","{""AMETHYSTS"": -17, ""STARFRUIT"": 13}",1068,5055,10001
151500,4834,110204,"(AMETHYSTS, MARKET << US, 10004, 1, 151500)
(AMETHYSTS, MARKET << US, 10004, 1, 151500)
(STARFRUIT, US << MARKET, 5058, 1, 151500)
(STARFRUIT, US << MARKET, 5058, 1, 151500)
(STARFRUIT, US << MARKET, 5058, 1, 151500)
(STARFRUIT, US << MARKET, 5058, 1, 151500)
(STARFRUIT, MARKET << US, 5058, 1, 151500)","{""AMETHYSTS"": -19, ""STARFRUIT"": 16}",1068,5054,10000
151600,-15050,95154,"(AMETHYSTS, US << MARKET, 9995, 1, 151600)
(AMETHYSTS, US << MARKET, 9995, 1, 151600)
(AMETHYSTS, MARKET << US, 9996, 1, 151600)
(STARFRUIT, US << MARKET, 5056, 1, 151600)","{""AMETHYSTS"": -18, ""STARFRUIT"": 17}",1123,5057,10000
152100,14947,110101,"(AMETHYSTS, MARKET << US, 10002, 1, 152100)
(AMETHYSTS, MARKET << US, 10002, 1, 152100)
(STARFRUIT, US << MARKET, 5057, 1, 152100)","{""AMETHYSTS"": -20, ""STARFRUIT"": 18}",1067,5057,10003
152400,0,110101,,"{""AMETHYSTS"": -20, ""STARFRUIT"": 18}",1151,5055,9997
152600,0,110101,,"{""AMETHYSTS"": -20, ""STARFRUIT"": 18}",1035,5053,10001
152700,-19992,90109,"(AMETHYSTS, US << MARKET, 9996, 1, 152700)
(AMETHYSTS, US << MARKET, 9996, 1, 152700)","{""AMETHYSTS"": -18, ""STARFRUIT"": 18}",1117,5056,10000
152800,5056,95165,"(STARFRUIT, MARKET << US, 5056, 1, 152800)","{""AMETHYSTS"": -18, ""STARFRUIT"": 17}",1067,5052,9999
153000,-19996,75169,"(AMETHYSTS, US << MARKET, 9998, 1, 153000)
(AMETHYSTS, US << MARKET, 9998, 1, 153000)","{""AMETHYSTS"": -16, ""STARFRUIT"": 17}",1135,5054,9997
153200,30006,105175,"(AMETHYSTS, MARKET << US, 10002, 1, 153200)
(AMETHYSTS, MARKET << US, 10002, 1, 153200)
(AMETHYSTS, MARKET << US, 10002, 1, 153200)","{""AMETHYSTS"": -19, ""STARFRUIT"": 17}",1002,5052,10003
153300,9998,115173,"(AMETHYSTS, MARKET << US, 9998, 1, 153300)","{""AMETHYSTS"": -20, ""STARFRUIT"": 17}",1151,5054,9997
153500,5051,120224,"(STARFRUIT, MARKET << US, 5051, 1, 153500)","{""AMETHYSTS"": -20, ""STARFRUIT"": 16}",1004,5050,10001
153600,-5051,115173,"(STARFRUIT, US << MARKET, 5051, 1, 153600)","{""AMETHYSTS"": -20, ""STARFRUIT"": 17}",1091,5054,10000
154000,-5057,110116,"(STARFRUIT, US << MARKET, 5057, 1, 154000)","{""AMETHYSTS"": -20, ""STARFRUIT"": 18}",1142,5057,10000
154200,-39984,70132,"(AMETHYSTS, US << MARKET, 9996, 1, 154200)
(AMETHYSTS, US << MARKET, 9996, 1, 154200)
(AMETHYSTS, US << MARKET, 9996, 1, 154200)
(AMETHYSTS, US << MARKET, 9996, 1, 154200)
(STARFRUIT, US << MARKET, 5052, 1, 154200)
(STARFRUIT, MARKET << US, 5052, 1, 154200)","{""AMETHYSTS"": -16, ""STARFRUIT"": 18}",1122,5055,10000
154900,-10110,60022,"(STARFRUIT, US << MARKET, 5055, 1, 154900)
(STARFRUIT, US << MARKET, 5055, 1, 154900)","{""AMETHYSTS"": -16, ""STARFRUIT"": 20}",1158,5056,9999
155100,30342,90364,"(STARFRUIT, MARKET << US, 5057, 1, 155100)
(STARFRUIT, MARKET << US, 5057, 1, 155100)
(STARFRUIT, MARKET << US, 5057, 1, 155100)
(STARFRUIT, MARKET << US, 5057, 1, 155100)
(STARFRUIT, MARKET << US, 5057, 1, 155100)
(STARFRUIT, MARKET << US, 5057, 1, 155100)","{""AMETHYSTS"": -16, ""STARFRUIT"": 14}",1072,5054,10003
155200,-15054,75310,"(AMETHYSTS, US << MARKET, 10004, 1, 155200)
(STARFRUIT, US << MARKET, 5050, 1, 155200)","{""AMETHYSTS"": -15, ""STARFRUIT"": 15}",1105,5054,10001
155300,-59988,15322,"(AMETHYSTS, US << MARKET, 9998, 1, 155300)
(AMETHYSTS, US << MARKET, 9998, 1, 155300)
(AMETHYSTS, US << MARKET, 9998, 1, 155300)
(AMETHYSTS, US << MARKET, 9998, 1, 155300)
(AMETHYSTS, US << MARKET, 9998, 1, 155300)
(AMETHYSTS, US << MARKET, 9998, 1, 155300)","{""AMETHYSTS"": -9, ""STARFRUIT"": 15}",1129,5052,9997
155600,5048,20370,"(STARFRUIT, MARKET << US, 5048, 1, 155600)","{""AMETHYSTS"": -9, ""STARFRUIT"": 14}",1084,5051,10000
156000,-20228,142,"(STARFRUIT, US << MARKET, 5057, 1, 156000)
(STARFRUIT, US << MARKET, 5057, 1, 156000)
(STARFRUIT, US << MARKET, 5057, 1, 156000)
(STARFRUIT, US << MARKET, 5057, 1, 156000)","{""AMETHYSTS"": -9, ""STARFRUIT"": 18}",1069,5053,10003
156100,20004,20146,"(AMETHYSTS, MARKET << US, 10002, 1, 156100)
(AMETHYSTS, MARKET << US, 10002, 1, 156100)","{""AMETHYSTS"": -11, ""STARFRUIT"": 18}",1085,5054,10003
156400,45504,65650,"(AMETHYSTS, US << MARKET, 9998, 1, 156400)
(AMETHYSTS, US << MARKET, 9998, 1, 156400)
(AMETHYSTS, MARKET << US, 9998, 1, 156400)
(AMETHYSTS, MARKET << US, 9998, 1, 156400)
(STARFRUIT, MARKET << US, 5056, 1, 156400)
(STARFRUIT, MARKET << US, 5056, 1, 156400)
(STARFRUIT, MARKET << US, 5056, 1, 156400)
(STARFRUIT, MARKET << US, 5056, 1, 156400)
(STARFRUIT, MARKET << US, 5056, 1, 156400)
(STARFRUIT, MARKET << US, 5056, 1, 156400)
(STARFRUIT, MARKET << US, 5056, 1, 156400)
(STARFRUIT, MARKET << US, 5056, 1, 156400)
(STARFRUIT, MARKET << US, 5056, 1, 156400)","{""AMETHYSTS"": -11, ""STARFRUIT"": 9}",1134,5055,10001
156800,-20106,45544,"(AMETHYSTS, US << MARKET, 9998, 1, 156800)
(AMETHYSTS, US << MARKET, 9998, 1, 156800)
(AMETHYSTS, MARKET << US, 9998, 1, 156800)
(STARFRUIT, US << MARKET, 5054, 1, 156800)
(STARFRUIT, US << MARKET, 5054, 1, 156800)
(STARFRUIT, US << MARKET, 5054, 1, 156800)
(STARFRUIT, US << MARKET, 5054, 1, 156800)
(STARFRUIT, MARKET << US, 5054, 1, 156800)
(STARFRUIT, MARKET << US, 5054, 1, 156800)","{""AMETHYSTS"": -10, ""STARFRUIT"": 11}",1139,5055,10001
156900,-25051,20493,"(AMETHYSTS, US << MARKET, 9998, 1, 156900)
(AMETHYSTS, US << MARKET, 9998, 1, 156900)
(STARFRUIT, US << MARKET, 5055, 1, 156900)","{""AMETHYSTS"": -8, ""STARFRUIT"": 12}",1149,5052,9996
157100,-10002,10491,"(AMETHYSTS, US << MARKET, 10002, 1, 157100)","{""AMETHYSTS"": -7, ""STARFRUIT"": 12}",1110,5051,9999
157400,10344,20835,"(AMETHYSTS, US << MARKET, 9996, 1, 157400)
(AMETHYSTS, US << MARKET, 9996, 1, 157400)
(STARFRUIT, US << MARKET, 5049, 1, 157400)
(STARFRUIT, MARKET << US, 5055, 1, 157400)
(STARFRUIT, MARKET << US, 5055, 1, 157400)
(STARFRUIT, MARKET << US, 5055, 1, 157400)
(STARFRUIT, MARKET << US, 5055, 1, 157400)
(STARFRUIT, MARKET << US, 5055, 1, 157400)
(STARFRUIT, MARKET << US, 5055, 1, 157400)
(STARFRUIT, MARKET << US, 5055, 1, 157400)","{""AMETHYSTS"": -5, ""STARFRUIT"": 6}",1147,5052,10000
157600,25280,46115,"(STARFRUIT, MARKET << US, 5056, 1, 157600)
(STARFRUIT, MARKET << US, 5056, 1, 157600)
(STARFRUIT, MARKET << US, 5056, 1, 157600)
(STARFRUIT, MARKET << US, 5056, 1, 157600)
(STARFRUIT, MARKET << US, 5056, 1, 157600)","{""AMETHYSTS"": -5, ""STARFRUIT"": 1}",1170,5055,10000
157700,15144,61259,"(STARFRUIT, MARKET << US, 5048, 1, 157700)
(STARFRUIT, MARKET << US, 5048, 1, 157700)
(STARFRUIT, MARKET << US, 5048, 1, 157700)","{""AMETHYSTS"": -5, ""STARFRUIT"": -2}",1157,5051,10000
157800,20004,81263,"(AMETHYSTS, MARKET << US, 10002, 1, 157800)
(AMETHYSTS, MARKET << US, 10002, 1, 157800)","{""AMETHYSTS"": -7, ""STARFRUIT"": -2}",1168,5051,9999
158300,-19996,61267,"(AMETHYSTS, US << MARKET, 9998, 1, 158300)
(AMETHYSTS, US << MARKET, 9998, 1, 158300)","{""AMETHYSTS"": -5, ""STARFRUIT"": -2}",1162,5050,10001
158400,104,61371,"(AMETHYSTS, US << MARKET, 10004, 1, 158400)
(STARFRUIT, MARKET << US, 5054, 1, 158400)
(STARFRUIT, MARKET << US, 5054, 1, 158400)","{""AMETHYSTS"": -4, ""STARFRUIT"": -4}",1171,5050,10000
158700,-30102,31269,"(AMETHYSTS, US << MARKET, 9998, 1, 158700)
(AMETHYSTS, US << MARKET, 9998, 1, 158700)
(STARFRUIT, US << MARKET, 5053, 1, 158700)
(STARFRUIT, US << MARKET, 5053, 1, 158700)","{""AMETHYSTS"": -2, ""STARFRUIT"": -2}",1179,5049,9996
159000,5052,36321,"(STARFRUIT, MARKET << US, 5052, 1, 159000)","{""AMETHYSTS"": -2, ""STARFRUIT"": -3}",1180,5049,9997
159200,5048,41369,"(STARFRUIT, MARKET << US, 5048, 1, 159200)","{""AMETHYSTS"": -2, ""STARFRUIT"": -4}",1165,5052,9998
159300,5049,46418,"(STARFRUIT, MARKET << US, 5049, 1, 159300)","{""AMETHYSTS"": -2, ""STARFRUIT"": -5}",1178,5048,10000
159400,-30104,16314,"(AMETHYSTS, US << MARKET, 9998, 1, 159400)
(AMETHYSTS, US << MARKET, 9998, 1, 159400)
(STARFRUIT, US << MARKET, 5054, 1, 159400)
(STARFRUIT, US << MARKET, 5054, 1, 159400)","{""AMETHYSTS"": 0, ""STARFRUIT"": -3}",1164,5050,9997
159500,-111,16203,"(AMETHYSTS, MARKET << US, 9995, 1, 159500)
(STARFRUIT, US << MARKET, 5053, 1, 159500)
(STARFRUIT, US << MARKET, 5053, 1, 159500)","{""AMETHYSTS"": -1, ""STARFRUIT"": -1}",1149,5054,10000
159700,15165,31368,"(STARFRUIT, MARKET << US, 5055, 1, 159700)
(STARFRUIT, MARKET << US, 5055, 1, 159700)
(STARFRUIT, MARKET << US, 5055, 1, 159700)","{""AMETHYSTS"": -1, ""STARFRUIT"": -4}",1160,5052,10000
160000,180090,211458,"(AMETHYSTS, MARKET << US, 10005, 1, 160000)
(AMETHYSTS, MARKET << US, 10005, 1, 160000)
(AMETHYSTS, MARKET << US, 10005, 1, 160000)
(AMETHYSTS, MARKET << US, 10005, 1, 160000)
(AMETHYSTS, MARKET << US, 10005, 1, 160000)
(AMETHYSTS, MARKET << US, 10005, 1, 160000)
(AMETHYSTS, MARKET << US, 10005, 1, 160000)
(AMETHYSTS, MARKET << US, 10005, 1, 160000)
(AMETHYSTS, MARKET << US, 10005, 1, 160000)
(AMETHYSTS, MARKET << US, 10005, 1, 160000)
(AMETHYSTS, MARKET << US, 10005, 1, 160000)
(AMETHYSTS, MARKET << US, 10005, 1, 160000)
(AMETHYSTS, MARKET << US, 10005, 1, 160000)
(AMETHYSTS, MARKET << US, 10005, 1, 160000)
(AMETHYSTS, MARKET << US, 10005, 1, 160000)
(AMETHYSTS, MARKET << US, 10005, 1, 160000)
(AMETHYSTS, MARKET << US, 10005, 1, 160000)
(AMETHYSTS, MARKET << US, 10005, 1, 160000)","{""AMETHYSTS"": -19, ""STARFRUIT"": -4}",1208,5053,10002
160700,-35336,176122,"(STARFRUIT, US << MARKET, 5048, 1, 160700)
(STARFRUIT, US << MARKET, 5048, 1, 160700)
(STARFRUIT, US << MARKET, 5048, 1, 160700)
(STARFRUIT, US << MARKET, 5048, 1, 160700)
(STARFRUIT, US << MARKET, 5048, 1, 160700)
(STARFRUIT, US << MARKET, 5048, 1, 160700)
(STARFRUIT, US << MARKET, 5048, 1, 160700)","{""AMETHYSTS"": -19, ""STARFRUIT"": 3}",1263,5047,10000
161000,-60168,115954,"(AMETHYSTS, US << MARKET, 9996, 1, 161000)
(AMETHYSTS, US << MARKET, 9996, 1, 161000)
(AMETHYSTS, US << MARKET, 9996, 1, 161000)
(AMETHYSTS, US << MARKET, 9996, 1, 161000)
(STARFRUIT, US << MARKET, 5046, 1, 161000)
(STARFRUIT, US << MARKET, 5046, 1, 161000)
(STARFRUIT, US << MARKET, 5046, 1, 161000)
(STARFRUIT, US << MARKET, 5046, 1, 161000)","{""AMETHYSTS"": -15, ""STARFRUIT"": 7}",1297,5049,10000
161500,5050,121004,"(STARFRUIT, MARKET << US, 5050, 1, 161500)","{""AMETHYSTS"": -15, ""STARFRUIT"": 6}",1316,5047,9998
161600,-10002,111002,"(AMETHYSTS, US << MARKET, 10002, 1, 161600)","{""AMETHYSTS"": -14, ""STARFRUIT"": 6}",1254,5049,10003
163100,15160,126162,"(STARFRUIT, US << MARKET, 5045, 1, 163100)
(STARFRUIT, US << MARKET, 5045, 1, 163100)
(STARFRUIT, MARKET << US, 5050, 1, 163100)
(STARFRUIT, MARKET << US, 5050, 1, 163100)
(STARFRUIT, MARKET << US, 5050, 1, 163100)
(STARFRUIT, MARKET << US, 5050, 1, 163100)
(STARFRUIT, MARKET << US, 5050, 1, 163100)","{""AMETHYSTS"": -14, ""STARFRUIT"": 3}",1317,5047,9999
163400,15044,141206,"(AMETHYSTS, US << MARKET, 10004, 1, 163400)
(AMETHYSTS, MARKET << US, 10004, 1, 163400)
(AMETHYSTS, MARKET << US, 10004, 1, 163400)
(STARFRUIT, US << MARKET, 5052, 1, 163400)
(STARFRUIT, US << MARKET, 5052, 1, 163400)
(STARFRUIT, US << MARKET, 5052, 1, 163400)
(STARFRUIT, MARKET << US, 5049, 1, 163400)
(STARFRUIT, MARKET << US, 5049, 1, 163400)
(STARFRUIT, MARKET << US, 5049, 1, 163400)
(STARFRUIT, MARKET << US, 5049, 1, 163400)","{""AMETHYSTS"": -15, ""STARFRUIT"": 2}",1306,5050,10000
163900,40016,181222,"(AMETHYSTS, MARKET << US, 10004, 1, 163900)
(AMETHYSTS, MARKET << US, 10004, 1, 163900)
(AMETHYSTS, MARKET << US, 10004, 1, 163900)
(AMETHYSTS, MARKET << US, 10004, 1, 163900)","{""AMETHYSTS"": -19, ""STARFRUIT"": 2}",1282,5049,10002
164000,-15146,166076,"(STARFRUIT, US << MARKET, 5049, 1, 164000)
(STARFRUIT, US << MARKET, 5049, 1, 164000)
(STARFRUIT, US << MARKET, 5049, 1, 164000)
(STARFRUIT, US << MARKET, 5049, 1, 164000)
(STARFRUIT, MARKET << US, 5050, 1, 164000)","{""AMETHYSTS"": -19, ""STARFRUIT"": 5}",1326,5050,10000
164200,25260,191336,"(STARFRUIT, MARKET << US, 5052, 1, 164200)
(STARFRUIT, MARKET << US, 5052, 1, 164200)
(STARFRUIT, MARKET << US, 5052, 1, 164200)
(STARFRUIT, MARKET << US, 5052, 1, 164200)
(STARFRUIT, MARKET << US, 5052, 1, 164200)","{""AMETHYSTS"": -19, ""STARFRUIT"": 0}",1336,5048,10000
164400,5049,196385,"(STARFRUIT, MARKET << US, 5049, 1, 164400)","{""AMETHYSTS"": -19, ""STARFRUIT"": -1}",1339,5046,10000
164600,9998,206383,"(AMETHYSTS, MARKET << US, 9998, 1, 164600)","{""AMETHYSTS"": -20, ""STARFRUIT"": -1}",1395,5048,9997
164800,0,206383,,"{""AMETHYSTS"": -20, ""STARFRUIT"": -1}",1337,5046,10000
164900,-25208,181175,"(STARFRUIT, US << MARKET, 5043, 1, 164900)
(STARFRUIT, US << MARKET, 5043, 1, 164900)
(STARFRUIT, US << MARKET, 5043, 1, 164900)
(STARFRUIT, US << MARKET, 5043, 1, 164900)
(STARFRUIT, US << MARKET, 5043, 1, 164900)
(STARFRUIT, US << MARKET, 5043, 1, 164900)
(STARFRUIT, MARKET << US, 5050, 1, 164900)","{""AMETHYSTS"": -20, ""STARFRUIT"": 4}",1359,5046,10000
165600,-20192,160983,"(STARFRUIT, US << MARKET, 5048, 1, 165600)
(STARFRUIT, US << MARKET, 5048, 1, 165600)
(STARFRUIT, US << MARKET, 5048, 1, 165600)
(STARFRUIT, US << MARKET, 5048, 1, 165600)","{""AMETHYSTS"": -20, ""STARFRUIT"": 8}",1411,5046,9997
165700,-5050,155933,"(STARFRUIT, US << MARKET, 5050, 1, 165700)","{""AMETHYSTS"": -20, ""STARFRUIT"": 9}",1383,5050,10000
165800,92,156025,"(AMETHYSTS, US << MARKET, 10004, 1, 165800)
(STARFRUIT, MARKET << US, 5051, 1, 165800)
(STARFRUIT, MARKET << US, 5045, 1, 165800)","{""AMETHYSTS"": -19, ""STARFRUIT"": 7}",1342,5048,10001
165900,9996,166021,"(AMETHYSTS, MARKET << US, 9996, 1, 165900)","{""AMETHYSTS"": -20, ""STARFRUIT"": 7}",1350,5047,10000
166000,-20196,145825,"(STARFRUIT, US << MARKET, 5049, 1, 166000)
(STARFRUIT, US << MARKET, 5049, 1, 166000)
(STARFRUIT, US << MARKET, 5049, 1, 166000)
(STARFRUIT, US << MARKET, 5049, 1, 166000)","{""AMETHYSTS"": -20, ""STARFRUIT"": 11}",1375,5050,10000
166200,0,145825,,"{""AMETHYSTS"": -20, ""STARFRUIT"": 11}",1282,5047,10003
166500,5045,150870,"(STARFRUIT, MARKET << US, 5045, 1, 166500)","{""AMETHYSTS"": -20, ""STARFRUIT"": 10}",1350,5048,10000
167100,-50076,100794,"(AMETHYSTS, US << MARKET, 9996, 1, 167100)
(AMETHYSTS, US << MARKET, 9996, 1, 167100)
(AMETHYSTS, US << MARKET, 9996, 1, 167100)
(AMETHYSTS, US << MARKET, 9996, 1, 167100)
(STARFRUIT, US << MARKET, 5046, 1, 167100)
(STARFRUIT, US << MARKET, 5046, 1, 167100)","{""AMETHYSTS"": -16, ""STARFRUIT"": 12}",1382,5049,10000
167400,5052,105846,"(STARFRUIT, MARKET << US, 5052, 1, 167400)","{""AMETHYSTS"": -16, ""STARFRUIT"": 11}",1401,5049,9999
167800,-20188,85658,"(STARFRUIT, US << MARKET, 5047, 1, 167800)
(STARFRUIT, US << MARKET, 5047, 1, 167800)
(STARFRUIT, US << MARKET, 5047, 1, 167800)
(STARFRUIT, US << MARKET, 5047, 1, 167800)","{""AMETHYSTS"": -16, ""STARFRUIT"": 15}",1408,5050,10000
168200,20376,106034,"(AMETHYSTS, US << MARKET, 10005, 1, 168200)
(AMETHYSTS, US << MARKET, 10005, 1, 168200)
(STARFRUIT, MARKET << US, 5052, 1, 168200)
(STARFRUIT, MARKET << US, 5052, 1, 168200)
(STARFRUIT, MARKET << US, 5047, 1, 168200)
(STARFRUIT, MARKET << US, 5047, 1, 168200)
(STARFRUIT, MARKET << US, 5047, 1, 168200)
(STARFRUIT, MARKET << US, 5047, 1, 168200)
(STARFRUIT, MARKET << US, 5047, 1, 168200)
(STARFRUIT, MARKET << US, 5047, 1, 168200)","{""AMETHYSTS"": -14, ""STARFRUIT"": 7}",1377,5049,10000
168400,-130016,-23982,"(AMETHYSTS, US << MARKET, 9998, 1, 168400)
(AMETHYSTS, US << MARKET, 9998, 1, 168400)
(AMETHYSTS, US << MARKET, 9998, 1, 168400)
(AMETHYSTS, US << MARKET, 9998, 1, 168400)
(AMETHYSTS, US << MARKET, 9998, 1, 168400)
(AMETHYSTS, US << MARKET, 9998, 1, 168400)
(AMETHYSTS, US << MARKET, 10004, 1, 168400)
(AMETHYSTS, US << MARKET, 10004, 1, 168400)
(AMETHYSTS, US << MARKET, 10004, 1, 168400)
(AMETHYSTS, US << MARKET, 10004, 1, 168400)
(AMETHYSTS, US << MARKET, 10004, 1, 168400)
(AMETHYSTS, US << MARKET, 10004, 1, 168400)
(AMETHYSTS, US << MARKET, 10004, 1, 168400)
(AMETHYSTS, US << MARKET, 10004, 1, 168400)
(AMETHYSTS, US << MARKET, 10004, 1, 168400)
(AMETHYSTS, MARKET << US, 10004, 1, 168400)
(AMETHYSTS, MARKET << US, 10004, 1, 168400)","{""AMETHYSTS"": -1, ""STARFRUIT"": 7}",1360,5049,10001
168700,25260,1278,"(STARFRUIT, MARKET << US, 5052, 1, 168700)
(STARFRUIT, MARKET << US, 5052, 1, 168700)
(STARFRUIT, MARKET << US, 5052, 1, 168700)
(STARFRUIT, MARKET << US, 5052, 1, 168700)
(STARFRUIT, MARKET << US, 5052, 1, 168700)","{""AMETHYSTS"": -1, ""STARFRUIT"": 2}",1378,5049,9998
169000,196,1474,"(AMETHYSTS, US << MARKET, 9998, 1, 169000)
(AMETHYSTS, US << MARKET, 9998, 1, 169000)
(STARFRUIT, MARKET << US, 5048, 1, 169000)
(STARFRUIT, MARKET << US, 5048, 1, 169000)
(STARFRUIT, MARKET << US, 5048, 1, 169000)
(STARFRUIT, MARKET << US, 5048, 1, 169000)","{""AMETHYSTS"": 1, ""STARFRUIT"": -2}",1377,5047,9997
169200,-29886,-28412,"(AMETHYSTS, US << MARKET, 9995, 1, 169200)
(AMETHYSTS, US << MARKET, 9995, 1, 169200)
(AMETHYSTS, US << MARKET, 9995, 1, 169200)
(AMETHYSTS, US << MARKET, 9995, 1, 169200)
(STARFRUIT, MARKET << US, 5047, 1, 169200)
(STARFRUIT, MARKET << US, 5047, 1, 169200)","{""AMETHYSTS"": 5, ""STARFRUIT"": -4}",1388,5050,10000
169900,19996,-8416,"(AMETHYSTS, MARKET << US, 9998, 1, 169900)
(AMETHYSTS, MARKET << US, 9998, 1, 169900)","{""AMETHYSTS"": 3, ""STARFRUIT"": -4}",1388,5049,10000
170000,49990,41574,"(AMETHYSTS, MARKET << US, 9998, 1, 170000)
(AMETHYSTS, MARKET << US, 9998, 1, 170000)
(AMETHYSTS, MARKET << US, 9998, 1, 170000)
(AMETHYSTS, MARKET << US, 9998, 1, 170000)
(AMETHYSTS, MARKET << US, 9998, 1, 170000)","{""AMETHYSTS"": -2, ""STARFRUIT"": -4}",1390,5048,9996
170100,5046,46620,"(STARFRUIT, MARKET << US, 5046, 1, 170100)","{""AMETHYSTS"": -2, ""STARFRUIT"": -5}",1375,5049,10000
170200,9998,56618,"(AMETHYSTS, MARKET << US, 9998, 1, 170200)","{""AMETHYSTS"": -3, ""STARFRUIT"": -5}",1382,5049,9997
171300,9998,66616,"(AMETHYSTS, MARKET << US, 9998, 1, 171300)","{""AMETHYSTS"": -4, ""STARFRUIT"": -5}",1387,5045,10001
171600,15049,81665,"(AMETHYSTS, MARKET << US, 9998, 1, 171600)
(STARFRUIT, MARKET << US, 5051, 1, 171600)","{""AMETHYSTS"": -5, ""STARFRUIT"": -6}",1368,5052,9997
171700,40008,121673,"(AMETHYSTS, MARKET << US, 10002, 1, 171700)
(AMETHYSTS, MARKET << US, 10002, 1, 171700)
(AMETHYSTS, MARKET << US, 10002, 1, 171700)
(AMETHYSTS, MARKET << US, 10002, 1, 171700)","{""AMETHYSTS"": -9, ""STARFRUIT"": -6}",1352,5049,10003
171800,-107,121566,"(AMETHYSTS, MARKET << US, 9995, 1, 171800)
(STARFRUIT, US << MARKET, 5051, 1, 171800)
(STARFRUIT, US << MARKET, 5051, 1, 171800)","{""AMETHYSTS"": -10, ""STARFRUIT"": -4}",1358,5052,10000
172300,-35329,86237,"(STARFRUIT, US << MARKET, 5047, 1, 172300)
(STARFRUIT, US << MARKET, 5047, 1, 172300)
(STARFRUIT, US << MARKET, 5047, 1, 172300)
(STARFRUIT, US << MARKET, 5047, 1, 172300)
(STARFRUIT, US << MARKET, 5047, 1, 172300)
(STARFRUIT, US << MARKET, 5047, 1, 172300)
(STARFRUIT, US << MARKET, 5047, 1, 172300)","{""AMETHYSTS"": -10, ""STARFRUIT"": 3}",1384,5049,10000
172500,-25235,61002,"(STARFRUIT, US << MARKET, 5047, 1, 172500)
(STARFRUIT, US << MARKET, 5047, 1, 172500)
(STARFRUIT, US << MARKET, 5047, 1, 172500)
(STARFRUIT, US << MARKET, 5047, 1, 172500)
(STARFRUIT, US << MARKET, 5047, 1, 172500)","{""AMETHYSTS"": -10, ""STARFRUIT"": 8}",1402,5050,10000
172600,-4950,56052,"(AMETHYSTS, US << MARKET, 10004, 1, 172600)
(STARFRUIT, MARKET << US, 5054, 1, 172600)","{""AMETHYSTS"": -9, ""STARFRUIT"": 7}",1402,5050,10000
172800,5048,61100,"(STARFRUIT, MARKET << US, 5048, 1, 172800)","{""AMETHYSTS"": -9, ""STARFRUIT"": 6}",1382,5047,10000
172900,-39992,21108,"(AMETHYSTS, US << MARKET, 9998, 1, 172900)
(AMETHYSTS, US << MARKET, 9998, 1, 172900)
(AMETHYSTS, US << MARKET, 9998, 1, 172900)
(AMETHYSTS, US << MARKET, 9998, 1, 172900)","{""AMETHYSTS"": -5, ""STARFRUIT"": 6}",1428,5050,9996
173000,-29898,-8790,"(AMETHYSTS, US << MARKET, 9998, 1, 173000)
(AMETHYSTS, US << MARKET, 9998, 1, 173000)
(AMETHYSTS, US << MARKET, 9998, 1, 173000)
(AMETHYSTS, US << MARKET, 9998, 1, 173000)
(STARFRUIT, MARKET << US, 5047, 1, 173000)
(STARFRUIT, MARKET << US, 5047, 1, 173000)","{""AMETHYSTS"": -1, ""STARFRUIT"": 4}",1409,5050,10001
173100,-10096,-18886,"(STARFRUIT, US << MARKET, 5048, 1, 173100)
(STARFRUIT, US << MARKET, 5048, 1, 173100)","{""AMETHYSTS"": -1, ""STARFRUIT"": 6}",1398,5047,9998
173300,9898,-8988,"(AMETHYSTS, MARKET << US, 10004, 1, 173300)
(AMETHYSTS, MARKET << US, 10004, 1, 173300)
(STARFRUIT, US << MARKET, 5055, 1, 173300)
(STARFRUIT, US << MARKET, 5055, 1, 173300)
(STARFRUIT, US << MARKET, 5055, 1, 173300)
(STARFRUIT, US << MARKET, 5055, 1, 173300)
(STARFRUIT, MARKET << US, 5055, 1, 173300)
(STARFRUIT, MARKET << US, 5055, 1, 173300)","{""AMETHYSTS"": -3, ""STARFRUIT"": 8}",1420,5051,10000
173600,-5053,-14041,"(STARFRUIT, US << MARKET, 5053, 1, 173600)","{""AMETHYSTS"": -3, ""STARFRUIT"": 9}",1442,5054,10001
174400,45257,31216,"(AMETHYSTS, MARKET << US, 10002, 1, 174400)
(AMETHYSTS, MARKET << US, 10002, 1, 174400)
(STARFRUIT, MARKET << US, 5051, 1, 174400)
(STARFRUIT, MARKET << US, 5051, 1, 174400)
(STARFRUIT, MARKET << US, 5051, 1, 174400)
(STARFRUIT, MARKET << US, 5050, 1, 174400)
(STARFRUIT, MARKET << US, 5050, 1, 174400)","{""AMETHYSTS"": -5, ""STARFRUIT"": 4}",1401,5050,10003
174600,20004,51220,"(AMETHYSTS, MARKET << US, 10002, 1, 174600)
(AMETHYSTS, MARKET << US, 10002, 1, 174600)","{""AMETHYSTS"": -7, ""STARFRUIT"": 4}",1450,5054,9998
174800,-10100,41120,"(STARFRUIT, US << MARKET, 5050, 1, 174800)
(STARFRUIT, US << MARKET, 5050, 1, 174800)","{""AMETHYSTS"": -7, ""STARFRUIT"": 6}",1432,5052,10000
175100,40008,81128,"(AMETHYSTS, MARKET << US, 10002, 1, 175100)
(AMETHYSTS, MARKET << US, 10002, 1, 175100)
(AMETHYSTS, MARKET << US, 10002, 1, 175100)
(AMETHYSTS, MARKET << US, 10002, 1, 175100)","{""AMETHYSTS"": -11, ""STARFRUIT"": 6}",1474,5054,9998
176300,-30015,51113,"(AMETHYSTS, US << MARKET, 10005, 1, 176300)
(AMETHYSTS, US << MARKET, 10005, 1, 176300)
(AMETHYSTS, US << MARKET, 10005, 1, 176300)","{""AMETHYSTS"": -8, ""STARFRUIT"": 6}",1429,5054,10001
176700,50096,101209,"(AMETHYSTS, MARKET << US, 9998, 1, 176700)
(AMETHYSTS, MARKET << US, 9998, 1, 176700)
(AMETHYSTS, MARKET << US, 9998, 1, 176700)
(AMETHYSTS, MARKET << US, 9998, 1, 176700)
(STARFRUIT, MARKET << US, 5052, 1, 176700)
(STARFRUIT, MARKET << US, 5052, 1, 176700)","{""AMETHYSTS"": -12, ""STARFRUIT"": 4}",1417,5055,10001
177000,-10104,91105,"(STARFRUIT, US << MARKET, 5052, 1, 177000)
(STARFRUIT, US << MARKET, 5052, 1, 177000)","{""AMETHYSTS"": -12, ""STARFRUIT"": 6}",1435,5055,10000
177600,-60030,31075,"(AMETHYSTS, US << MARKET, 10005, 1, 177600)
(AMETHYSTS, US << MARKET, 10005, 1, 177600)
(AMETHYSTS, US << MARKET, 10005, 1, 177600)
(AMETHYSTS, US << MARKET, 10005, 1, 177600)
(AMETHYSTS, US << MARKET, 10005, 1, 177600)
(AMETHYSTS, US << MARKET, 10005, 1, 177600)","{""AMETHYSTS"": -6, ""STARFRUIT"": 6}",1399,5054,10000
177900,9892,40967,"(AMETHYSTS, MARKET << US, 10004, 1, 177900)
(AMETHYSTS, MARKET << US, 10004, 1, 177900)
(STARFRUIT, US << MARKET, 5058, 1, 177900)
(STARFRUIT, US << MARKET, 5058, 1, 177900)","{""AMETHYSTS"": -8, ""STARFRUIT"": 8}",1407,5055,10000
178100,-20224,20743,"(STARFRUIT, US << MARKET, 5056, 1, 178100)
(STARFRUIT, US << MARKET, 5056, 1, 178100)
(STARFRUIT, US << MARKET, 5056, 1, 178100)
(STARFRUIT, US << MARKET, 5056, 1, 178100)","{""AMETHYSTS"": -8, ""STARFRUIT"": 12}",1427,5057,10000
178800,5052,25795,"(STARFRUIT, MARKET << US, 5052, 1, 178800)","{""AMETHYSTS"": -8, ""STARFRUIT"": 11}",1389,5054,10000
179000,-20236,5559,"(STARFRUIT, US << MARKET, 5059, 1, 179000)
(STARFRUIT, US << MARKET, 5059, 1, 179000)
(STARFRUIT, US << MARKET, 5059, 1, 179000)
(STARFRUIT, US << MARKET, 5059, 1, 179000)","{""AMETHYSTS"": -8, ""STARFRUIT"": 15}",1392,5055,9999
179500,-10002,-4443,"(AMETHYSTS, US << MARKET, 10002, 1, 179500)","{""AMETHYSTS"": -7, ""STARFRUIT"": 15}",1361,5055,10003
179600,-5057,-9500,"(STARFRUIT, US << MARKET, 5057, 1, 179600)","{""AMETHYSTS"": -7, ""STARFRUIT"": 16}",1412,5057,10000
179900,80016,70516,"(AMETHYSTS, MARKET << US, 10002, 1, 179900)
(AMETHYSTS, MARKET << US, 10002, 1, 179900)
(AMETHYSTS, MARKET << US, 10002, 1, 179900)
(AMETHYSTS, MARKET << US, 10002, 1, 179900)
(AMETHYSTS, MARKET << US, 10002, 1, 179900)
(AMETHYSTS, MARKET << US, 10002, 1, 179900)
(AMETHYSTS, MARKET << US, 10002, 1, 179900)
(AMETHYSTS, MARKET << US, 10002, 1, 179900)","{""AMETHYSTS"": -15, ""STARFRUIT"": 16}",1367,5056,10003
180000,-19996,50520,"(AMETHYSTS, US << MARKET, 9998, 1, 180000)
(AMETHYSTS, US << MARKET, 9998, 1, 180000)","{""AMETHYSTS"": -13, ""STARFRUIT"": 16}",1439,5055,9997
180100,-20232,30288,"(STARFRUIT, US << MARKET, 5058, 1, 180100)
(STARFRUIT, US << MARKET, 5058, 1, 180100)
(STARFRUIT, US << MARKET, 5058, 1, 180100)
(STARFRUIT, US << MARKET, 5058, 1, 180100)","{""AMETHYSTS"": -13, ""STARFRUIT"": 20}",1388,5055,10000
180300,5051,35339,"(STARFRUIT, MARKET << US, 5051, 1, 180300)","{""AMETHYSTS"": -13, ""STARFRUIT"": 19}",1398,5053,9996
180400,5057,40396,"(STARFRUIT, MARKET << US, 5057, 1, 180400)","{""AMETHYSTS"": -13, ""STARFRUIT"": 18}",1422,5057,10000
180600,-10002,30394,"(AMETHYSTS, US << MARKET, 10002, 1, 180600)","{""AMETHYSTS"": -12, ""STARFRUIT"": 18}",1348,5055,10003
180900,29900,60294,"(AMETHYSTS, MARKET << US, 10004, 1, 180900)
(AMETHYSTS, MARKET << US, 10004, 1, 180900)
(AMETHYSTS, MARKET << US, 10004, 1, 180900)
(AMETHYSTS, MARKET << US, 10004, 1, 180900)
(STARFRUIT, US << MARKET, 5058, 1, 180900)
(STARFRUIT, US << MARKET, 5058, 1, 180900)","{""AMETHYSTS"": -16, ""STARFRUIT"": 20}",1394,5055,10000
181600,-30006,30288,"(AMETHYSTS, US << MARKET, 10002, 1, 181600)
(AMETHYSTS, US << MARKET, 10002, 1, 181600)
(AMETHYSTS, US << MARKET, 10002, 1, 181600)","{""AMETHYSTS"": -13, ""STARFRUIT"": 20}",1309,5053,10003
181700,0,30288,,"{""AMETHYSTS"": -13, ""STARFRUIT"": 20}",1335,5053,10001
182200,0,30288,,"{""AMETHYSTS"": -13, ""STARFRUIT"": 20}",1255,5049,10001
182500,-10002,20286,"(AMETHYSTS, US << MARKET, 10002, 1, 182500)","{""AMETHYSTS"": -12, ""STARFRUIT"": 20}",1310,5053,10003
182800,20004,40290,"(AMETHYSTS, MARKET << US, 10002, 1, 182800)
(AMETHYSTS, MARKET << US, 10002, 1, 182800)","{""AMETHYSTS"": -14, ""STARFRUIT"": 20}",1298,5049,9998
182900,50550,90840,"(STARFRUIT, MARKET << US, 5055, 1, 182900)
(STARFRUIT, MARKET << US, 5055, 1, 182900)
(STARFRUIT, MARKET << US, 5055, 1, 182900)
(STARFRUIT, MARKET << US, 5055, 1, 182900)
(STARFRUIT, MARKET << US, 5055, 1, 182900)
(STARFRUIT, MARKET << US, 5055, 1, 182900)
(STARFRUIT, MARKET << US, 5055, 1, 182900)
(STARFRUIT, MARKET << US, 5055, 1, 182900)
(STARFRUIT, MARKET << US, 5055, 1, 182900)
(STARFRUIT, MARKET << US, 5055, 1, 182900)","{""AMETHYSTS"": -14, ""STARFRUIT"": 10}",1360,5052,10000
183300,-5049,85791,"(STARFRUIT, US << MARKET, 5049, 1, 183300)","{""AMETHYSTS"": -14, ""STARFRUIT"": 11}",1363,5052,10000
183400,-239952,-154161,"(AMETHYSTS, US << MARKET, 9998, 1, 183400)
(AMETHYSTS, US << MARKET, 9998, 1, 183400)
(AMETHYSTS, US << MARKET, 9998, 1, 183400)
(AMETHYSTS, US << MARKET, 9998, 1, 183400)
(AMETHYSTS, US << MARKET, 9998, 1, 183400)
(AMETHYSTS, US << MARKET, 9998, 1, 183400)
(AMETHYSTS, US << MARKET, 9998, 1, 183400)
(AMETHYSTS, US << MARKET, 9998, 1, 183400)
(AMETHYSTS, US << MARKET, 9998, 1, 183400)
(AMETHYSTS, US << MARKET, 9998, 1, 183400)
(AMETHYSTS, US << MARKET, 9998, 1, 183400)
(AMETHYSTS, US << MARKET, 9998, 1, 183400)
(AMETHYSTS, US << MARKET, 9998, 1, 183400)
(AMETHYSTS, US << MARKET, 9998, 1, 183400)
(AMETHYSTS, US << MARKET, 9998, 1, 183400)
(AMETHYSTS, US << MARKET, 9998, 1, 183400)
(AMETHYSTS, US << MARKET, 9998, 1, 183400)
(AMETHYSTS, US << MARKET, 9998, 1, 183400)
(AMETHYSTS, US << MARKET, 9998, 1, 183400)
(AMETHYSTS, US << MARKET, 9998, 1, 183400)
(AMETHYSTS, US << MARKET, 9998, 1, 183400)
(AMETHYSTS, US << MARKET, 9998, 1, 183400)
(AMETHYSTS, US << MARKET, 9998, 1, 183400)
(AMETHYSTS, US << MARKET, 9998, 1, 183400)","{""AMETHYSTS"": 10, ""STARFRUIT"": 11}",1359,5050,9997
183600,-208,-154369,"(AMETHYSTS, MARKET << US, 10002, 1, 183600)
(AMETHYSTS, MARKET << US, 10002, 1, 183600)
(STARFRUIT, US << MARKET, 5053, 1, 183600)
(STARFRUIT, US << MARKET, 5053, 1, 183600)
(STARFRUIT, US << MARKET, 5053, 1, 183600)
(STARFRUIT, US << MARKET, 5053, 1, 183600)","{""AMETHYSTS"": 8, ""STARFRUIT"": 15}",1425,5054,9998
183800,-5048,-159417,"(STARFRUIT, US << MARKET, 5048, 1, 183800)","{""AMETHYSTS"": 8, ""STARFRUIT"": 16}",1399,5051,10000
184800,4945,-154472,"(AMETHYSTS, MARKET << US, 9998, 1, 184800)
(STARFRUIT, US << MARKET, 5053, 1, 184800)","{""AMETHYSTS"": 7, ""STARFRUIT"": 17}",1453,5054,10001
185000,-14943,-169415,"(AMETHYSTS, US << MARKET, 9996, 1, 185000)
(AMETHYSTS, US << MARKET, 9996, 1, 185000)
(STARFRUIT, MARKET << US, 5049, 1, 185000)","{""AMETHYSTS"": 9, ""STARFRUIT"": 16}",1401,5051,10000
185500,-29888,-199303,"(AMETHYSTS, US << MARKET, 9996, 1, 185500)
(AMETHYSTS, US << MARKET, 9996, 1, 185500)
(AMETHYSTS, US << MARKET, 9996, 1, 185500)
(AMETHYSTS, US << MARKET, 9996, 1, 185500)
(STARFRUIT, MARKET << US, 5048, 1, 185500)
(STARFRUIT, MARKET << US, 5048, 1, 185500)","{""AMETHYSTS"": 13, ""STARFRUIT"": 14}",1411,5051,10000
185600,40384,-158919,"(STARFRUIT, MARKET << US, 5048, 1, 185600)
(STARFRUIT, MARKET << US, 5048, 1, 185600)
(STARFRUIT, MARKET << US, 5048, 1, 185600)
(STARFRUIT, MARKET << US, 5048, 1, 185600)
(STARFRUIT, MARKET << US, 5048, 1, 185600)
(STARFRUIT, MARKET << US, 5048, 1, 185600)
(STARFRUIT, MARKET << US, 5048, 1, 185600)
(STARFRUIT, MARKET << US, 5048, 1, 185600)","{""AMETHYSTS"": 13, ""STARFRUIT"": 6}",1374,5051,9999
185800,-10106,-169025,"(STARFRUIT, US << MARKET, 5053, 1, 185800)
(STARFRUIT, US << MARKET, 5053, 1, 185800)","{""AMETHYSTS"": 13, ""STARFRUIT"": 8}",1386,5053,9999
186200,100020,-69005,"(AMETHYSTS, MARKET << US, 10002, 1, 186200)
(AMETHYSTS, MARKET << US, 10002, 1, 186200)
(AMETHYSTS, MARKET << US, 10002, 1, 186200)
(AMETHYSTS, MARKET << US, 10002, 1, 186200)
(AMETHYSTS, MARKET << US, 10002, 1, 186200)
(AMETHYSTS, MARKET << US, 10002, 1, 186200)
(AMETHYSTS, MARKET << US, 10002, 1, 186200)
(AMETHYSTS, MARKET << US, 10002, 1, 186200)
(AMETHYSTS, MARKET << US, 10002, 1, 186200)
(AMETHYSTS, MARKET << US, 10002, 1, 186200)","{""AMETHYSTS"": 3, ""STARFRUIT"": 8}",1400,5051,9999
186700,-159936,-228941,"(AMETHYSTS, US << MARKET, 9996, 1, 186700)
(AMETHYSTS, US << MARKET, 9996, 1, 186700)
(AMETHYSTS, US << MARKET, 9996, 1, 186700)
(AMETHYSTS, US << MARKET, 9996, 1, 186700)
(AMETHYSTS, US << MARKET, 9996, 1, 186700)
(AMETHYSTS, US << MARKET, 9996, 1, 186700)
(AMETHYSTS, US << MARKET, 9996, 1, 186700)
(AMETHYSTS, US << MARKET, 9996, 1, 186700)
(AMETHYSTS, US << MARKET, 9996, 1, 186700)
(AMETHYSTS, US << MARKET, 9996, 1, 186700)
(AMETHYSTS, US << MARKET, 9996, 1, 186700)
(AMETHYSTS, US << MARKET, 9996, 1, 186700)
(AMETHYSTS, US << MARKET, 9996, 1, 186700)
(AMETHYSTS, US << MARKET, 9996, 1, 186700)
(AMETHYSTS, US << MARKET, 9996, 1, 186700)
(AMETHYSTS, US << MARKET, 9996, 1, 186700)","{""AMETHYSTS"": 19, ""STARFRUIT"": 8}",1410,5051,9997
187000,5050,-223891,"(STARFRUIT, MARKET << US, 5050, 1, 187000)","{""AMETHYSTS"": 19, ""STARFRUIT"": 7}",1452,5049,10000
187200,-9998,-233889,"(AMETHYSTS, US << MARKET, 9998, 1, 187200)","{""AMETHYSTS"": 20, ""STARFRUIT"": 7}",1416,5055,9996
187300,-5050,-238939,"(STARFRUIT, US << MARKET, 5050, 1, 187300)","{""AMETHYSTS"": 20, ""STARFRUIT"": 8}",1437,5052,9998
187600,25053,-213886,"(AMETHYSTS, MARKET << US, 10002, 1, 187600)
(AMETHYSTS, MARKET << US, 10002, 1, 187600)
(STARFRUIT, MARKET << US, 5049, 1, 187600)","{""AMETHYSTS"": 18, ""STARFRUIT"": 7}",1532,5052,10003
187900,80008,-133878,"(AMETHYSTS, MARKET << US, 10004, 1, 187900)
(AMETHYSTS, MARKET << US, 10004, 1, 187900)
(AMETHYSTS, MARKET << US, 10004, 1, 187900)
(AMETHYSTS, MARKET << US, 10004, 1, 187900)
(AMETHYSTS, MARKET << US, 9998, 1, 187900)
(AMETHYSTS, MARKET << US, 9998, 1, 187900)
(AMETHYSTS, MARKET << US, 9998, 1, 187900)
(AMETHYSTS, MARKET << US, 9998, 1, 187900)","{""AMETHYSTS"": 10, ""STARFRUIT"": 7}",1475,5049,10001
188200,-15050,-148928,"(AMETHYSTS, US << MARKET, 9998, 1, 188200)
(AMETHYSTS, US << MARKET, 9998, 1, 188200)
(AMETHYSTS, MARKET << US, 9996, 1, 188200)
(STARFRUIT, US << MARKET, 5050, 1, 188200)","{""AMETHYSTS"": 11, ""STARFRUIT"": 8}",1447,5051,9997
188500,-15061,-163989,"(AMETHYSTS, US << MARKET, 10005, 1, 188500)
(STARFRUIT, US << MARKET, 5056, 1, 188500)","{""AMETHYSTS"": 12, ""STARFRUIT"": 9}",1479,5052,10000
189200,19992,-143997,"(AMETHYSTS, MARKET << US, 9996, 1, 189200)
(AMETHYSTS, MARKET << US, 9996, 1, 189200)","{""AMETHYSTS"": 10, ""STARFRUIT"": 9}",1471,5052,10000
189600,-30108,-174105,"(AMETHYSTS, US << MARKET, 10002, 1, 189600)
(AMETHYSTS, US << MARKET, 10002, 1, 189600)
(STARFRUIT, US << MARKET, 5052, 1, 189600)
(STARFRUIT, US << MARKET, 5052, 1, 189600)","{""AMETHYSTS"": 12, ""STARFRUIT"": 11}",1481,5050,10003
189800,-19996,-194101,"(AMETHYSTS, US << MARKET, 9998, 1, 189800)
(AMETHYSTS, US << MARKET, 9998, 1, 189800)","{""AMETHYSTS"": 14, ""STARFRUIT"": 11}",1415,5052,9996
190000,-19996,-214097,"(AMETHYSTS, US << MARKET, 9998, 1, 190000)
(AMETHYSTS, US << MARKET, 9998, 1, 190000)","{""AMETHYSTS"": 16, ""STARFRUIT"": 11}",1427,5052,9997
190200,5048,-209049,"(STARFRUIT, MARKET << US, 5048, 1, 190200)","{""AMETHYSTS"": 16, ""STARFRUIT"": 10}",1387,5050,9996
190300,19992,-189057,"(AMETHYSTS, MARKET << US, 9996, 1, 190300)
(AMETHYSTS, MARKET << US, 9996, 1, 190300)","{""AMETHYSTS"": 14, ""STARFRUIT"": 10}",1443,5050,10000
190800,-20200,-209257,"(STARFRUIT, US << MARKET, 5050, 1, 190800)
(STARFRUIT, US << MARKET, 5050, 1, 190800)
(STARFRUIT, US << MARKET, 5050, 1, 190800)
(STARFRUIT, US << MARKET, 5050, 1, 190800)","{""AMETHYSTS"": 14, ""STARFRUIT"": 14}",1443,5051,9999
190900,-50070,-259327,"(AMETHYSTS, US << MARKET, 9995, 1, 190900)
(AMETHYSTS, US << MARKET, 9995, 1, 190900)
(AMETHYSTS, US << MARKET, 9995, 1, 190900)
(AMETHYSTS, US << MARKET, 9995, 1, 190900)
(STARFRUIT, US << MARKET, 5045, 1, 190900)
(STARFRUIT, US << MARKET, 5045, 1, 190900)","{""AMETHYSTS"": 18, ""STARFRUIT"": 16}",1405,5048,9998
192200,5050,-254277,"(STARFRUIT, MARKET << US, 5050, 1, 192200)","{""AMETHYSTS"": 18, ""STARFRUIT"": 15}",1488,5051,10000
192400,40424,-213853,"(STARFRUIT, MARKET << US, 5053, 1, 192400)
(STARFRUIT, MARKET << US, 5053, 1, 192400)
(STARFRUIT, MARKET << US, 5053, 1, 192400)
(STARFRUIT, MARKET << US, 5053, 1, 192400)
(STARFRUIT, MARKET << US, 5053, 1, 192400)
(STARFRUIT, MARKET << US, 5053, 1, 192400)
(STARFRUIT, MARKET << US, 5053, 1, 192400)
(STARFRUIT, MARKET << US, 5053, 1, 192400)","{""AMETHYSTS"": 18, ""STARFRUIT"": 7}",1490,5049,10000
192900,0,-213853,"(STARFRUIT, US << MARKET, 5048, 1, 192900)
(STARFRUIT, US << MARKET, 5048, 1, 192900)
(STARFRUIT, MARKET << US, 5048, 1, 192900)
(STARFRUIT, MARKET << US, 5048, 1, 192900)","{""AMETHYSTS"": 18, ""STARFRUIT"": 7}",1540,5051,10002
193000,-9896,-223749,"(AMETHYSTS, US << MARKET, 9995, 1, 193000)
(AMETHYSTS, US << MARKET, 9995, 1, 193000)
(STARFRUIT, MARKET << US, 5047, 1, 193000)
(STARFRUIT, MARKET << US, 5047, 1, 193000)","{""AMETHYSTS"": 20, ""STARFRUIT"": 5}",1426,5047,9997
193100,-10094,-233843,"(STARFRUIT, US << MARKET, 5047, 1, 193100)
(STARFRUIT, US << MARKET, 5047, 1, 193100)","{""AMETHYSTS"": 20, ""STARFRUIT"": 7}",1507,5050,10000
193200,-5051,-238894,"(STARFRUIT, US << MARKET, 5051, 1, 193200)","{""AMETHYSTS"": 20, ""STARFRUIT"": 8}",1482,5052,9998
193700,250422,11528,"(AMETHYSTS, MARKET << US, 10005, 1, 193700)
(AMETHYSTS, MARKET << US, 10005, 1, 193700)
(AMETHYSTS, MARKET << US, 10005, 1, 193700)
(AMETHYSTS, MARKET << US, 10005, 1, 193700)
(AMETHYSTS, MARKET << US, 10005, 1, 193700)
(AMETHYSTS, MARKET << US, 10005, 1, 193700)
(AMETHYSTS, MARKET << US, 10005, 1, 193700)
(AMETHYSTS, MARKET << US, 10005, 1, 193700)
(AMETHYSTS, MARKET << US, 10005, 1, 193700)
(AMETHYSTS, MARKET << US, 10005, 1, 193700)
(AMETHYSTS, MARKET << US, 10005, 1, 193700)
(AMETHYSTS, MARKET << US, 10005, 1, 193700)
(AMETHYSTS, MARKET << US, 10005, 1, 193700)
(AMETHYSTS, MARKET << US, 10005, 1, 193700)
(AMETHYSTS, MARKET << US, 10005, 1, 193700)
(AMETHYSTS, MARKET << US, 10005, 1, 193700)
(AMETHYSTS, MARKET << US, 10005, 1, 193700)
(AMETHYSTS, MARKET << US, 10005, 1, 193700)
(AMETHYSTS, MARKET << US, 10005, 1, 193700)
(AMETHYSTS, MARKET << US, 10005, 1, 193700)
(AMETHYSTS, MARKET << US, 10005, 1, 193700)
(AMETHYSTS, MARKET << US, 10005, 1, 193700)
(STARFRUIT, MARKET << US, 5052, 1, 193700)
(STARFRUIT, MARKET << US, 5052, 1, 193700)
(STARFRUIT, MARKET << US, 5052, 1, 193700)
(STARFRUIT, MARKET << US, 5052, 1, 193700)
(STARFRUIT, MARKET << US, 5052, 1, 193700)
(STARFRUIT, MARKET << US, 5052, 1, 193700)","{""AMETHYSTS"": -2, ""STARFRUIT"": 2}",1624,5048,10000
193800,9998,21526,"(AMETHYSTS, MARKET << US, 9998, 1, 193800)","{""AMETHYSTS"": -3, ""STARFRUIT"": 2}",1621,5049,10001
193900,-34932,-13406,"(AMETHYSTS, US << MARKET, 9996, 1, 193900)
(AMETHYSTS, US << MARKET, 9996, 1, 193900)
(AMETHYSTS, US << MARKET, 9996, 1, 193900)
(AMETHYSTS, US << MARKET, 9996, 1, 193900)
(STARFRUIT, MARKET << US, 5052, 1, 193900)","{""AMETHYSTS"": 1, ""STARFRUIT"": 1}",1643,5049,10000
194000,-10108,-23514,"(STARFRUIT, US << MARKET, 5054, 1, 194000)
(STARFRUIT, US << MARKET, 5054, 1, 194000)","{""AMETHYSTS"": 1, ""STARFRUIT"": 3}",1636,5050,10000
194200,-4953,-28467,"(AMETHYSTS, US << MARKET, 10002, 1, 194200)
(STARFRUIT, MARKET << US, 5049, 1, 194200)","{""AMETHYSTS"": 2, ""STARFRUIT"": 2}",1643,5052,10003
194300,-10096,-38563,"(STARFRUIT, US << MARKET, 5048, 1, 194300)
(STARFRUIT, US << MARKET, 5048, 1, 194300)","{""AMETHYSTS"": 2, ""STARFRUIT"": 4}",1641,5051,10000
194800,-14942,-53505,"(AMETHYSTS, US << MARKET, 9995, 1, 194800)
(AMETHYSTS, US << MARKET, 9995, 1, 194800)
(STARFRUIT, MARKET << US, 5048, 1, 194800)","{""AMETHYSTS"": 4, ""STARFRUIT"": 3}",1645,5050,10000
195100,-19992,-73497,"(AMETHYSTS, US << MARKET, 9996, 1, 195100)
(AMETHYSTS, US << MARKET, 9996, 1, 195100)","{""AMETHYSTS"": 6, ""STARFRUIT"": 3}",1656,5051,10000
195300,-20208,-93705,"(STARFRUIT, US << MARKET, 5052, 1, 195300)
(STARFRUIT, US << MARKET, 5052, 1, 195300)
(STARFRUIT, US << MARKET, 5052, 1, 195300)
(STARFRUIT, US << MARKET, 5052, 1, 195300)","{""AMETHYSTS"": 6, ""STARFRUIT"": 7}",1666,5053,10000
195500,-5047,-98752,"(STARFRUIT, US << MARKET, 5047, 1, 195500)","{""AMETHYSTS"": 6, ""STARFRUIT"": 8}",1666,5050,10003
195600,29918,-68834,"(AMETHYSTS, MARKET << US, 10004, 1, 195600)
(AMETHYSTS, MARKET << US, 10004, 1, 195600)
(AMETHYSTS, MARKET << US, 10004, 1, 195600)
(AMETHYSTS, MARKET << US, 10004, 1, 195600)
(STARFRUIT, US << MARKET, 5049, 1, 195600)
(STARFRUIT, US << MARKET, 5049, 1, 195600)","{""AMETHYSTS"": 2, ""STARFRUIT"": 10}",1648,5048,10001
195700,25255,-43579,"(STARFRUIT, MARKET << US, 5051, 1, 195700)
(STARFRUIT, MARKET << US, 5051, 1, 195700)
(STARFRUIT, MARKET << US, 5051, 1, 195700)
(STARFRUIT, MARKET << US, 5051, 1, 195700)
(STARFRUIT, MARKET << US, 5051, 1, 195700)","{""AMETHYSTS"": 2, ""STARFRUIT"": 5}",1683,5052,10001
196100,25260,-18319,"(STARFRUIT, MARKET << US, 5052, 1, 196100)
(STARFRUIT, MARKET << US, 5052, 1, 196100)
(STARFRUIT, MARKET << US, 5052, 1, 196100)
(STARFRUIT, MARKET << US, 5052, 1, 196100)
(STARFRUIT, MARKET << US, 5052, 1, 196100)","{""AMETHYSTS"": 2, ""STARFRUIT"": 0}",1681,5049,10000
196700,5052,-13267,"(STARFRUIT, MARKET << US, 5052, 1, 196700)","{""AMETHYSTS"": 2, ""STARFRUIT"": -1}",1683,5052,10001
197000,9998,-3269,"(AMETHYSTS, MARKET << US, 9998, 1, 197000)","{""AMETHYSTS"": 1, ""STARFRUIT"": -1}",1679,5049,9997
197100,-10002,-13271,"(AMETHYSTS, US << MARKET, 10002, 1, 197100)","{""AMETHYSTS"": 2, ""STARFRUIT"": -1}",1685,5050,10003
197400,9996,-3275,"(AMETHYSTS, MARKET << US, 9996, 1, 197400)","{""AMETHYSTS"": 1, ""STARFRUIT"": -1}",1672,5050,9997
197500,-99980,-103255,"(AMETHYSTS, US << MARKET, 9998, 1, 197500)
(AMETHYSTS, US << MARKET, 9998, 1, 197500)
(AMETHYSTS, US << MARKET, 9998, 1, 197500)
(AMETHYSTS, US << MARKET, 9998, 1, 197500)
(AMETHYSTS, US << MARKET, 9998, 1, 197500)
(AMETHYSTS, US << MARKET, 9998, 1, 197500)
(AMETHYSTS, US << MARKET, 9998, 1, 197500)
(AMETHYSTS, US << MARKET, 9998, 1, 197500)
(AMETHYSTS, US << MARKET, 9998, 1, 197500)
(AMETHYSTS, US << MARKET, 9998, 1, 197500)","{""AMETHYSTS"": 11, ""STARFRUIT"": -1}",1706,5050,10001
197700,-14943,-118198,"(AMETHYSTS, US << MARKET, 9995, 1, 197700)
(AMETHYSTS, US << MARKET, 9995, 1, 197700)
(STARFRUIT, MARKET << US, 5047, 1, 197700)","{""AMETHYSTS"": 13, ""STARFRUIT"": -2}",1682,5047,9998
198000,5048,-113150,"(STARFRUIT, MARKET << US, 5048, 1, 198000)","{""AMETHYSTS"": 13, ""STARFRUIT"": -3}",1697,5051,10000
198400,-9900,-123050,"(AMETHYSTS, US << MARKET, 9998, 1, 198400)
(AMETHYSTS, US << MARKET, 9998, 1, 198400)
(STARFRUIT, MARKET << US, 5048, 1, 198400)
(STARFRUIT, MARKET << US, 5048, 1, 198400)","{""AMETHYSTS"": 15, ""STARFRUIT"": -5}",1730,5047,10001
198500,-30006,-153056,"(AMETHYSTS, US << MARKET, 10002, 1, 198500)
(AMETHYSTS, US << MARKET, 10002, 1, 198500)
(AMETHYSTS, US << MARKET, 10002, 1, 198500)","{""AMETHYSTS"": 18, ""STARFRUIT"": -5}",1681,5049,9999
199000,-10094,-163150,"(STARFRUIT, US << MARKET, 5047, 1, 199000)
(STARFRUIT, US << MARKET, 5047, 1, 199000)","{""AMETHYSTS"": 18, ""STARFRUIT"": -3}",1700,5050,10000
199300,5053,-158097,"(STARFRUIT, MARKET << US, 5053, 1, 199300)","{""AMETHYSTS"": 18, ""STARFRUIT"": -4}",1691,5053,10000
199400,10002,-148095,"(AMETHYSTS, US << MARKET, 10002, 1, 199400)
(AMETHYSTS, MARKET << US, 10002, 1, 199400)
(AMETHYSTS, MARKET << US, 10002, 1, 199400)","{""AMETHYSTS"": 17, ""STARFRUIT"": -4}",1760,5049,10003
199700,20004,-128091,"(AMETHYSTS, MARKET << US, 10002, 1, 199700)
(AMETHYSTS, MARKET << US, 10002, 1, 199700)","{""AMETHYSTS"": 15, ""STARFRUIT"": -4}",1754,5050,10003
200100,79828,-48263,"(AMETHYSTS, MARKET << US, 10002, 1, 200100)
(AMETHYSTS, MARKET << US, 10002, 1, 200100)
(AMETHYSTS, MARKET << US, 10002, 1, 200100)
(AMETHYSTS, MARKET << US, 10002, 1, 200100)
(AMETHYSTS, MARKET << US, 10002, 1, 200100)
(AMETHYSTS, MARKET << US, 10002, 1, 200100)
(AMETHYSTS, MARKET << US, 10002, 1, 200100)
(AMETHYSTS, MARKET << US, 10002, 1, 200100)
(AMETHYSTS, MARKET << US, 10002, 1, 200100)
(AMETHYSTS, MARKET << US, 10002, 1, 200100)
(STARFRUIT, US << MARKET, 5048, 1, 200100)
(STARFRUIT, US << MARKET, 5048, 1, 200100)
(STARFRUIT, US << MARKET, 5048, 1, 200100)
(STARFRUIT, US << MARKET, 5048, 1, 200100)","{""AMETHYSTS"": 5, ""STARFRUIT"": 0}",1752,5047,10003
200200,15141,-33122,"(STARFRUIT, MARKET << US, 5047, 1, 200200)
(STARFRUIT, MARKET << US, 5047, 1, 200200)
(STARFRUIT, MARKET << US, 5047, 1, 200200)","{""AMETHYSTS"": 5, ""STARFRUIT"": -3}",1708,5050,9996
200300,45064,11942,"(AMETHYSTS, MARKET << US, 10004, 1, 200300)
(AMETHYSTS, MARKET << US, 10004, 1, 200300)
(AMETHYSTS, MARKET << US, 10004, 1, 200300)
(AMETHYSTS, MARKET << US, 10004, 1, 200300)
(STARFRUIT, MARKET << US, 5048, 1, 200300)","{""AMETHYSTS"": 1, ""STARFRUIT"": -4}",1755,5047,10001
200400,25062,37004,"(AMETHYSTS, MARKET << US, 10004, 1, 200400)
(AMETHYSTS, MARKET << US, 10004, 1, 200400)
(STARFRUIT, MARKET << US, 5054, 1, 200400)","{""AMETHYSTS"": -1, ""STARFRUIT"": -5}",1749,5051,10000
200800,-10002,27002,"(AMETHYSTS, US << MARKET, 10002, 1, 200800)","{""AMETHYSTS"": 0, ""STARFRUIT"": -5}",1747,5051,9998
200900,-10094,16908,"(STARFRUIT, US << MARKET, 5047, 1, 200900)
(STARFRUIT, US << MARKET, 5047, 1, 200900)","{""AMETHYSTS"": 0, ""STARFRUIT"": -3}",1758,5050,9999
201800,-59988,-43080,"(AMETHYSTS, US << MARKET, 9998, 1, 201800)
(AMETHYSTS, US << MARKET, 9998, 1, 201800)
(AMETHYSTS, US << MARKET, 9998, 1, 201800)
(AMETHYSTS, US << MARKET, 9998, 1, 201800)
(AMETHYSTS, US << MARKET, 9998, 1, 201800)
(AMETHYSTS, US << MARKET, 9998, 1, 201800)","{""AMETHYSTS"": 6, ""STARFRUIT"": -3}",1755,5049,9997
202000,-30006,-73086,"(AMETHYSTS, US << MARKET, 10002, 1, 202000)
(AMETHYSTS, US << MARKET, 10002, 1, 202000)
(AMETHYSTS, US << MARKET, 10002, 1, 202000)","{""AMETHYSTS"": 9, ""STARFRUIT"": -3}",1791,5050,10003
202100,5048,-68038,"(STARFRUIT, MARKET << US, 5048, 1, 202100)","{""AMETHYSTS"": 9, ""STARFRUIT"": -4}",1783,5047,10001
202200,100020,31982,"(AMETHYSTS, MARKET << US, 10002, 1, 202200)
(AMETHYSTS, MARKET << US, 10002, 1, 202200)
(AMETHYSTS, MARKET << US, 10002, 1, 202200)
(AMETHYSTS, MARKET << US, 10002, 1, 202200)
(AMETHYSTS, MARKET << US, 10002, 1, 202200)
(AMETHYSTS, MARKET << US, 10002, 1, 202200)
(AMETHYSTS, MARKET << US, 10002, 1, 202200)
(AMETHYSTS, MARKET << US, 10002, 1, 202200)
(AMETHYSTS, MARKET << US, 10002, 1, 202200)
(AMETHYSTS, MARKET << US, 10002, 1, 202200)","{""AMETHYSTS"": -1, ""STARFRUIT"": -4}",1771,5052,10003
202600,-40008,-8026,"(AMETHYSTS, US << MARKET, 10002, 1, 202600)
(AMETHYSTS, US << MARKET, 10002, 1, 202600)
(AMETHYSTS, US << MARKET, 10002, 1, 202600)
(AMETHYSTS, US << MARKET, 10002, 1, 202600)","{""AMETHYSTS"": 3, ""STARFRUIT"": -4}",1783,5050,10003
203000,-10104,-18130,"(STARFRUIT, US << MARKET, 5052, 1, 203000)
(STARFRUIT, US << MARKET, 5052, 1, 203000)","{""AMETHYSTS"": 3, ""STARFRUIT"": -2}",1767,5053,10001
203300,19992,1862,"(AMETHYSTS, MARKET << US, 9996, 1, 203300)
(AMETHYSTS, MARKET << US, 9996, 1, 203300)","{""AMETHYSTS"": 1, ""STARFRUIT"": -2}",1764,5048,9998
203700,5051,6913,"(STARFRUIT, MARKET << US, 5051, 1, 203700)","{""AMETHYSTS"": 1, ""STARFRUIT"": -3}",1761,5051,10001
203900,-192,6721,"(AMETHYSTS, MARKET << US, 10004, 1, 203900)
(AMETHYSTS, MARKET << US, 10004, 1, 203900)
(STARFRUIT, US << MARKET, 5050, 1, 203900)
(STARFRUIT, US << MARKET, 5050, 1, 203900)
(STARFRUIT, US << MARKET, 5050, 1, 203900)
(STARFRUIT, US << MARKET, 5050, 1, 203900)","{""AMETHYSTS"": -1, ""STARFRUIT"": 1}",1765,5047,10003
204000,10098,16819,"(STARFRUIT, MARKET << US, 5049, 1, 204000)
(STARFRUIT, MARKET << US, 5049, 1, 204000)","{""AMETHYSTS"": -1, ""STARFRUIT"": -1}",1768,5050,10001
204200,-10100,6719,"(STARFRUIT, US << MARKET, 5050, 1, 204200)
(STARFRUIT, US << MARKET, 5050, 1, 204200)","{""AMETHYSTS"": -1, ""STARFRUIT"": 1}",1766,5047,10000
204400,5050,11769,"(STARFRUIT, MARKET << US, 5050, 1, 204400)","{""AMETHYSTS"": -1, ""STARFRUIT"": 0}",1768,5047,10001
204500,-10100,1669,"(STARFRUIT, US << MARKET, 5050, 1, 204500)
(STARFRUIT, US << MARKET, 5050, 1, 204500)","{""AMETHYSTS"": -1, ""STARFRUIT"": 2}",1760,5047,10003
204800,160064,161733,"(AMETHYSTS, MARKET << US, 10004, 1, 204800)
(AMETHYSTS, MARKET << US, 10004, 1, 204800)
(AMETHYSTS, MARKET << US, 10004, 1, 204800)
(AMETHYSTS, MARKET << US, 10004, 1, 204800)
(AMETHYSTS, MARKET << US, 10004, 1, 204800)
(AMETHYSTS, MARKET << US, 10004, 1, 204800)
(AMETHYSTS, MARKET << US, 10004, 1, 204800)
(AMETHYSTS, MARKET << US, 10004, 1, 204800)
(AMETHYSTS, MARKET << US, 10004, 1, 204800)
(AMETHYSTS, MARKET << US, 10004, 1, 204800)
(AMETHYSTS, MARKET << US, 10004, 1, 204800)
(AMETHYSTS, MARKET << US, 10004, 1, 204800)
(AMETHYSTS, MARKET << US, 10004, 1, 204800)
(AMETHYSTS, MARKET << US, 10004, 1, 204800)
(AMETHYSTS, MARKET << US, 10004, 1, 204800)
(AMETHYSTS, MARKET << US, 10004, 1, 204800)","{""AMETHYSTS"": -17, ""STARFRUIT"": 2}",1825,5046,10000
205000,-4864,156869,"(AMETHYSTS, US << MARKET, 10004, 1, 205000)
(AMETHYSTS, US << MARKET, 10004, 1, 205000)
(STARFRUIT, MARKET << US, 5050, 1, 205000)
(STARFRUIT, MARKET << US, 5050, 1, 205000)
(STARFRUIT, MARKET << US, 5044, 1, 205000)","{""AMETHYSTS"": -15, ""STARFRUIT"": -1}",1822,5047,10000
205400,5050,161919,"(STARFRUIT, MARKET << US, 5050, 1, 205400)","{""AMETHYSTS"": -15, ""STARFRUIT"": -2}",1804,5050,10001
205800,-10002,151917,"(AMETHYSTS, US << MARKET, 10002, 1, 205800)","{""AMETHYSTS"": -14, ""STARFRUIT"": -2}",1849,5048,9998
206400,-60160,91757,"(AMETHYSTS, US << MARKET, 9996, 1, 206400)
(AMETHYSTS, US << MARKET, 9996, 1, 206400)
(AMETHYSTS, US << MARKET, 9996, 1, 206400)
(AMETHYSTS, US << MARKET, 9996, 1, 206400)
(STARFRUIT, US << MARKET, 5044, 1, 206400)
(STARFRUIT, US << MARKET, 5044, 1, 206400)
(STARFRUIT, US << MARKET, 5044, 1, 206400)
(STARFRUIT, US << MARKET, 5044, 1, 206400)","{""AMETHYSTS"": -10, ""STARFRUIT"": 2}",1861,5047,9999
206700,20180,111937,"(STARFRUIT, MARKET << US, 5045, 1, 206700)
(STARFRUIT, MARKET << US, 5045, 1, 206700)
(STARFRUIT, MARKET << US, 5045, 1, 206700)
(STARFRUIT, MARKET << US, 5045, 1, 206700)","{""AMETHYSTS"": -10, ""STARFRUIT"": -2}",1849,5044,10000
207000,-14953,96984,"(AMETHYSTS, US << MARKET, 9998, 1, 207000)
(AMETHYSTS, US << MARKET, 9998, 1, 207000)
(STARFRUIT, MARKET << US, 5043, 1, 207000)","{""AMETHYSTS"": -8, ""STARFRUIT"": -3}",1890,5042,9996
207300,-4954,92030,"(AMETHYSTS, US << MARKET, 10004, 1, 207300)
(STARFRUIT, MARKET << US, 5050, 1, 207300)","{""AMETHYSTS"": -7, ""STARFRUIT"": -4}",1842,5047,10000
207500,-139944,-47914,"(AMETHYSTS, US << MARKET, 9996, 1, 207500)
(AMETHYSTS, US << MARKET, 9996, 1, 207500)
(AMETHYSTS, US << MARKET, 9996, 1, 207500)
(AMETHYSTS, US << MARKET, 9996, 1, 207500)
(AMETHYSTS, US << MARKET, 9996, 1, 207500)
(AMETHYSTS, US << MARKET, 9996, 1, 207500)
(AMETHYSTS, US << MARKET, 9996, 1, 207500)
(AMETHYSTS, US << MARKET, 9996, 1, 207500)
(AMETHYSTS, US << MARKET, 9996, 1, 207500)
(AMETHYSTS, US << MARKET, 9996, 1, 207500)
(AMETHYSTS, US << MARKET, 9996, 1, 207500)
(AMETHYSTS, US << MARKET, 9996, 1, 207500)
(AMETHYSTS, US << MARKET, 9996, 1, 207500)
(AMETHYSTS, US << MARKET, 9996, 1, 207500)","{""AMETHYSTS"": 7, ""STARFRUIT"": -4}",1898,5047,10000
207600,10096,-37818,"(STARFRUIT, MARKET << US, 5048, 1, 207600)
(STARFRUIT, MARKET << US, 5048, 1, 207600)","{""AMETHYSTS"": 7, ""STARFRUIT"": -6}",1888,5049,10000
207800,-35358,-73176,"(STARFRUIT, US << MARKET, 5051, 1, 207800)
(STARFRUIT, US << MARKET, 5051, 1, 207800)
(STARFRUIT, US << MARKET, 5051, 1, 207800)
(STARFRUIT, US << MARKET, 5051, 1, 207800)
(STARFRUIT, US << MARKET, 5051, 1, 207800)
(STARFRUIT, US << MARKET, 5051, 1, 207800)
(STARFRUIT, US << MARKET, 5051, 1, 207800)
(STARFRUIT, US << MARKET, 5051, 1, 207800)
(STARFRUIT, MARKET << US, 5050, 1, 207800)","{""AMETHYSTS"": 7, ""STARFRUIT"": 1}",1881,5050,10001
208000,-20108,-93284,"(AMETHYSTS, US << MARKET, 10004, 1, 208000)
(STARFRUIT, US << MARKET, 5052, 1, 208000)
(STARFRUIT, US << MARKET, 5052, 1, 208000)","{""AMETHYSTS"": 8, ""STARFRUIT"": 3}",1887,5049,10003
208100,30182,-63102,"(AMETHYSTS, MARKET << US, 9998, 1, 208100)
(STARFRUIT, MARKET << US, 5046, 1, 208100)
(STARFRUIT, MARKET << US, 5046, 1, 208100)
(STARFRUIT, MARKET << US, 5046, 1, 208100)
(STARFRUIT, MARKET << US, 5046, 1, 208100)","{""AMETHYSTS"": 7, ""STARFRUIT"": -1}",1828,5049,9997
208300,-10088,-73190,"(STARFRUIT, US << MARKET, 5044, 1, 208300)
(STARFRUIT, US << MARKET, 5044, 1, 208300)","{""AMETHYSTS"": 7, ""STARFRUIT"": 1}",1878,5047,10003
208700,-10090,-83280,"(STARFRUIT, US << MARKET, 5045, 1, 208700)
(STARFRUIT, US << MARKET, 5045, 1, 208700)","{""AMETHYSTS"": 7, ""STARFRUIT"": 3}",1871,5048,10001
208900,-10092,-93372,"(STARFRUIT, US << MARKET, 5046, 1, 208900)
(STARFRUIT, US << MARKET, 5046, 1, 208900)
(STARFRUIT, US << MARKET, 5046, 1, 208900)
(STARFRUIT, MARKET << US, 5046, 1, 208900)","{""AMETHYSTS"": 7, ""STARFRUIT"": 5}",1839,5045,9998
209000,5050,-88322,"(STARFRUIT, MARKET << US, 5050, 1, 209000)","{""AMETHYSTS"": 7, ""STARFRUIT"": 4}",1885,5050,10001
209700,-130044,-218366,"(AMETHYSTS, US << MARKET, 9996, 1, 209700)
(AMETHYSTS, US << MARKET, 9996, 1, 209700)
(AMETHYSTS, US << MARKET, 9996, 1, 209700)
(AMETHYSTS, US << MARKET, 9996, 1, 209700)
(AMETHYSTS, US << MARKET, 9996, 1, 209700)
(AMETHYSTS, US << MARKET, 9996, 1, 209700)
(AMETHYSTS, US << MARKET, 9996, 1, 209700)
(AMETHYSTS, US << MARKET, 9996, 1, 209700)
(AMETHYSTS, US << MARKET, 9996, 1, 209700)
(AMETHYSTS, US << MARKET, 9996, 1, 209700)
(AMETHYSTS, US << MARKET, 9996, 1, 209700)
(AMETHYSTS, US << MARKET, 9996, 1, 209700)
(STARFRUIT, US << MARKET, 5046, 1, 209700)
(STARFRUIT, US << MARKET, 5046, 1, 209700)","{""AMETHYSTS"": 19, ""STARFRUIT"": 6}",1904,5045,10000
209900,9998,-208368,"(AMETHYSTS, MARKET << US, 9998, 1, 209900)","{""AMETHYSTS"": 18, ""STARFRUIT"": 6}",1842,5047,9996
210000,15138,-193230,"(STARFRUIT, MARKET << US, 5046, 1, 210000)
(STARFRUIT, MARKET << US, 5046, 1, 210000)
(STARFRUIT, MARKET << US, 5046, 1, 210000)","{""AMETHYSTS"": 18, ""STARFRUIT"": 3}",1887,5045,9999
210100,-10090,-203320,"(STARFRUIT, US << MARKET, 5045, 1, 210100)
(STARFRUIT, US << MARKET, 5045, 1, 210100)","{""AMETHYSTS"": 18, ""STARFRUIT"": 5}",1915,5047,10000
210300,94,-203226,"(AMETHYSTS, US << MARKET, 10002, 1, 210300)
(STARFRUIT, MARKET << US, 5051, 1, 210300)
(STARFRUIT, MARKET << US, 5045, 1, 210300)","{""AMETHYSTS"": 19, ""STARFRUIT"": 3}",1899,5048,9999
210400,-10090,-213316,"(STARFRUIT, US << MARKET, 5045, 1, 210400)
(STARFRUIT, US << MARKET, 5045, 1, 210400)","{""AMETHYSTS"": 19, ""STARFRUIT"": 5}",1919,5047,10000
210600,15040,-198276,"(AMETHYSTS, MARKET << US, 9995, 1, 210600)
(STARFRUIT, MARKET << US, 5045, 1, 210600)","{""AMETHYSTS"": 18, ""STARFRUIT"": 4}",1916,5048,10000
210700,15041,-183235,"(AMETHYSTS, MARKET << US, 9996, 1, 210700)
(STARFRUIT, MARKET << US, 5045, 1, 210700)","{""AMETHYSTS"": 17, ""STARFRUIT"": 3}",1892,5048,9999
211100,-4949,-188184,"(AMETHYSTS, US << MARKET, 10002, 1, 211100)
(STARFRUIT, MARKET << US, 5053, 1, 211100)","{""AMETHYSTS"": 18, ""STARFRUIT"": 2}",1878,5049,9998
211300,40316,-147868,"(AMETHYSTS, MARKET << US, 9998, 1, 211300)
(STARFRUIT, MARKET << US, 5053, 1, 211300)
(STARFRUIT, MARKET << US, 5053, 1, 211300)
(STARFRUIT, MARKET << US, 5053, 1, 211300)
(STARFRUIT, MARKET << US, 5053, 1, 211300)
(STARFRUIT, MARKET << US, 5053, 1, 211300)
(STARFRUIT, MARKET << US, 5053, 1, 211300)","{""AMETHYSTS"": 17, ""STARFRUIT"": -4}",1868,5049,9996
211400,-29988,-177856,"(AMETHYSTS, US << MARKET, 9996, 1, 211400)
(AMETHYSTS, US << MARKET, 9996, 1, 211400)
(AMETHYSTS, US << MARKET, 9996, 1, 211400)","{""AMETHYSTS"": 20, ""STARFRUIT"": -4}",1944,5050,10000
211500,10094,-167762,"(STARFRUIT, MARKET << US, 5047, 1, 211500)
(STARFRUIT, MARKET << US, 5047, 1, 211500)","{""AMETHYSTS"": 20, ""STARFRUIT"": -6}",1938,5050,10000
211800,5046,-162716,"(STARFRUIT, MARKET << US, 5046, 1, 211800)","{""AMETHYSTS"": 20, ""STARFRUIT"": -7}",1969,5045,10000
212000,5045,-157671,"(STARFRUIT, MARKET << US, 5045, 1, 212000)","{""AMETHYSTS"": 20, ""STARFRUIT"": -8}",1965,5048,10001
212300,20212,-137459,"(STARFRUIT, MARKET << US, 5053, 1, 212300)
(STARFRUIT, MARKET << US, 5053, 1, 212300)
(STARFRUIT, MARKET << US, 5053, 1, 212300)
(STARFRUIT, MARKET << US, 5053, 1, 212300)","{""AMETHYSTS"": 20, ""STARFRUIT"": -12}",1857,5052,9997
212500,15153,-122306,"(STARFRUIT, US << MARKET, 5051, 1, 212500)
(STARFRUIT, MARKET << US, 5051, 1, 212500)
(STARFRUIT, MARKET << US, 5051, 1, 212500)
(STARFRUIT, MARKET << US, 5051, 1, 212500)
(STARFRUIT, MARKET << US, 5051, 1, 212500)","{""AMETHYSTS"": 20, ""STARFRUIT"": -15}",1959,5049,10000
212800,-10092,-132398,"(STARFRUIT, US << MARKET, 5046, 1, 212800)
(STARFRUIT, US << MARKET, 5046, 1, 212800)","{""AMETHYSTS"": 20, ""STARFRUIT"": -13}",1965,5049,10000
213000,0,-132398,,"{""AMETHYSTS"": 20, ""STARFRUIT"": -13}",1885,5049,9996
213900,29994,-102404,"(AMETHYSTS, MARKET << US, 9998, 1, 213900)
(AMETHYSTS, MARKET << US, 9998, 1, 213900)
(AMETHYSTS, MARKET << US, 9998, 1, 213900)","{""AMETHYSTS"": 17, ""STARFRUIT"": -13}",1908,5049,9997
214100,-9998,-112402,"(AMETHYSTS, US << MARKET, 9998, 1, 214100)
(AMETHYSTS, US << MARKET, 9998, 1, 214100)
(AMETHYSTS, MARKET << US, 9998, 1, 214100)","{""AMETHYSTS"": 18, ""STARFRUIT"": -13}",1902,5048,9996
214500,-19996,-132398,"(AMETHYSTS, US << MARKET, 9998, 1, 214500)
(AMETHYSTS, US << MARKET, 9998, 1, 214500)","{""AMETHYSTS"": 20, ""STARFRUIT"": -13}",1998,5048,10001
214700,19992,-112406,"(AMETHYSTS, MARKET << US, 9996, 1, 214700)
(AMETHYSTS, MARKET << US, 9996, 1, 214700)","{""AMETHYSTS"": 18, ""STARFRUIT"": -13}",1970,5048,10000
214800,-30276,-142682,"(STARFRUIT, US << MARKET, 5046, 1, 214800)
(STARFRUIT, US << MARKET, 5046, 1, 214800)
(STARFRUIT, US << MARKET, 5046, 1, 214800)
(STARFRUIT, US << MARKET, 5046, 1, 214800)
(STARFRUIT, US << MARKET, 5046, 1, 214800)
(STARFRUIT, US << MARKET, 5046, 1, 214800)","{""AMETHYSTS"": 18, ""STARFRUIT"": -7}",2021,5045,10001
215100,-19996,-162678,"(AMETHYSTS, US << MARKET, 9998, 1, 215100)
(AMETHYSTS, US << MARKET, 9998, 1, 215100)","{""AMETHYSTS"": 20, ""STARFRUIT"": -7}",1919,5049,9997
215800,5046,-157632,"(STARFRUIT, MARKET << US, 5046, 1, 215800)","{""AMETHYSTS"": 20, ""STARFRUIT"": -8}",1976,5049,10000
215900,-40368,-198000,"(STARFRUIT, US << MARKET, 5046, 1, 215900)
(STARFRUIT, US << MARKET, 5046, 1, 215900)
(STARFRUIT, US << MARKET, 5046, 1, 215900)
(STARFRUIT, US << MARKET, 5046, 1, 215900)
(STARFRUIT, US << MARKET, 5046, 1, 215900)
(STARFRUIT, US << MARKET, 5046, 1, 215900)
(STARFRUIT, US << MARKET, 5046, 1, 215900)
(STARFRUIT, US << MARKET, 5046, 1, 215900)","{""AMETHYSTS"": 20, ""STARFRUIT"": 0}",2060,5049,10003
216000,-25260,-223260,"(STARFRUIT, US << MARKET, 5051, 1, 216000)
(STARFRUIT, US << MARKET, 5051, 1, 216000)
(STARFRUIT, US << MARKET, 5051, 1, 216000)
(STARFRUIT, US << MARKET, 5051, 1, 216000)
(STARFRUIT, US << MARKET, 5051, 1, 216000)
(STARFRUIT, US << MARKET, 5051, 1, 216000)
(STARFRUIT, MARKET << US, 5046, 1, 216000)","{""AMETHYSTS"": 20, ""STARFRUIT"": 5}",2000,5052,10000
216100,0,-223260,,"{""AMETHYSTS"": 20, ""STARFRUIT"": 5}",1980,5052,9999
216400,-15144,-238404,"(STARFRUIT, US << MARKET, 5048, 1, 216400)
(STARFRUIT, US << MARKET, 5048, 1, 216400)
(STARFRUIT, US << MARKET, 5048, 1, 216400)","{""AMETHYSTS"": 20, ""STARFRUIT"": 8}",1932,5047,9998
216500,5047,-233357,"(STARFRUIT, MARKET << US, 5047, 1, 216500)","{""AMETHYSTS"": 20, ""STARFRUIT"": 7}",1939,5048,9998
216600,5051,-228306,"(STARFRUIT, US << MARKET, 5051, 1, 216600)
(STARFRUIT, US << MARKET, 5051, 1, 216600)
(STARFRUIT, US << MARKET, 5051, 1, 216600)
(STARFRUIT, US << MARKET, 5051, 1, 216600)
(STARFRUIT, MARKET << US, 5051, 1, 216600)
(STARFRUIT, MARKET << US, 5051, 1, 216600)
(STARFRUIT, MARKET << US, 5051, 1, 216600)
(STARFRUIT, MARKET << US, 5051, 1, 216600)
(STARFRUIT, MARKET << US, 5051, 1, 216600)","{""AMETHYSTS"": 20, ""STARFRUIT"": 6}",1902,5048,9996
217100,0,-228306,,"{""AMETHYSTS"": 20, ""STARFRUIT"": 6}",1988,5049,10000
217400,-20184,-248490,"(STARFRUIT, US << MARKET, 5046, 1, 217400)
(STARFRUIT, US << MARKET, 5046, 1, 217400)
(STARFRUIT, US << MARKET, 5046, 1, 217400)
(STARFRUIT, US << MARKET, 5046, 1, 217400)","{""AMETHYSTS"": 20, ""STARFRUIT"": 10}",2060,5049,10003
217500,-5045,-253535,"(STARFRUIT, US << MARKET, 5045, 1, 217500)","{""AMETHYSTS"": 20, ""STARFRUIT"": 11}",1993,5048,10000
217700,5051,-248484,"(STARFRUIT, MARKET << US, 5051, 1, 217700)","{""AMETHYSTS"": 20, ""STARFRUIT"": 10}",2006,5051,9999
217800,9996,-238488,"(AMETHYSTS, MARKET << US, 9996, 1, 217800)","{""AMETHYSTS"": 19, ""STARFRUIT"": 10}",2002,5049,10000
218200,-5045,-243533,"(STARFRUIT, US << MARKET, 5045, 1, 218200)","{""AMETHYSTS"": 19, ""STARFRUIT"": 11}",1995,5048,10000
218700,-5050,-248583,"(STARFRUIT, US << MARKET, 5050, 1, 218700)","{""AMETHYSTS"": 19, ""STARFRUIT"": 12}",2000,5047,10001
219400,20009,-228574,"(AMETHYSTS, MARKET << US, 10004, 1, 219400)
(AMETHYSTS, MARKET << US, 10004, 1, 219400)
(STARFRUIT, US << MARKET, 5048, 1, 219400)
(STARFRUIT, MARKET << US, 5049, 1, 219400)","{""AMETHYSTS"": 17, ""STARFRUIT"": 12}",1983,5045,10001
219600,-5049,-233623,"(STARFRUIT, US << MARKET, 5049, 1, 219600)","{""AMETHYSTS"": 17, ""STARFRUIT"": 13}",1979,5045,10001
220500,15135,-218488,"(STARFRUIT, MARKET << US, 5045, 1, 220500)
(STARFRUIT, MARKET << US, 5045, 1, 220500)
(STARFRUIT, MARKET << US, 5045, 1, 220500)","{""AMETHYSTS"": 17, ""STARFRUIT"": 10}",1999,5047,10001
221000,30300,-188188,"(STARFRUIT, MARKET << US, 5050, 1, 221000)
(STARFRUIT, MARKET << US, 5050, 1, 221000)
(STARFRUIT, MARKET << US, 5050, 1, 221000)
(STARFRUIT, MARKET << US, 5050, 1, 221000)
(STARFRUIT, MARKET << US, 5050, 1, 221000)
(STARFRUIT, MARKET << US, 5050, 1, 221000)","{""AMETHYSTS"": 17, ""STARFRUIT"": 4}",2000,5047,10000
221100,-20100,-208288,"(AMETHYSTS, US << MARKET, 10002, 1, 221100)
(STARFRUIT, US << MARKET, 5049, 1, 221100)
(STARFRUIT, US << MARKET, 5049, 1, 221100)","{""AMETHYSTS"": 18, ""STARFRUIT"": 6}",1964,5045,9999
221200,25046,-183242,"(AMETHYSTS, MARKET << US, 10002, 1, 221200)
(AMETHYSTS, MARKET << US, 10002, 1, 221200)
(STARFRUIT, MARKET << US, 5042, 1, 221200)","{""AMETHYSTS"": 16, ""STARFRUIT"": 5}",2036,5046,10003
221800,-20184,-203426,"(STARFRUIT, US << MARKET, 5046, 1, 221800)
(STARFRUIT, US << MARKET, 5046, 1, 221800)
(STARFRUIT, US << MARKET, 5046, 1, 221800)
(STARFRUIT, US << MARKET, 5046, 1, 221800)","{""AMETHYSTS"": 16, ""STARFRUIT"": 9}",1995,5045,10001
222200,19996,-183430,"(AMETHYSTS, MARKET << US, 9998, 1, 222200)
(AMETHYSTS, MARKET << US, 9998, 1, 222200)","{""AMETHYSTS"": 14, ""STARFRUIT"": 9}",1937,5047,9996
222800,5047,-178383,"(STARFRUIT, MARKET << US, 5047, 1, 222800)","{""AMETHYSTS"": 14, ""STARFRUIT"": 8}",1969,5044,10000
223000,25205,-153178,"(STARFRUIT, MARKET << US, 5041, 1, 223000)
(STARFRUIT, MARKET << US, 5041, 1, 223000)
(STARFRUIT, MARKET << US, 5041, 1, 223000)
(STARFRUIT, MARKET << US, 5041, 1, 223000)
(STARFRUIT, MARKET << US, 5041, 1, 223000)","{""AMETHYSTS"": 14, ""STARFRUIT"": 3}",1931,5041,9999
223100,19996,-133182,"(AMETHYSTS, MARKET << US, 9998, 1, 223100)
(AMETHYSTS, MARKET << US, 9998, 1, 223100)","{""AMETHYSTS"": 12, ""STARFRUIT"": 3}",1965,5045,10001
223600,-10002,-143184,"(AMETHYSTS, US << MARKET, 10002, 1, 223600)","{""AMETHYSTS"": 13, ""STARFRUIT"": 3}",1935,5044,9999
223700,25058,-118126,"(AMETHYSTS, MARKET << US, 10005, 1, 223700)
(AMETHYSTS, MARKET << US, 10005, 1, 223700)
(STARFRUIT, MARKET << US, 5048, 1, 223700)","{""AMETHYSTS"": 11, ""STARFRUIT"": 2}",1995,5044,10003
223800,-20086,-138212,"(AMETHYSTS, US << MARKET, 10002, 1, 223800)
(STARFRUIT, US << MARKET, 5042, 1, 223800)
(STARFRUIT, US << MARKET, 5042, 1, 223800)","{""AMETHYSTS"": 12, ""STARFRUIT"": 4}",2004,5045,10003
224400,20172,-118040,"(STARFRUIT, MARKET << US, 5043, 1, 224400)
(STARFRUIT, MARKET << US, 5043, 1, 224400)
(STARFRUIT, MARKET << US, 5043, 1, 224400)
(STARFRUIT, MARKET << US, 5043, 1, 224400)","{""AMETHYSTS"": 12, ""STARFRUIT"": 0}",1960,5045,10000
224500,-10284,-128324,"(AMETHYSTS, MARKET << US, 10002, 1, 224500)
(AMETHYSTS, MARKET << US, 10002, 1, 224500)
(STARFRUIT, US << MARKET, 5048, 1, 224500)
(STARFRUIT, US << MARKET, 5048, 1, 224500)
(STARFRUIT, US << MARKET, 5048, 1, 224500)
(STARFRUIT, US << MARKET, 5048, 1, 224500)
(STARFRUIT, US << MARKET, 5048, 1, 224500)
(STARFRUIT, US << MARKET, 5048, 1, 224500)","{""AMETHYSTS"": 10, ""STARFRUIT"": 6}",2000,5049,10003
224600,-96,-128420,"(AMETHYSTS, US << MARKET, 10004, 1, 224600)
(AMETHYSTS, MARKET << US, 10005, 1, 224600)
(AMETHYSTS, MARKET << US, 10005, 1, 224600)
(STARFRUIT, US << MARKET, 5051, 1, 224600)
(STARFRUIT, US << MARKET, 5051, 1, 224600)","{""AMETHYSTS"": 9, ""STARFRUIT"": 8}",1965,5047,10001
225000,9996,-118424,"(AMETHYSTS, MARKET << US, 9996, 1, 225000)","{""AMETHYSTS"": 8, ""STARFRUIT"": 8}",1928,5047,9997
225500,-5044,-123468,"(STARFRUIT, US << MARKET, 5044, 1, 225500)","{""AMETHYSTS"": 8, ""STARFRUIT"": 9}",1912,5044,9998
225700,-4958,-128426,"(AMETHYSTS, US << MARKET, 10002, 1, 225700)
(STARFRUIT, MARKET << US, 5044, 1, 225700)","{""AMETHYSTS"": 9, ""STARFRUIT"": 8}",1977,5047,10003
226100,49990,-78436,"(AMETHYSTS, MARKET << US, 9998, 1, 226100)
(AMETHYSTS, MARKET << US, 9998, 1, 226100)
(AMETHYSTS, MARKET << US, 9998, 1, 226100)
(AMETHYSTS, MARKET << US, 9998, 1, 226100)
(AMETHYSTS, MARKET << US, 9998, 1, 226100)","{""AMETHYSTS"": 4, ""STARFRUIT"": 8}",1936,5048,9997
226700,-29900,-108336,"(AMETHYSTS, US << MARKET, 9998, 1, 226700)
(AMETHYSTS, US << MARKET, 9998, 1, 226700)
(AMETHYSTS, US << MARKET, 9998, 1, 226700)
(AMETHYSTS, US << MARKET, 9998, 1, 226700)
(STARFRUIT, MARKET << US, 5046, 1, 226700)
(STARFRUIT, MARKET << US, 5046, 1, 226700)","{""AMETHYSTS"": 8, ""STARFRUIT"": 6}",1960,5048,10001
226800,25235,-83101,"(STARFRUIT, MARKET << US, 5047, 1, 226800)
(STARFRUIT, MARKET << US, 5047, 1, 226800)
(STARFRUIT, MARKET << US, 5047, 1, 226800)
(STARFRUIT, MARKET << US, 5047, 1, 226800)
(STARFRUIT, MARKET << US, 5047, 1, 226800)","{""AMETHYSTS"": 8, ""STARFRUIT"": 1}",1945,5046,10000
227100,-10092,-93193,"(STARFRUIT, US << MARKET, 5046, 1, 227100)
(STARFRUIT, US << MARKET, 5046, 1, 227100)","{""AMETHYSTS"": 8, ""STARFRUIT"": 3}",1951,5048,10000
227300,-19996,-113189,"(AMETHYSTS, US << MARKET, 9998, 1, 227300)
(AMETHYSTS, US << MARKET, 9998, 1, 227300)","{""AMETHYSTS"": 10, ""STARFRUIT"": 3}",1915,5048,9996
227700,15043,-98146,"(AMETHYSTS, MARKET << US, 9996, 1, 227700)
(STARFRUIT, MARKET << US, 5047, 1, 227700)","{""AMETHYSTS"": 9, ""STARFRUIT"": 2}",1954,5050,10000
228300,-20192,-118338,"(STARFRUIT, US << MARKET, 5048, 1, 228300)
(STARFRUIT, US << MARKET, 5048, 1, 228300)
(STARFRUIT, US << MARKET, 5048, 1, 228300)
(STARFRUIT, US << MARKET, 5048, 1, 228300)
(STARFRUIT, US << MARKET, 5048, 1, 228300)
(STARFRUIT, MARKET << US, 5048, 1, 228300)","{""AMETHYSTS"": 9, ""STARFRUIT"": 6}",1968,5051,10000
228400,-10096,-128434,"(STARFRUIT, US << MARKET, 5048, 1, 228400)
(STARFRUIT, US << MARKET, 5048, 1, 228400)","{""AMETHYSTS"": 9, ""STARFRUIT"": 8}",1974,5051,10000
229400,-19996,-148430,"(AMETHYSTS, US << MARKET, 9998, 1, 229400)
(AMETHYSTS, US << MARKET, 9998, 1, 229400)","{""AMETHYSTS"": 11, ""STARFRUIT"": 8}",1929,5049,9997
229600,-10002,-158432,"(AMETHYSTS, US << MARKET, 10002, 1, 229600)","{""AMETHYSTS"": 12, ""STARFRUIT"": 8}",1980,5050,10001
229700,-5051,-163483,"(STARFRUIT, US << MARKET, 5051, 1, 229700)","{""AMETHYSTS"": 12, ""STARFRUIT"": 9}",1976,5051,10000
229900,-10092,-173575,"(STARFRUIT, US << MARKET, 5046, 1, 229900)
(STARFRUIT, US << MARKET, 5046, 1, 229900)","{""AMETHYSTS"": 12, ""STARFRUIT"": 11}",1928,5049,9997
230100,-10094,-183669,"(STARFRUIT, US << MARKET, 5047, 1, 230100)
(STARFRUIT, US << MARKET, 5047, 1, 230100)","{""AMETHYSTS"": 12, ""STARFRUIT"": 13}",1893,5046,9997
230300,69972,-113697,"(AMETHYSTS, US << MARKET, 9996, 1, 230300)
(AMETHYSTS, US << MARKET, 9996, 1, 230300)
(AMETHYSTS, MARKET << US, 9996, 1, 230300)
(AMETHYSTS, MARKET << US, 9996, 1, 230300)
(AMETHYSTS, MARKET << US, 9996, 1, 230300)
(AMETHYSTS, MARKET << US, 9996, 1, 230300)
(AMETHYSTS, MARKET << US, 9996, 1, 230300)
(AMETHYSTS, MARKET << US, 9996, 1, 230300)
(AMETHYSTS, MARKET << US, 9996, 1, 230300)
(AMETHYSTS, MARKET << US, 9996, 1, 230300)
(AMETHYSTS, MARKET << US, 9996, 1, 230300)","{""AMETHYSTS"": 5, ""STARFRUIT"": 13}",1940,5049,10000
230400,-15054,-128751,"(AMETHYSTS, US << MARKET, 10002, 1, 230400)
(STARFRUIT, US << MARKET, 5052, 1, 230400)","{""AMETHYSTS"": 6, ""STARFRUIT"": 14}",1915,5048,9999
230500,5046,-123705,"(STARFRUIT, MARKET << US, 5046, 1, 230500)","{""AMETHYSTS"": 6, ""STARFRUIT"": 13}",1932,5049,10000
230900,25059,-98646,"(AMETHYSTS, MARKET << US, 10004, 1, 230900)
(AMETHYSTS, MARKET << US, 10004, 1, 230900)
(STARFRUIT, MARKET << US, 5051, 1, 230900)","{""AMETHYSTS"": 4, ""STARFRUIT"": 12}",1934,5048,10001
231100,25240,-73406,"(STARFRUIT, MARKET << US, 5048, 1, 231100)
(STARFRUIT, MARKET << US, 5048, 1, 231100)
(STARFRUIT, MARKET << US, 5048, 1, 231100)
(STARFRUIT, MARKET << US, 5048, 1, 231100)
(STARFRUIT, MARKET << US, 5048, 1, 231100)","{""AMETHYSTS"": 4, ""STARFRUIT"": 7}",1908,5046,9998
231300,-19996,-93402,"(AMETHYSTS, US << MARKET, 9998, 1, 231300)
(AMETHYSTS, US << MARKET, 9998, 1, 231300)","{""AMETHYSTS"": 6, ""STARFRUIT"": 7}",1940,5048,10001
231400,-10098,-103500,"(STARFRUIT, US << MARKET, 5049, 1, 231400)
(STARFRUIT, US << MARKET, 5049, 1, 231400)","{""AMETHYSTS"": 6, ""STARFRUIT"": 9}",1950,5050,10000
231700,24850,-78650,"(AMETHYSTS, MARKET << US, 10000, 1, 231700)
(AMETHYSTS, MARKET << US, 10000, 1, 231700)
(AMETHYSTS, MARKET << US, 10000, 1, 231700)
(AMETHYSTS, MARKET << US, 10000, 1, 231700)
(STARFRUIT, US << MARKET, 5049, 1, 231700)
(STARFRUIT, US << MARKET, 5049, 1, 231700)
(STARFRUIT, US << MARKET, 5049, 1, 231700)
(STARFRUIT, US << MARKET, 5049, 1, 231700)
(STARFRUIT, MARKET << US, 5046, 1, 231700)","{""AMETHYSTS"": 2, ""STARFRUIT"": 12}",1910,5047,9998
232000,-20204,-98854,"(STARFRUIT, US << MARKET, 5051, 1, 232000)
(STARFRUIT, US << MARKET, 5051, 1, 232000)
(STARFRUIT, US << MARKET, 5051, 1, 232000)
(STARFRUIT, US << MARKET, 5051, 1, 232000)","{""AMETHYSTS"": 2, ""STARFRUIT"": 16}",1980,5052,10001
232100,20004,-78850,"(AMETHYSTS, MARKET << US, 10002, 1, 232100)
(AMETHYSTS, MARKET << US, 10002, 1, 232100)","{""AMETHYSTS"": 0, ""STARFRUIT"": 16}",1950,5050,10003
232300,-4949,-83799,"(AMETHYSTS, US << MARKET, 10002, 1, 232300)
(STARFRUIT, MARKET << US, 5053, 1, 232300)","{""AMETHYSTS"": 1, ""STARFRUIT"": 15}",1949,5050,9998
232600,5053,-78746,"(AMETHYSTS, US << MARKET, 9998, 1, 232600)
(AMETHYSTS, US << MARKET, 9998, 1, 232600)
(AMETHYSTS, MARKET << US, 9998, 1, 232600)
(AMETHYSTS, MARKET << US, 9998, 1, 232600)
(STARFRUIT, MARKET << US, 5053, 1, 232600)","{""AMETHYSTS"": 1, ""STARFRUIT"": 14}",1937,5049,9997
234200,-5044,-83790,"(STARFRUIT, US << MARKET, 5044, 1, 234200)","{""AMETHYSTS"": 1, ""STARFRUIT"": 15}",1915,5047,10000
234300,-14945,-98735,"(AMETHYSTS, US << MARKET, 9995, 1, 234300)
(AMETHYSTS, US << MARKET, 9995, 1, 234300)
(STARFRUIT, MARKET << US, 5045, 1, 234300)","{""AMETHYSTS"": 3, ""STARFRUIT"": 14}",1937,5048,10000
234500,9998,-88737,"(AMETHYSTS, MARKET << US, 9998, 1, 234500)","{""AMETHYSTS"": 2, ""STARFRUIT"": 14}",1943,5049,9997
234700,-90,-88827,"(AMETHYSTS, US << MARKET, 10004, 1, 234700)
(AMETHYSTS, MARKET << US, 10004, 1, 234700)
(AMETHYSTS, MARKET << US, 10004, 1, 234700)
(STARFRUIT, US << MARKET, 5049, 1, 234700)
(STARFRUIT, US << MARKET, 5049, 1, 234700)
(STARFRUIT, US << MARKET, 5049, 1, 234700)
(STARFRUIT, US << MARKET, 5049, 1, 234700)
(STARFRUIT, MARKET << US, 5051, 1, 234700)
(STARFRUIT, MARKET << US, 5051, 1, 234700)","{""AMETHYSTS"": 1, ""STARFRUIT"": 16}",1973,5050,10000
234800,9998,-78829,"(AMETHYSTS, MARKET << US, 9998, 1, 234800)","{""AMETHYSTS"": 0, ""STARFRUIT"": 16}",1923,5047,10001
235200,79960,1131,"(AMETHYSTS, MARKET << US, 9995, 1, 235200)
(AMETHYSTS, MARKET << US, 9995, 1, 235200)
(AMETHYSTS, MARKET << US, 9995, 1, 235200)
(AMETHYSTS, MARKET << US, 9995, 1, 235200)
(AMETHYSTS, MARKET << US, 9995, 1, 235200)
(AMETHYSTS, MARKET << US, 9995, 1, 235200)
(AMETHYSTS, MARKET << US, 9995, 1, 235200)
(AMETHYSTS, MARKET << US, 9995, 1, 235200)","{""AMETHYSTS"": -8, ""STARFRUIT"": 16}",1899,5048,10000
235500,-5045,-3914,"(STARFRUIT, US << MARKET, 5045, 1, 235500)","{""AMETHYSTS"": -8, ""STARFRUIT"": 17}",1910,5048,9999
235900,-15138,-19052,"(STARFRUIT, US << MARKET, 5046, 1, 235900)
(STARFRUIT, US << MARKET, 5046, 1, 235900)
(STARFRUIT, US << MARKET, 5046, 1, 235900)","{""AMETHYSTS"": -8, ""STARFRUIT"": 20}",1848,5045,10000
236200,9998,-9054,"(AMETHYSTS, MARKET << US, 9998, 1, 236200)","{""AMETHYSTS"": -9, ""STARFRUIT"": 20}",1933,5048,9997
236400,-19996,-29050,"(AMETHYSTS, US << MARKET, 9998, 1, 236400)
(AMETHYSTS, US << MARKET, 9998, 1, 236400)","{""AMETHYSTS"": -7, ""STARFRUIT"": 20}",1911,5047,9997
236800,-19996,-49046,"(AMETHYSTS, US << MARKET, 9998, 1, 236800)
(AMETHYSTS, US << MARKET, 9998, 1, 236800)","{""AMETHYSTS"": -5, ""STARFRUIT"": 20}",1929,5048,9997
237000,45046,-4000,"(AMETHYSTS, MARKET << US, 9998, 1, 237000)
(AMETHYSTS, MARKET << US, 9998, 1, 237000)
(AMETHYSTS, MARKET << US, 9998, 1, 237000)
(AMETHYSTS, MARKET << US, 9998, 1, 237000)
(STARFRUIT, MARKET << US, 5054, 1, 237000)","{""AMETHYSTS"": -9, ""STARFRUIT"": 19}",1977,5050,9997
237300,9997,5997,"(AMETHYSTS, MARKET << US, 9996, 1, 237300)
(STARFRUIT, US << MARKET, 5046, 1, 237300)
(STARFRUIT, MARKET << US, 5047, 1, 237300)","{""AMETHYSTS"": -10, ""STARFRUIT"": 19}",1871,5046,10000
237400,15044,21041,"(AMETHYSTS, MARKET << US, 9998, 1, 237400)
(STARFRUIT, MARKET << US, 5046, 1, 237400)","{""AMETHYSTS"": -11, ""STARFRUIT"": 18}",1949,5048,9996
237700,9998,31039,"(AMETHYSTS, MARKET << US, 9998, 1, 237700)","{""AMETHYSTS"": -12, ""STARFRUIT"": 18}",1927,5050,10001
238000,-5046,25993,"(STARFRUIT, US << MARKET, 5046, 1, 238000)","{""AMETHYSTS"": -12, ""STARFRUIT"": 19}",1924,5049,10000
238300,-99980,-73987,"(AMETHYSTS, US << MARKET, 9998, 1, 238300)
(AMETHYSTS, US << MARKET, 9998, 1, 238300)
(AMETHYSTS, US << MARKET, 9998, 1, 238300)
(AMETHYSTS, US << MARKET, 9998, 1, 238300)
(AMETHYSTS, US << MARKET, 9998, 1, 238300)
(AMETHYSTS, US << MARKET, 9998, 1, 238300)
(AMETHYSTS, US << MARKET, 9998, 1, 238300)
(AMETHYSTS, US << MARKET, 9998, 1, 238300)
(AMETHYSTS, US << MARKET, 9998, 1, 238300)
(AMETHYSTS, US << MARKET, 9998, 1, 238300)","{""AMETHYSTS"": -2, ""STARFRUIT"": 19}",1923,5048,10001
238600,40360,-33627,"(STARFRUIT, MARKET << US, 5045, 1, 238600)
(STARFRUIT, MARKET << US, 5045, 1, 238600)
(STARFRUIT, MARKET << US, 5045, 1, 238600)
(STARFRUIT, MARKET << US, 5045, 1, 238600)
(STARFRUIT, MARKET << US, 5045, 1, 238600)
(STARFRUIT, MARKET << US, 5045, 1, 238600)
(STARFRUIT, MARKET << US, 5045, 1, 238600)
(STARFRUIT, MARKET << US, 5045, 1, 238600)","{""AMETHYSTS"": -2, ""STARFRUIT"": 11}",1901,5048,10000
238700,40008,6381,"(AMETHYSTS, MARKET << US, 10004, 1, 238700)
(AMETHYSTS, MARKET << US, 10004, 1, 238700)
(AMETHYSTS, MARKET << US, 10004, 1, 238700)
(AMETHYSTS, MARKET << US, 10002, 1, 238700)
(STARFRUIT, US << MARKET, 5052, 1, 238700)
(STARFRUIT, MARKET << US, 5046, 1, 238700)","{""AMETHYSTS"": -6, ""STARFRUIT"": 11}",1891,5048,10003
238800,35364,41745,"(STARFRUIT, MARKET << US, 5052, 1, 238800)
(STARFRUIT, MARKET << US, 5052, 1, 238800)
(STARFRUIT, MARKET << US, 5052, 1, 238800)
(STARFRUIT, MARKET << US, 5052, 1, 238800)
(STARFRUIT, MARKET << US, 5052, 1, 238800)
(STARFRUIT, MARKET << US, 5052, 1, 238800)
(STARFRUIT, MARKET << US, 5052, 1, 238800)","{""AMETHYSTS"": -6, ""STARFRUIT"": 4}",1933,5050,10002
239300,-59924,-18179,"(AMETHYSTS, US << MARKET, 10004, 1, 239300)
(AMETHYSTS, US << MARKET, 10004, 1, 239300)
(AMETHYSTS, US << MARKET, 10004, 1, 239300)
(AMETHYSTS, US << MARKET, 10004, 1, 239300)
(AMETHYSTS, US << MARKET, 10004, 1, 239300)
(AMETHYSTS, US << MARKET, 10004, 1, 239300)
(AMETHYSTS, US << MARKET, 10004, 1, 239300)
(AMETHYSTS, US << MARKET, 10004, 1, 239300)
(AMETHYSTS, US << MARKET, 10004, 1, 239300)
(AMETHYSTS, MARKET << US, 10005, 1, 239300)
(AMETHYSTS, MARKET << US, 10005, 1, 239300)
(STARFRUIT, MARKET << US, 5051, 1, 239300)
(STARFRUIT, MARKET << US, 5051, 1, 239300)","{""AMETHYSTS"": 1, ""STARFRUIT"": 2}",1917,5048,10000
240100,9790,-8389,"(AMETHYSTS, MARKET << US, 9998, 1, 240100)
(AMETHYSTS, MARKET << US, 9998, 1, 240100)
(AMETHYSTS, MARKET << US, 9998, 1, 240100)
(STARFRUIT, US << MARKET, 5051, 1, 240100)
(STARFRUIT, US << MARKET, 5051, 1, 240100)
(STARFRUIT, US << MARKET, 5051, 1, 240100)
(STARFRUIT, US << MARKET, 5051, 1, 240100)","{""AMETHYSTS"": -2, ""STARFRUIT"": 6}",1905,5049,10000
240200,-70010,-78399,"(AMETHYSTS, US << MARKET, 10000, 1, 240200)
(AMETHYSTS, US << MARKET, 10000, 1, 240200)
(AMETHYSTS, US << MARKET, 10002, 1, 240200)
(AMETHYSTS, US << MARKET, 10002, 1, 240200)
(AMETHYSTS, US << MARKET, 10002, 1, 240200)
(AMETHYSTS, US << MARKET, 10002, 1, 240200)
(AMETHYSTS, US << MARKET, 10002, 1, 240200)","{""AMETHYSTS"": 5, ""STARFRUIT"": 6}",1879,5048,9998
240700,5052,-73347,"(STARFRUIT, MARKET << US, 5052, 1, 240700)","{""AMETHYSTS"": 5, ""STARFRUIT"": 5}",1928,5053,10002
241000,75255,1908,"(AMETHYSTS, MARKET << US, 9998, 1, 241000)
(AMETHYSTS, MARKET << US, 9998, 1, 241000)
(AMETHYSTS, MARKET << US, 9998, 1, 241000)
(AMETHYSTS, MARKET << US, 9998, 1, 241000)
(AMETHYSTS, MARKET << US, 9998, 1, 241000)
(STARFRUIT, MARKET << US, 5053, 1, 241000)
(STARFRUIT, MARKET << US, 5053, 1, 241000)
(STARFRUIT, MARKET << US, 5053, 1, 241000)
(STARFRUIT, MARKET << US, 5053, 1, 241000)
(STARFRUIT, MARKET << US, 5053, 1, 241000)","{""AMETHYSTS"": 0, ""STARFRUIT"": 0}",1908,5049,9997
241200,-80032,-78124,"(AMETHYSTS, US << MARKET, 10004, 1, 241200)
(AMETHYSTS, US << MARKET, 10004, 1, 241200)
(AMETHYSTS, US << MARKET, 10004, 1, 241200)
(AMETHYSTS, US << MARKET, 10004, 1, 241200)
(AMETHYSTS, US << MARKET, 10004, 1, 241200)
(AMETHYSTS, US << MARKET, 10004, 1, 241200)
(AMETHYSTS, US << MARKET, 10004, 1, 241200)
(AMETHYSTS, US << MARKET, 10004, 1, 241200)","{""AMETHYSTS"": 8, ""STARFRUIT"": 0}",1876,5049,10000
241300,-30282,-108406,"(STARFRUIT, US << MARKET, 5047, 1, 241300)
(STARFRUIT, US << MARKET, 5047, 1, 241300)
(STARFRUIT, US << MARKET, 5047, 1, 241300)
(STARFRUIT, US << MARKET, 5047, 1, 241300)
(STARFRUIT, US << MARKET, 5047, 1, 241300)
(STARFRUIT, US << MARKET, 5047, 1, 241300)","{""AMETHYSTS"": 8, ""STARFRUIT"": 6}",1878,5046,10001
241400,9998,-98408,"(AMETHYSTS, MARKET << US, 9998, 1, 241400)","{""AMETHYSTS"": 7, ""STARFRUIT"": 6}",1899,5050,10001
241600,-20192,-118600,"(STARFRUIT, US << MARKET, 5048, 1, 241600)
(STARFRUIT, US << MARKET, 5048, 1, 241600)
(STARFRUIT, US << MARKET, 5048, 1, 241600)
(STARFRUIT, US << MARKET, 5048, 1, 241600)","{""AMETHYSTS"": 7, ""STARFRUIT"": 10}",1870,5047,10000
242000,9998,-108602,"(AMETHYSTS, MARKET << US, 9998, 1, 242000)","{""AMETHYSTS"": 6, ""STARFRUIT"": 10}",1854,5048,9996
242400,-10004,-118606,"(AMETHYSTS, US << MARKET, 10004, 1, 242400)","{""AMETHYSTS"": 7, ""STARFRUIT"": 10}",1894,5050,10000
242800,30318,-88288,"(STARFRUIT, MARKET << US, 5053, 1, 242800)
(STARFRUIT, MARKET << US, 5053, 1, 242800)
(STARFRUIT, MARKET << US, 5053, 1, 242800)
(STARFRUIT, MARKET << US, 5053, 1, 242800)
(STARFRUIT, MARKET << US, 5053, 1, 242800)
(STARFRUIT, MARKET << US, 5053, 1, 242800)","{""AMETHYSTS"": 7, ""STARFRUIT"": 4}",1908,5049,10000
243100,-20204,-108492,"(STARFRUIT, US << MARKET, 5051, 1, 243100)
(STARFRUIT, US << MARKET, 5051, 1, 243100)
(STARFRUIT, US << MARKET, 5051, 1, 243100)
(STARFRUIT, US << MARKET, 5051, 1, 243100)","{""AMETHYSTS"": 7, ""STARFRUIT"": 8}",1924,5052,10000
243500,-10002,-118494,"(AMETHYSTS, US << MARKET, 10002, 1, 243500)","{""AMETHYSTS"": 8, ""STARFRUIT"": 8}",1922,5049,10003
243600,9998,-108496,"(AMETHYSTS, MARKET << US, 9998, 1, 243600)","{""AMETHYSTS"": 7, ""STARFRUIT"": 8}",1903,5049,10001
243900,9998,-98498,"(AMETHYSTS, MARKET << US, 9998, 1, 243900)","{""AMETHYSTS"": 6, ""STARFRUIT"": 8}",1870,5049,9996
244100,-14945,-113443,"(AMETHYSTS, US << MARKET, 9996, 1, 244100)
(AMETHYSTS, US << MARKET, 9996, 1, 244100)
(STARFRUIT, MARKET << US, 5047, 1, 244100)","{""AMETHYSTS"": 8, ""STARFRUIT"": 7}",1907,5050,10000
244300,-5047,-118490,"(STARFRUIT, US << MARKET, 5047, 1, 244300)","{""AMETHYSTS"": 8, ""STARFRUIT"": 8}",1878,5049,9997
244500,-20184,-138674,"(STARFRUIT, US << MARKET, 5046, 1, 244500)
(STARFRUIT, US << MARKET, 5046, 1, 244500)
(STARFRUIT, US << MARKET, 5046, 1, 244500)
(STARFRUIT, US << MARKET, 5046, 1, 244500)","{""AMETHYSTS"": 8, ""STARFRUIT"": 12}",1914,5049,10000
244900,25228,-113446,"(STARFRUIT, US << MARKET, 5047, 1, 244900)
(STARFRUIT, US << MARKET, 5047, 1, 244900)
(STARFRUIT, MARKET << US, 5046, 1, 244900)
(STARFRUIT, MARKET << US, 5046, 1, 244900)
(STARFRUIT, MARKET << US, 5046, 1, 244900)
(STARFRUIT, MARKET << US, 5046, 1, 244900)
(STARFRUIT, MARKET << US, 5046, 1, 244900)
(STARFRUIT, MARKET << US, 5046, 1, 244900)
(STARFRUIT, MARKET << US, 5046, 1, 244900)","{""AMETHYSTS"": 8, ""STARFRUIT"": 7}",1884,5046,10001
245300,20004,-93442,"(AMETHYSTS, MARKET << US, 10002, 1, 245300)
(AMETHYSTS, MARKET << US, 10002, 1, 245300)","{""AMETHYSTS"": 6, ""STARFRUIT"": 7}",1912,5048,10003
245700,-20212,-113654,"(STARFRUIT, US << MARKET, 5053, 1, 245700)
(STARFRUIT, US << MARKET, 5053, 1, 245700)
(STARFRUIT, US << MARKET, 5053, 1, 245700)
(STARFRUIT, US << MARKET, 5053, 1, 245700)","{""AMETHYSTS"": 6, ""STARFRUIT"": 11}",1873,5049,9998
246000,5052,-108602,"(STARFRUIT, MARKET << US, 5052, 1, 246000)","{""AMETHYSTS"": 6, ""STARFRUIT"": 10}",1918,5052,10000
246100,30276,-78326,"(STARFRUIT, MARKET << US, 5046, 1, 246100)
(STARFRUIT, MARKET << US, 5046, 1, 246100)
(STARFRUIT, MARKET << US, 5046, 1, 246100)
(STARFRUIT, MARKET << US, 5046, 1, 246100)
(STARFRUIT, MARKET << US, 5046, 1, 246100)
(STARFRUIT, MARKET << US, 5046, 1, 246100)","{""AMETHYSTS"": 6, ""STARFRUIT"": 4}",1870,5049,10000
246800,-10092,-88418,"(STARFRUIT, US << MARKET, 5046, 1, 246800)
(STARFRUIT, US << MARKET, 5046, 1, 246800)","{""AMETHYSTS"": 6, ""STARFRUIT"": 6}",1852,5045,10000
247000,-44965,-133383,"(AMETHYSTS, US << MARKET, 10002, 1, 247000)
(AMETHYSTS, US << MARKET, 10002, 1, 247000)
(AMETHYSTS, US << MARKET, 10002, 1, 247000)
(AMETHYSTS, US << MARKET, 10002, 1, 247000)
(AMETHYSTS, US << MARKET, 10002, 1, 247000)
(STARFRUIT, MARKET << US, 5045, 1, 247000)","{""AMETHYSTS"": 11, ""STARFRUIT"": 5}",1890,5048,10003
247200,-10098,-143481,"(STARFRUIT, US << MARKET, 5049, 1, 247200)
(STARFRUIT, US << MARKET, 5049, 1, 247200)","{""AMETHYSTS"": 11, ""STARFRUIT"": 7}",1858,5050,9999
247500,-89955,-233436,"(AMETHYSTS, US << MARKET, 9995, 1, 247500)
(AMETHYSTS, US << MARKET, 9995, 1, 247500)
(AMETHYSTS, US << MARKET, 9995, 1, 247500)
(AMETHYSTS, US << MARKET, 9995, 1, 247500)
(AMETHYSTS, US << MARKET, 9995, 1, 247500)
(AMETHYSTS, US << MARKET, 9995, 1, 247500)
(AMETHYSTS, US << MARKET, 9995, 1, 247500)
(AMETHYSTS, US << MARKET, 9995, 1, 247500)
(AMETHYSTS, US << MARKET, 9995, 1, 247500)","{""AMETHYSTS"": 20, ""STARFRUIT"": 7}",1813,5047,9996
247600,69965,-163471,"(AMETHYSTS, MARKET << US, 9995, 1, 247600)
(AMETHYSTS, MARKET << US, 9995, 1, 247600)
(AMETHYSTS, MARKET << US, 9995, 1, 247600)
(AMETHYSTS, MARKET << US, 9995, 1, 247600)
(AMETHYSTS, MARKET << US, 9995, 1, 247600)
(AMETHYSTS, MARKET << US, 9995, 1, 247600)
(AMETHYSTS, MARKET << US, 9995, 1, 247600)","{""AMETHYSTS"": 13, ""STARFRUIT"": 7}",1865,5048,10000
248100,-45030,-208501,"(AMETHYSTS, US << MARKET, 9998, 1, 248100)
(AMETHYSTS, US << MARKET, 9998, 1, 248100)
(AMETHYSTS, US << MARKET, 9998, 1, 248100)
(AMETHYSTS, US << MARKET, 9998, 1, 248100)
(STARFRUIT, US << MARKET, 5044, 1, 248100)
(STARFRUIT, US << MARKET, 5044, 1, 248100)
(STARFRUIT, MARKET << US, 5050, 1, 248100)","{""AMETHYSTS"": 17, ""STARFRUIT"": 8}",1892,5047,10001
248200,-5045,-213546,"(STARFRUIT, US << MARKET, 5045, 1, 248200)","{""AMETHYSTS"": 17, ""STARFRUIT"": 9}",1886,5048,10000
248300,30294,-183252,"(STARFRUIT, MARKET << US, 5049, 1, 248300)
(STARFRUIT, MARKET << US, 5049, 1, 248300)
(STARFRUIT, MARKET << US, 5049, 1, 248300)
(STARFRUIT, MARKET << US, 5049, 1, 248300)
(STARFRUIT, MARKET << US, 5049, 1, 248300)
(STARFRUIT, MARKET << US, 5049, 1, 248300)","{""AMETHYSTS"": 17, ""STARFRUIT"": 3}",1915,5050,10001
248400,-35166,-218418,"(AMETHYSTS, US << MARKET, 10005, 1, 248400)
(AMETHYSTS, US << MARKET, 10005, 1, 248400)
(STARFRUIT, US << MARKET, 5052, 1, 248400)
(STARFRUIT, US << MARKET, 5052, 1, 248400)
(STARFRUIT, US << MARKET, 5052, 1, 248400)","{""AMETHYSTS"": 19, ""STARFRUIT"": 6}",1870,5048,10000
248600,-20200,-238618,"(STARFRUIT, US << MARKET, 5050, 1, 248600)
(STARFRUIT, US << MARKET, 5050, 1, 248600)
(STARFRUIT, US << MARKET, 5050, 1, 248600)
(STARFRUIT, US << MARKET, 5050, 1, 248600)","{""AMETHYSTS"": 19, ""STARFRUIT"": 10}",1892,5051,10000
248700,-10005,-248623,"(AMETHYSTS, US << MARKET, 10005, 1, 248700)","{""AMETHYSTS"": 20, ""STARFRUIT"": 10}",1867,5049,10000
248800,5046,-243577,"(STARFRUIT, MARKET << US, 5046, 1, 248800)","{""AMETHYSTS"": 20, ""STARFRUIT"": 9}",1835,5048,9999
248900,5046,-238531,"(STARFRUIT, MARKET << US, 5046, 1, 248900)","{""AMETHYSTS"": 20, ""STARFRUIT"": 8}",1873,5048,10001
249100,9998,-228533,"(AMETHYSTS, MARKET << US, 9998, 1, 249100)","{""AMETHYSTS"": 19, ""STARFRUIT"": 8}",1802,5049,9997
249200,-20200,-248733,"(STARFRUIT, US << MARKET, 5050, 1, 249200)
(STARFRUIT, US << MARKET, 5050, 1, 249200)
(STARFRUIT, US << MARKET, 5050, 1, 249200)
(STARFRUIT, US << MARKET, 5050, 1, 249200)","{""AMETHYSTS"": 19, ""STARFRUIT"": 12}",1867,5050,10000
249400,34945,-213788,"(AMETHYSTS, MARKET << US, 9998, 1, 249400)
(AMETHYSTS, MARKET << US, 9998, 1, 249400)
(AMETHYSTS, MARKET << US, 9998, 1, 249400)
(AMETHYSTS, MARKET << US, 9998, 1, 249400)
(STARFRUIT, US << MARKET, 5047, 1, 249400)","{""AMETHYSTS"": 15, ""STARFRUIT"": 13}",1802,5050,9996
249500,-19996,-233784,"(AMETHYSTS, US << MARKET, 9998, 1, 249500)
(AMETHYSTS, US << MARKET, 9998, 1, 249500)","{""AMETHYSTS"": 17, ""STARFRUIT"": 13}",1883,5050,10001
249600,-20192,-253976,"(STARFRUIT, US << MARKET, 5048, 1, 249600)
(STARFRUIT, US << MARKET, 5048, 1, 249600)
(STARFRUIT, US << MARKET, 5048, 1, 249600)
(STARFRUIT, US << MARKET, 5048, 1, 249600)","{""AMETHYSTS"": 17, ""STARFRUIT"": 17}",1891,5051,10000
249700,-6,-253982,"(AMETHYSTS, US << MARKET, 10002, 1, 249700)
(AMETHYSTS, MARKET << US, 9996, 1, 249700)","{""AMETHYSTS"": 17, ""STARFRUIT"": 17}",1851,5050,9999
249800,30324,-223658,"(STARFRUIT, MARKET << US, 5054, 1, 249800)
(STARFRUIT, MARKET << US, 5054, 1, 249800)
(STARFRUIT, MARKET << US, 5054, 1, 249800)
(STARFRUIT, MARKET << US, 5054, 1, 249800)
(STARFRUIT, MARKET << US, 5054, 1, 249800)
(STARFRUIT, MARKET << US, 5054, 1, 249800)","{""AMETHYSTS"": 17, ""STARFRUIT"": 11}",1903,5051,10000
250000,100020,-123638,"(AMETHYSTS, MARKET << US, 10002, 1, 250000)
(AMETHYSTS, MARKET << US, 10002, 1, 250000)
(AMETHYSTS, MARKET << US, 10002, 1, 250000)
(AMETHYSTS, MARKET << US, 10002, 1, 250000)
(AMETHYSTS, MARKET << US, 10002, 1, 250000)
(AMETHYSTS, MARKET << US, 10002, 1, 250000)
(AMETHYSTS, MARKET << US, 10002, 1, 250000)
(AMETHYSTS, MARKET << US, 10002, 1, 250000)
(AMETHYSTS, MARKET << US, 10002, 1, 250000)
(AMETHYSTS, MARKET << US, 10002, 1, 250000)","{""AMETHYSTS"": 7, ""STARFRUIT"": 11}",1944,5051,10003
250100,35329,-88309,"(STARFRUIT, MARKET << US, 5047, 1, 250100)
(STARFRUIT, MARKET << US, 5047, 1, 250100)
(STARFRUIT, MARKET << US, 5047, 1, 250100)
(STARFRUIT, MARKET << US, 5047, 1, 250100)
(STARFRUIT, MARKET << US, 5047, 1, 250100)
(STARFRUIT, MARKET << US, 5047, 1, 250100)
(STARFRUIT, MARKET << US, 5047, 1, 250100)","{""AMETHYSTS"": 7, ""STARFRUIT"": 4}",1891,5050,10000
250200,89955,1646,"(AMETHYSTS, MARKET << US, 9995, 1, 250200)
(AMETHYSTS, MARKET << US, 9995, 1, 250200)
(AMETHYSTS, MARKET << US, 9995, 1, 250200)
(AMETHYSTS, MARKET << US, 9995, 1, 250200)
(AMETHYSTS, MARKET << US, 9995, 1, 250200)
(AMETHYSTS, MARKET << US, 9995, 1, 250200)
(AMETHYSTS, MARKET << US, 9995, 1, 250200)
(AMETHYSTS, MARKET << US, 9995, 1, 250200)
(AMETHYSTS, MARKET << US, 9995, 1, 250200)","{""AMETHYSTS"": -2, ""STARFRUIT"": 4}",1846,5050,10000
250400,-5164,-3518,"(AMETHYSTS, MARKET << US, 9998, 1, 250400)
(STARFRUIT, US << MARKET, 5054, 1, 250400)
(STARFRUIT, US << MARKET, 5054, 1, 250400)
(STARFRUIT, US << MARKET, 5054, 1, 250400)","{""AMETHYSTS"": -3, ""STARFRUIT"": 7}",1844,5050,9996
250700,20204,16686,"(STARFRUIT, MARKET << US, 5051, 1, 250700)
(STARFRUIT, MARKET << US, 5051, 1, 250700)
(STARFRUIT, MARKET << US, 5051, 1, 250700)
(STARFRUIT, MARKET << US, 5051, 1, 250700)","{""AMETHYSTS"": -3, ""STARFRUIT"": 3}",1842,5052,10000
251400,-25255,-8569,"(STARFRUIT, US << MARKET, 5051, 1, 251400)
(STARFRUIT, US << MARKET, 5051, 1, 251400)
(STARFRUIT, US << MARKET, 5051, 1, 251400)
(STARFRUIT, US << MARKET, 5051, 1, 251400)
(STARFRUIT, US << MARKET, 5051, 1, 251400)","{""AMETHYSTS"": -3, ""STARFRUIT"": 8}",1829,5049,9998
251700,-5054,-13623,"(STARFRUIT, US << MARKET, 5054, 1, 251700)","{""AMETHYSTS"": -3, ""STARFRUIT"": 9}",1872,5055,10000
252000,4949,-8674,"(AMETHYSTS, MARKET << US, 9998, 1, 252000)
(STARFRUIT, US << MARKET, 5049, 1, 252000)","{""AMETHYSTS"": -4, ""STARFRUIT"": 10}",1822,5048,9996
252100,-15150,-23824,"(STARFRUIT, US << MARKET, 5050, 1, 252100)
(STARFRUIT, US << MARKET, 5050, 1, 252100)
(STARFRUIT, US << MARKET, 5050, 1, 252100)","{""AMETHYSTS"": -4, ""STARFRUIT"": 13}",1813,5049,10000
252700,5054,-18770,"(STARFRUIT, MARKET << US, 5054, 1, 252700)","{""AMETHYSTS"": -4, ""STARFRUIT"": 12}",1846,5051,9999
252800,-15059,-33829,"(AMETHYSTS, US << MARKET, 10004, 1, 252800)
(STARFRUIT, US << MARKET, 5055, 1, 252800)","{""AMETHYSTS"": -3, ""STARFRUIT"": 13}",1847,5052,10000
253100,25062,-8767,"(AMETHYSTS, MARKET << US, 10004, 1, 253100)
(AMETHYSTS, MARKET << US, 10004, 1, 253100)
(STARFRUIT, MARKET << US, 5054, 1, 253100)","{""AMETHYSTS"": -5, ""STARFRUIT"": 12}",1833,5050,10000
253400,5047,-3720,"(STARFRUIT, MARKET << US, 5047, 1, 253400)","{""AMETHYSTS"": -5, ""STARFRUIT"": 11}",1830,5050,10000
253600,5053,1333,"(STARFRUIT, MARKET << US, 5053, 1, 253600)","{""AMETHYSTS"": -5, ""STARFRUIT"": 10}",1868,5053,9999
253800,20004,21337,"(AMETHYSTS, MARKET << US, 10002, 1, 253800)
(AMETHYSTS, MARKET << US, 10002, 1, 253800)","{""AMETHYSTS"": -7, ""STARFRUIT"": 10}",1851,5050,9998
254000,-5048,16289,"(STARFRUIT, US << MARKET, 5048, 1, 254000)","{""AMETHYSTS"": -7, ""STARFRUIT"": 11}",1850,5051,10000
254200,-80032,-63743,"(AMETHYSTS, US << MARKET, 10004, 1, 254200)
(AMETHYSTS, US << MARKET, 10004, 1, 254200)
(AMETHYSTS, US << MARKET, 10004, 1, 254200)
(AMETHYSTS, US << MARKET, 10004, 1, 254200)
(AMETHYSTS, US << MARKET, 10004, 1, 254200)
(AMETHYSTS, US << MARKET, 10004, 1, 254200)
(AMETHYSTS, US << MARKET, 10004, 1, 254200)
(AMETHYSTS, US << MARKET, 10004, 1, 254200)
(AMETHYSTS, US << MARKET, 10004, 1, 254200)
(AMETHYSTS, US << MARKET, 10004, 1, 254200)
(AMETHYSTS, MARKET << US, 10004, 1, 254200)
(AMETHYSTS, MARKET << US, 10004, 1, 254200)","{""AMETHYSTS"": 1, ""STARFRUIT"": 11}",1808,5050,10001
254800,-39984,-103727,"(AMETHYSTS, US << MARKET, 9996, 1, 254800)
(AMETHYSTS, US << MARKET, 9996, 1, 254800)
(AMETHYSTS, US << MARKET, 9996, 1, 254800)
(AMETHYSTS, US << MARKET, 9996, 1, 254800)","{""AMETHYSTS"": 5, ""STARFRUIT"": 11}",1808,5050,9997
254900,19996,-83731,"(AMETHYSTS, MARKET << US, 9998, 1, 254900)
(AMETHYSTS, MARKET << US, 9998, 1, 254900)","{""AMETHYSTS"": 3, ""STARFRUIT"": 11}",1832,5052,9997
255100,-19996,-103727,"(AMETHYSTS, US << MARKET, 9998, 1, 255100)
(AMETHYSTS, US << MARKET, 9998, 1, 255100)","{""AMETHYSTS"": 5, ""STARFRUIT"": 11}",1861,5053,10001
255500,20017,-83710,"(AMETHYSTS, MARKET << US, 10005, 1, 255500)
(AMETHYSTS, MARKET << US, 10005, 1, 255500)
(STARFRUIT, US << MARKET, 5047, 1, 255500)
(STARFRUIT, MARKET << US, 5054, 1, 255500)","{""AMETHYSTS"": 3, ""STARFRUIT"": 11}",1840,5050,10000
255800,-94918,-178628,"(AMETHYSTS, US << MARKET, 9998, 1, 255800)
(AMETHYSTS, US << MARKET, 9998, 1, 255800)
(AMETHYSTS, US << MARKET, 9998, 1, 255800)
(AMETHYSTS, US << MARKET, 9998, 1, 255800)
(AMETHYSTS, US << MARKET, 9998, 1, 255800)
(AMETHYSTS, US << MARKET, 9998, 1, 255800)
(AMETHYSTS, US << MARKET, 9998, 1, 255800)
(AMETHYSTS, US << MARKET, 9998, 1, 255800)
(AMETHYSTS, US << MARKET, 9998, 1, 255800)
(AMETHYSTS, US << MARKET, 9998, 1, 255800)
(STARFRUIT, US << MARKET, 5047, 1, 255800)
(STARFRUIT, US << MARKET, 5047, 1, 255800)
(STARFRUIT, US << MARKET, 5047, 1, 255800)
(STARFRUIT, US << MARKET, 5047, 1, 255800)
(STARFRUIT, MARKET << US, 5050, 1, 255800)
(STARFRUIT, MARKET << US, 5050, 1, 255800)
(STARFRUIT, MARKET << US, 5050, 1, 255800)
(STARFRUIT, MARKET << US, 5050, 1, 255800)
(STARFRUIT, MARKET << US, 5050, 1, 255800)","{""AMETHYSTS"": 13, ""STARFRUIT"": 10}",1793,5046,9997
255900,-19996,-198624,"(AMETHYSTS, US << MARKET, 9998, 1, 255900)
(AMETHYSTS, US << MARKET, 9998, 1, 255900)","{""AMETHYSTS"": 15, ""STARFRUIT"": 10}",1906,5050,10002
256000,5051,-193573,"(STARFRUIT, MARKET << US, 5051, 1, 256000)","{""AMETHYSTS"": 15, ""STARFRUIT"": 9}",1886,5051,10000
256100,45038,-148535,"(AMETHYSTS, MARKET << US, 9998, 1, 256100)
(AMETHYSTS, MARKET << US, 9998, 1, 256100)
(AMETHYSTS, MARKET << US, 9998, 1, 256100)
(AMETHYSTS, MARKET << US, 9998, 1, 256100)
(STARFRUIT, MARKET << US, 5046, 1, 256100)","{""AMETHYSTS"": 11, ""STARFRUIT"": 8}",1825,5045,10000
256200,-5050,-153585,"(STARFRUIT, US << MARKET, 5050, 1, 256200)","{""AMETHYSTS"": 11, ""STARFRUIT"": 9}",1838,5047,10000
256400,5045,-148540,"(STARFRUIT, MARKET << US, 5045, 1, 256400)","{""AMETHYSTS"": 11, ""STARFRUIT"": 8}",1863,5049,10001
256500,-5045,-153585,"(STARFRUIT, US << MARKET, 5045, 1, 256500)","{""AMETHYSTS"": 11, ""STARFRUIT"": 9}",1858,5048,10001
257200,-5045,-158630,"(STARFRUIT, US << MARKET, 5045, 1, 257200)","{""AMETHYSTS"": 11, ""STARFRUIT"": 10}",1810,5044,10000
257400,-79984,-238614,"(AMETHYSTS, US << MARKET, 9998, 1, 257400)
(AMETHYSTS, US << MARKET, 9998, 1, 257400)
(AMETHYSTS, US << MARKET, 9998, 1, 257400)
(AMETHYSTS, US << MARKET, 9998, 1, 257400)
(AMETHYSTS, US << MARKET, 9998, 1, 257400)
(AMETHYSTS, US << MARKET, 9998, 1, 257400)
(AMETHYSTS, US << MARKET, 9998, 1, 257400)
(AMETHYSTS, US << MARKET, 9998, 1, 257400)","{""AMETHYSTS"": 19, ""STARFRUIT"": 10}",1799,5047,9997
257500,-10002,-248616,"(AMETHYSTS, US << MARKET, 10002, 1, 257500)","{""AMETHYSTS"": 20, ""STARFRUIT"": 10}",1914,5047,10003
257800,0,-248616,,"{""AMETHYSTS"": 20, ""STARFRUIT"": 10}",1854,5047,10000
257900,-10102,-258718,"(STARFRUIT, US << MARKET, 5051, 1, 257900)
(STARFRUIT, US << MARKET, 5051, 1, 257900)","{""AMETHYSTS"": 20, ""STARFRUIT"": 12}",1802,5050,9996
258000,0,-258718,,"{""AMETHYSTS"": 20, ""STARFRUIT"": 12}",1878,5048,10001
258200,35322,-223396,"(STARFRUIT, MARKET << US, 5046, 1, 258200)
(STARFRUIT, MARKET << US, 5046, 1, 258200)
(STARFRUIT, MARKET << US, 5046, 1, 258200)
(STARFRUIT, MARKET << US, 5046, 1, 258200)
(STARFRUIT, MARKET << US, 5046, 1, 258200)
(STARFRUIT, MARKET << US, 5046, 1, 258200)
(STARFRUIT, MARKET << US, 5046, 1, 258200)","{""AMETHYSTS"": 20, ""STARFRUIT"": 5}",1849,5049,10000
258500,24846,-198550,"(AMETHYSTS, MARKET << US, 10002, 1, 258500)
(AMETHYSTS, MARKET << US, 10002, 1, 258500)
(AMETHYSTS, MARKET << US, 10002, 1, 258500)
(AMETHYSTS, MARKET << US, 10002, 1, 258500)
(STARFRUIT, US << MARKET, 5054, 1, 258500)
(STARFRUIT, US << MARKET, 5054, 1, 258500)
(STARFRUIT, US << MARKET, 5054, 1, 258500)","{""AMETHYSTS"": 16, ""STARFRUIT"": 8}",1842,5051,9999
258900,-10002,-208552,"(AMETHYSTS, US << MARKET, 10002, 1, 258900)","{""AMETHYSTS"": 17, ""STARFRUIT"": 8}",1875,5047,10003
259000,-30116,-238668,"(AMETHYSTS, US << MARKET, 10004, 1, 259000)
(AMETHYSTS, US << MARKET, 10004, 1, 259000)
(STARFRUIT, US << MARKET, 5054, 1, 259000)
(STARFRUIT, US << MARKET, 5054, 1, 259000)","{""AMETHYSTS"": 19, ""STARFRUIT"": 10}",1832,5050,10000
259400,-5047,-243715,"(STARFRUIT, US << MARKET, 5047, 1, 259400)","{""AMETHYSTS"": 19, ""STARFRUIT"": 11}",1854,5050,10001
259700,5047,-238668,"(STARFRUIT, MARKET << US, 5047, 1, 259700)","{""AMETHYSTS"": 19, ""STARFRUIT"": 10}",1851,5050,10001
260300,-10002,-248670,"(AMETHYSTS, US << MARKET, 10002, 1, 260300)","{""AMETHYSTS"": 20, ""STARFRUIT"": 10}",1810,5050,9999
260700,5047,-243623,"(STARFRUIT, MARKET << US, 5047, 1, 260700)","{""AMETHYSTS"": 20, ""STARFRUIT"": 9}",1820,5047,10001
260800,5052,-238571,"(STARFRUIT, MARKET << US, 5052, 1, 260800)","{""AMETHYSTS"": 20, ""STARFRUIT"": 8}",1845,5052,10000
261000,-20192,-258763,"(STARFRUIT, US << MARKET, 5048, 1, 261000)
(STARFRUIT, US << MARKET, 5048, 1, 261000)
(STARFRUIT, US << MARKET, 5048, 1, 261000)
(STARFRUIT, US << MARKET, 5048, 1, 261000)","{""AMETHYSTS"": 20, ""STARFRUIT"": 12}",1801,5047,10000
261100,35329,-223434,"(STARFRUIT, MARKET << US, 5047, 1, 261100)
(STARFRUIT, MARKET << US, 5047, 1, 261100)
(STARFRUIT, MARKET << US, 5047, 1, 261100)
(STARFRUIT, MARKET << US, 5047, 1, 261100)
(STARFRUIT, MARKET << US, 5047, 1, 261100)
(STARFRUIT, MARKET << US, 5047, 1, 261100)
(STARFRUIT, MARKET << US, 5047, 1, 261100)","{""AMETHYSTS"": 20, ""STARFRUIT"": 5}",1816,5050,10000
261200,5053,-218381,"(STARFRUIT, MARKET << US, 5053, 1, 261200)","{""AMETHYSTS"": 20, ""STARFRUIT"": 4}",1775,5049,9998
261400,-10096,-228477,"(STARFRUIT, US << MARKET, 5048, 1, 261400)
(STARFRUIT, US << MARKET, 5048, 1, 261400)","{""AMETHYSTS"": 20, ""STARFRUIT"": 6}",1817,5049,10000
261600,49990,-178487,"(AMETHYSTS, MARKET << US, 9998, 1, 261600)
(AMETHYSTS, MARKET << US, 9998, 1, 261600)
(AMETHYSTS, MARKET << US, 9998, 1, 261600)
(AMETHYSTS, MARKET << US, 9998, 1, 261600)
(AMETHYSTS, MARKET << US, 9998, 1, 261600)","{""AMETHYSTS"": 15, ""STARFRUIT"": 6}",1774,5051,9997
261800,15041,-163446,"(AMETHYSTS, MARKET << US, 9995, 1, 261800)
(STARFRUIT, MARKET << US, 5046, 1, 261800)","{""AMETHYSTS"": 14, ""STARFRUIT"": 5}",1766,5048,9998
262100,-20098,-183544,"(AMETHYSTS, US << MARKET, 10002, 1, 262100)
(STARFRUIT, US << MARKET, 5048, 1, 262100)
(STARFRUIT, US << MARKET, 5048, 1, 262100)","{""AMETHYSTS"": 15, ""STARFRUIT"": 7}",1830,5047,10003
262700,-5048,-188592,"(STARFRUIT, US << MARKET, 5048, 1, 262700)","{""AMETHYSTS"": 15, ""STARFRUIT"": 8}",1823,5050,10001
263200,-20008,-208600,"(AMETHYSTS, US << MARKET, 10004, 1, 263200)
(AMETHYSTS, US << MARKET, 10004, 1, 263200)","{""AMETHYSTS"": 17, ""STARFRUIT"": 8}",1858,5053,10002
263300,-19996,-228596,"(AMETHYSTS, US << MARKET, 9998, 1, 263300)
(AMETHYSTS, US << MARKET, 9998, 1, 263300)
(AMETHYSTS, US << MARKET, 9998, 1, 263300)
(AMETHYSTS, MARKET << US, 9998, 1, 263300)","{""AMETHYSTS"": 19, ""STARFRUIT"": 8}",1763,5052,9997
263900,70014,-158582,"(AMETHYSTS, US << MARKET, 10002, 1, 263900)
(AMETHYSTS, MARKET << US, 10002, 1, 263900)
(AMETHYSTS, MARKET << US, 10002, 1, 263900)
(AMETHYSTS, MARKET << US, 10002, 1, 263900)
(AMETHYSTS, MARKET << US, 10002, 1, 263900)
(AMETHYSTS, MARKET << US, 10002, 1, 263900)
(AMETHYSTS, MARKET << US, 10002, 1, 263900)
(AMETHYSTS, MARKET << US, 10002, 1, 263900)
(AMETHYSTS, MARKET << US, 10002, 1, 263900)","{""AMETHYSTS"": 12, ""STARFRUIT"": 8}",1862,5051,10003
264100,50130,-108452,"(AMETHYSTS, MARKET << US, 10005, 1, 264100)
(AMETHYSTS, MARKET << US, 10005, 1, 264100)
(AMETHYSTS, MARKET << US, 10005, 1, 264100)
(AMETHYSTS, MARKET << US, 10005, 1, 264100)
(STARFRUIT, MARKET << US, 5055, 1, 264100)
(STARFRUIT, MARKET << US, 5055, 1, 264100)","{""AMETHYSTS"": 8, ""STARFRUIT"": 6}",1854,5051,10000
264300,-20196,-128648,"(STARFRUIT, US << MARKET, 5049, 1, 264300)
(STARFRUIT, US << MARKET, 5049, 1, 264300)
(STARFRUIT, US << MARKET, 5049, 1, 264300)
(STARFRUIT, US << MARKET, 5049, 1, 264300)","{""AMETHYSTS"": 8, ""STARFRUIT"": 10}",1840,5048,10001
264500,20098,-108550,"(AMETHYSTS, MARKET << US, 9998, 1, 264500)
(STARFRUIT, MARKET << US, 5050, 1, 264500)
(STARFRUIT, MARKET << US, 5050, 1, 264500)","{""AMETHYSTS"": 7, ""STARFRUIT"": 8}",1849,5049,10001
264700,-75039,-183589,"(AMETHYSTS, US << MARKET, 9998, 1, 264700)
(AMETHYSTS, US << MARKET, 9998, 1, 264700)
(AMETHYSTS, US << MARKET, 9998, 1, 264700)
(AMETHYSTS, US << MARKET, 9998, 1, 264700)
(AMETHYSTS, US << MARKET, 9998, 1, 264700)
(AMETHYSTS, US << MARKET, 9998, 1, 264700)
(AMETHYSTS, US << MARKET, 9998, 1, 264700)
(AMETHYSTS, US << MARKET, 9998, 1, 264700)
(AMETHYSTS, MARKET << US, 9998, 1, 264700)
(STARFRUIT, US << MARKET, 5053, 1, 264700)
(STARFRUIT, US << MARKET, 5053, 1, 264700)
(STARFRUIT, US << MARKET, 5053, 1, 264700)
(STARFRUIT, US << MARKET, 5053, 1, 264700)
(STARFRUIT, MARKET << US, 5053, 1, 264700)
(STARFRUIT, MARKET << US, 5053, 1, 264700)
(STARFRUIT, MARKET << US, 5053, 1, 264700)","{""AMETHYSTS"": 14, ""STARFRUIT"": 9}",1828,5051,9997
264800,-20008,-203597,"(AMETHYSTS, US << MARKET, 10004, 1, 264800)
(AMETHYSTS, US << MARKET, 10004, 1, 264800)","{""AMETHYSTS"": 16, ""STARFRUIT"": 9}",1887,5052,10001
265200,5055,-198542,"(STARFRUIT, MARKET << US, 5055, 1, 265200)","{""AMETHYSTS"": 16, ""STARFRUIT"": 8}",1834,5051,9998
265600,9998,-188544,"(AMETHYSTS, MARKET << US, 9998, 1, 265600)","{""AMETHYSTS"": 15, ""STARFRUIT"": 8}",1835,5053,9997
265900,-49975,-238519,"(AMETHYSTS, US << MARKET, 9995, 1, 265900)
(AMETHYSTS, US << MARKET, 9995, 1, 265900)
(AMETHYSTS, US << MARKET, 9995, 1, 265900)
(AMETHYSTS, US << MARKET, 9995, 1, 265900)
(AMETHYSTS, US << MARKET, 9995, 1, 265900)","{""AMETHYSTS"": 20, ""STARFRUIT"": 8}",1881,5055,9998
266000,9998,-228521,"(AMETHYSTS, MARKET << US, 9998, 1, 266000)","{""AMETHYSTS"": 19, ""STARFRUIT"": 8}",1854,5054,9997
266100,5056,-223465,"(STARFRUIT, MARKET << US, 5056, 1, 266100)","{""AMETHYSTS"": 19, ""STARFRUIT"": 7}",1925,5053,10001
266700,-20117,-243582,"(AMETHYSTS, US << MARKET, 10005, 1, 266700)
(STARFRUIT, US << MARKET, 5056, 1, 266700)
(STARFRUIT, US << MARKET, 5056, 1, 266700)","{""AMETHYSTS"": 20, ""STARFRUIT"": 9}",1886,5052,10000
267100,40008,-203574,"(AMETHYSTS, MARKET << US, 10002, 1, 267100)
(AMETHYSTS, MARKET << US, 10002, 1, 267100)
(AMETHYSTS, MARKET << US, 10002, 1, 267100)
(AMETHYSTS, MARKET << US, 10002, 1, 267100)","{""AMETHYSTS"": 16, ""STARFRUIT"": 9}",1942,5052,10003
267900,-10004,-213578,"(AMETHYSTS, US << MARKET, 10004, 1, 267900)
(AMETHYSTS, US << MARKET, 10004, 1, 267900)
(AMETHYSTS, US << MARKET, 10004, 1, 267900)
(AMETHYSTS, MARKET << US, 10004, 1, 267900)
(AMETHYSTS, MARKET << US, 10004, 1, 267900)","{""AMETHYSTS"": 17, ""STARFRUIT"": 9}",1881,5051,10000
268200,-25073,-238651,"(AMETHYSTS, US << MARKET, 10005, 1, 268200)
(AMETHYSTS, US << MARKET, 10005, 1, 268200)
(STARFRUIT, US << MARKET, 5056, 1, 268200)
(STARFRUIT, US << MARKET, 5056, 1, 268200)
(STARFRUIT, MARKET << US, 5049, 1, 268200)","{""AMETHYSTS"": 19, ""STARFRUIT"": 10}",1879,5053,10000
268300,4947,-233704,"(AMETHYSTS, MARKET << US, 9995, 1, 268300)
(STARFRUIT, US << MARKET, 5048, 1, 268300)","{""AMETHYSTS"": 18, ""STARFRUIT"": 11}",1857,5051,10000
268400,-5054,-238758,"(STARFRUIT, US << MARKET, 5054, 1, 268400)","{""AMETHYSTS"": 18, ""STARFRUIT"": 12}",1908,5054,10001
268500,5048,-233710,"(STARFRUIT, MARKET << US, 5048, 1, 268500)","{""AMETHYSTS"": 18, ""STARFRUIT"": 11}",1822,5050,9999
269200,-5054,-238764,"(STARFRUIT, US << MARKET, 5054, 1, 269200)","{""AMETHYSTS"": 18, ""STARFRUIT"": 12}",1848,5051,10000
269400,-5049,-243813,"(STARFRUIT, US << MARKET, 5049, 1, 269400)","{""AMETHYSTS"": 18, ""STARFRUIT"": 13}",1863,5052,10000
269700,-5054,-248867,"(STARFRUIT, US << MARKET, 5054, 1, 269700)","{""AMETHYSTS"": 18, ""STARFRUIT"": 14}",1903,5055,10000
270100,0,-248867,"(AMETHYSTS, US << MARKET, 9996, 1, 270100)
(AMETHYSTS, US << MARKET, 9996, 1, 270100)
(AMETHYSTS, MARKET << US, 9996, 1, 270100)
(AMETHYSTS, MARKET << US, 9996, 1, 270100)","{""AMETHYSTS"": 18, ""STARFRUIT"": 14}",1835,5054,9997
270300,-20228,-269095,"(STARFRUIT, US << MARKET, 5057, 1, 270300)
(STARFRUIT, US << MARKET, 5057, 1, 270300)
(STARFRUIT, US << MARKET, 5057, 1, 270300)
(STARFRUIT, US << MARKET, 5057, 1, 270300)","{""AMETHYSTS"": 18, ""STARFRUIT"": 18}",1877,5054,10000
270500,-4948,-274043,"(AMETHYSTS, US << MARKET, 10002, 1, 270500)
(STARFRUIT, MARKET << US, 5054, 1, 270500)","{""AMETHYSTS"": 19, ""STARFRUIT"": 17}",1805,5051,9999
271200,5053,-268990,"(STARFRUIT, MARKET << US, 5053, 1, 271200)","{""AMETHYSTS"": 19, ""STARFRUIT"": 16}",1810,5050,10000
271400,-10002,-278992,"(AMETHYSTS, US << MARKET, 10002, 1, 271400)","{""AMETHYSTS"": 20, ""STARFRUIT"": 16}",1884,5051,10003
271500,0,-278992,,"{""AMETHYSTS"": 20, ""STARFRUIT"": 16}",1808,5050,10000
272500,10090,-268902,"(STARFRUIT, MARKET << US, 5045, 1, 272500)
(STARFRUIT, MARKET << US, 5045, 1, 272500)","{""AMETHYSTS"": 20, ""STARFRUIT"": 14}",1756,5047,10000
272900,5047,-263855,"(STARFRUIT, MARKET << US, 5047, 1, 272900)","{""AMETHYSTS"": 20, ""STARFRUIT"": 13}",1795,5050,10000
273100,0,-263855,,"{""AMETHYSTS"": 20, ""STARFRUIT"": 13}",1842,5049,10003
273400,35322,-228533,"(STARFRUIT, MARKET << US, 5046, 1, 273400)
(STARFRUIT, MARKET << US, 5046, 1, 273400)
(STARFRUIT, MARKET << US, 5046, 1, 273400)
(STARFRUIT, MARKET << US, 5046, 1, 273400)
(STARFRUIT, MARKET << US, 5046, 1, 273400)
(STARFRUIT, MARKET << US, 5046, 1, 273400)
(STARFRUIT, MARKET << US, 5046, 1, 273400)","{""AMETHYSTS"": 20, ""STARFRUIT"": 6}",1741,5049,9999
273500,99950,-128583,"(AMETHYSTS, MARKET << US, 9995, 1, 273500)
(AMETHYSTS, MARKET << US, 9995, 1, 273500)
(AMETHYSTS, MARKET << US, 9995, 1, 273500)
(AMETHYSTS, MARKET << US, 9995, 1, 273500)
(AMETHYSTS, MARKET << US, 9995, 1, 273500)
(AMETHYSTS, MARKET << US, 9995, 1, 273500)
(AMETHYSTS, MARKET << US, 9995, 1, 273500)
(AMETHYSTS, MARKET << US, 9995, 1, 273500)
(AMETHYSTS, MARKET << US, 9995, 1, 273500)
(AMETHYSTS, MARKET << US, 9995, 1, 273500)","{""AMETHYSTS"": 10, ""STARFRUIT"": 6}",1685,5048,9998
273700,20008,-108575,"(AMETHYSTS, MARKET << US, 10004, 1, 273700)
(AMETHYSTS, MARKET << US, 10004, 1, 273700)","{""AMETHYSTS"": 8, ""STARFRUIT"": 6}",1737,5048,10003
274000,9996,-98579,"(AMETHYSTS, MARKET << US, 9996, 1, 274000)","{""AMETHYSTS"": 7, ""STARFRUIT"": 6}",1703,5047,10000
274300,9906,-88673,"(AMETHYSTS, MARKET << US, 10004, 1, 274300)
(AMETHYSTS, MARKET << US, 10004, 1, 274300)
(STARFRUIT, US << MARKET, 5051, 1, 274300)
(STARFRUIT, US << MARKET, 5051, 1, 274300)","{""AMETHYSTS"": 5, ""STARFRUIT"": 8}",1711,5048,10000
274700,-20200,-108873,"(STARFRUIT, US << MARKET, 5050, 1, 274700)
(STARFRUIT, US << MARKET, 5050, 1, 274700)
(STARFRUIT, US << MARKET, 5050, 1, 274700)
(STARFRUIT, US << MARKET, 5050, 1, 274700)","{""AMETHYSTS"": 5, ""STARFRUIT"": 12}",1691,5047,10000
274900,30082,-78791,"(AMETHYSTS, MARKET << US, 9996, 1, 274900)
(AMETHYSTS, MARKET << US, 9996, 1, 274900)
(STARFRUIT, MARKET << US, 5045, 1, 274900)
(STARFRUIT, MARKET << US, 5045, 1, 274900)","{""AMETHYSTS"": 3, ""STARFRUIT"": 10}",1689,5048,10000
275500,-19992,-98783,"(AMETHYSTS, US << MARKET, 9996, 1, 275500)
(AMETHYSTS, US << MARKET, 9996, 1, 275500)","{""AMETHYSTS"": 5, ""STARFRUIT"": 10}",1687,5047,10000
275600,-19996,-118779,"(AMETHYSTS, US << MARKET, 9998, 1, 275600)
(AMETHYSTS, US << MARKET, 9998, 1, 275600)","{""AMETHYSTS"": 7, ""STARFRUIT"": 10}",1670,5047,9997
275700,-19996,-138775,"(AMETHYSTS, US << MARKET, 9998, 1, 275700)
(AMETHYSTS, US << MARKET, 9998, 1, 275700)","{""AMETHYSTS"": 9, ""STARFRUIT"": 10}",1669,5048,9996
276300,25060,-113715,"(AMETHYSTS, MARKET << US, 10004, 1, 276300)
(AMETHYSTS, MARKET << US, 10004, 1, 276300)
(STARFRUIT, MARKET << US, 5052, 1, 276300)","{""AMETHYSTS"": 7, ""STARFRUIT"": 9}",1744,5051,10000
276800,-20180,-133895,"(STARFRUIT, US << MARKET, 5045, 1, 276800)
(STARFRUIT, US << MARKET, 5045, 1, 276800)
(STARFRUIT, US << MARKET, 5045, 1, 276800)
(STARFRUIT, US << MARKET, 5045, 1, 276800)","{""AMETHYSTS"": 7, ""STARFRUIT"": 13}",1729,5048,10000
277300,-20180,-154075,"(STARFRUIT, US << MARKET, 5045, 1, 277300)
(STARFRUIT, US << MARKET, 5045, 1, 277300)
(STARFRUIT, US << MARKET, 5045, 1, 277300)
(STARFRUIT, US << MARKET, 5045, 1, 277300)","{""AMETHYSTS"": 7, ""STARFRUIT"": 17}",1762,5048,10003
277600,-5045,-159120,"(STARFRUIT, US << MARKET, 5045, 1, 277600)","{""AMETHYSTS"": 7, ""STARFRUIT"": 18}",1744,5048,10000
277800,-10002,-169122,"(AMETHYSTS, US << MARKET, 10002, 1, 277800)","{""AMETHYSTS"": 8, ""STARFRUIT"": 18}",1752,5049,9999
278000,-30088,-199210,"(AMETHYSTS, US << MARKET, 9996, 1, 278000)
(AMETHYSTS, US << MARKET, 9996, 1, 278000)
(STARFRUIT, US << MARKET, 5048, 1, 278000)
(STARFRUIT, US << MARKET, 5048, 1, 278000)","{""AMETHYSTS"": 10, ""STARFRUIT"": 20}",1810,5051,10000
278100,0,-199210,,"{""AMETHYSTS"": 10, ""STARFRUIT"": 20}",1810,5051,10000
278500,0,-199210,,"{""AMETHYSTS"": 10, ""STARFRUIT"": 20}",1770,5050,9998
278700,30211,-168999,"(AMETHYSTS, US << MARKET, 10002, 1, 278700)
(AMETHYSTS, MARKET << US, 10002, 1, 278700)
(AMETHYSTS, MARKET << US, 10002, 1, 278700)
(STARFRUIT, MARKET << US, 5053, 1, 278700)
(STARFRUIT, MARKET << US, 5052, 1, 278700)
(STARFRUIT, MARKET << US, 5052, 1, 278700)
(STARFRUIT, MARKET << US, 5052, 1, 278700)","{""AMETHYSTS"": 9, ""STARFRUIT"": 16}",1876,5053,10003
279000,5053,-163946,"(STARFRUIT, MARKET << US, 5053, 1, 279000)","{""AMETHYSTS"": 9, ""STARFRUIT"": 15}",1804,5050,10000
279300,-5049,-168995,"(STARFRUIT, US << MARKET, 5049, 1, 279300)","{""AMETHYSTS"": 9, ""STARFRUIT"": 16}",1837,5052,10000
279600,-15051,-184046,"(AMETHYSTS, US << MARKET, 10002, 1, 279600)
(STARFRUIT, US << MARKET, 5049, 1, 279600)","{""AMETHYSTS"": 10, ""STARFRUIT"": 17}",1851,5051,10003
280000,-39984,-224030,"(AMETHYSTS, US << MARKET, 9996, 1, 280000)
(AMETHYSTS, US << MARKET, 9996, 1, 280000)
(AMETHYSTS, US << MARKET, 9996, 1, 280000)
(AMETHYSTS, US << MARKET, 9996, 1, 280000)","{""AMETHYSTS"": 14, ""STARFRUIT"": 17}",1854,5052,10000
280500,15042,-208988,"(AMETHYSTS, MARKET << US, 9996, 1, 280500)
(STARFRUIT, US << MARKET, 5048, 1, 280500)
(STARFRUIT, MARKET << US, 5047, 1, 280500)
(STARFRUIT, MARKET << US, 5047, 1, 280500)","{""AMETHYSTS"": 13, ""STARFRUIT"": 16}",1812,5050,10000
280700,-5053,-214041,"(STARFRUIT, US << MARKET, 5053, 1, 280700)","{""AMETHYSTS"": 13, ""STARFRUIT"": 17}",1873,5053,10001
280800,10002,-204039,"(AMETHYSTS, US << MARKET, 10002, 1, 280800)
(AMETHYSTS, MARKET << US, 10002, 1, 280800)
(AMETHYSTS, MARKET << US, 10002, 1, 280800)","{""AMETHYSTS"": 12, ""STARFRUIT"": 17}",1864,5051,10003
280900,25265,-178774,"(STARFRUIT, MARKET << US, 5053, 1, 280900)
(STARFRUIT, MARKET << US, 5053, 1, 280900)
(STARFRUIT, MARKET << US, 5053, 1, 280900)
(STARFRUIT, MARKET << US, 5053, 1, 280900)
(STARFRUIT, MARKET << US, 5053, 1, 280900)","{""AMETHYSTS"": 12, ""STARFRUIT"": 12}",1874,5054,10000
281200,-39992,-218766,"(AMETHYSTS, US << MARKET, 9998, 1, 281200)
(AMETHYSTS, US << MARKET, 9998, 1, 281200)
(AMETHYSTS, US << MARKET, 9998, 1, 281200)
(AMETHYSTS, US << MARKET, 9998, 1, 281200)
(AMETHYSTS, US << MARKET, 9998, 1, 281200)
(AMETHYSTS, US << MARKET, 9998, 1, 281200)
(AMETHYSTS, US << MARKET, 9998, 1, 281200)
(AMETHYSTS, MARKET << US, 9998, 1, 281200)
(AMETHYSTS, MARKET << US, 9998, 1, 281200)
(AMETHYSTS, MARKET << US, 9998, 1, 281200)","{""AMETHYSTS"": 16, ""STARFRUIT"": 12}",1874,5052,10001
281300,-5053,-223819,"(STARFRUIT, US << MARKET, 5053, 1, 281300)","{""AMETHYSTS"": 16, ""STARFRUIT"": 13}",1870,5053,10000
281400,10098,-213721,"(STARFRUIT, MARKET << US, 5049, 1, 281400)
(STARFRUIT, MARKET << US, 5049, 1, 281400)","{""AMETHYSTS"": 16, ""STARFRUIT"": 11}",1791,5048,9999
281700,25063,-188658,"(AMETHYSTS, MARKET << US, 10004, 1, 281700)
(AMETHYSTS, MARKET << US, 10004, 1, 281700)
(STARFRUIT, MARKET << US, 5055, 1, 281700)","{""AMETHYSTS"": 14, ""STARFRUIT"": 10}",1862,5052,10000
282100,5050,-183608,"(STARFRUIT, MARKET << US, 5050, 1, 282100)","{""AMETHYSTS"": 14, ""STARFRUIT"": 9}",1833,5049,10000
282800,-19996,-203604,"(AMETHYSTS, US << MARKET, 9998, 1, 282800)
(AMETHYSTS, US << MARKET, 9998, 1, 282800)","{""AMETHYSTS"": 16, ""STARFRUIT"": 9}",1889,5053,10001
282900,5056,-198548,"(STARFRUIT, MARKET << US, 5056, 1, 282900)","{""AMETHYSTS"": 16, ""STARFRUIT"": 8}",1900,5056,10000
283400,-5051,-203599,"(STARFRUIT, US << MARKET, 5051, 1, 283400)","{""AMETHYSTS"": 16, ""STARFRUIT"": 9}",1871,5054,9999
283500,25260,-178339,"(STARFRUIT, MARKET << US, 5052, 1, 283500)
(STARFRUIT, MARKET << US, 5052, 1, 283500)
(STARFRUIT, MARKET << US, 5052, 1, 283500)
(STARFRUIT, MARKET << US, 5052, 1, 283500)
(STARFRUIT, MARKET << US, 5052, 1, 283500)","{""AMETHYSTS"": 16, ""STARFRUIT"": 4}",1881,5051,10001
283600,40028,-138311,"(AMETHYSTS, MARKET << US, 10004, 1, 283600)
(AMETHYSTS, MARKET << US, 10004, 1, 283600)
(AMETHYSTS, MARKET << US, 10004, 1, 283600)
(AMETHYSTS, MARKET << US, 10004, 1, 283600)
(STARFRUIT, US << MARKET, 5051, 1, 283600)
(STARFRUIT, US << MARKET, 5051, 1, 283600)
(STARFRUIT, MARKET << US, 5057, 1, 283600)
(STARFRUIT, MARKET << US, 5057, 1, 283600)","{""AMETHYSTS"": 12, ""STARFRUIT"": 4}",1905,5054,10000
283700,-10114,-148425,"(STARFRUIT, US << MARKET, 5057, 1, 283700)
(STARFRUIT, US << MARKET, 5057, 1, 283700)","{""AMETHYSTS"": 12, ""STARFRUIT"": 6}",1893,5053,10000
283900,-10102,-158527,"(STARFRUIT, US << MARKET, 5051, 1, 283900)
(STARFRUIT, US << MARKET, 5051, 1, 283900)","{""AMETHYSTS"": 12, ""STARFRUIT"": 8}",1917,5054,10001
284200,-20228,-178755,"(STARFRUIT, US << MARKET, 5057, 1, 284200)
(STARFRUIT, US << MARKET, 5057, 1, 284200)
(STARFRUIT, US << MARKET, 5057, 1, 284200)
(STARFRUIT, US << MARKET, 5057, 1, 284200)","{""AMETHYSTS"": 12, ""STARFRUIT"": 12}",1881,5053,10000
284700,-29884,-208639,"(AMETHYSTS, US << MARKET, 9996, 1, 284700)
(AMETHYSTS, US << MARKET, 9996, 1, 284700)
(AMETHYSTS, US << MARKET, 9996, 1, 284700)
(AMETHYSTS, US << MARKET, 9996, 1, 284700)
(STARFRUIT, MARKET << US, 5050, 1, 284700)
(STARFRUIT, MARKET << US, 5050, 1, 284700)","{""AMETHYSTS"": 16, ""STARFRUIT"": 10}",1891,5053,10000
284800,-5050,-213689,"(STARFRUIT, US << MARKET, 5050, 1, 284800)","{""AMETHYSTS"": 16, ""STARFRUIT"": 11}",1850,5049,10000
285000,-19992,-233681,"(AMETHYSTS, US << MARKET, 9996, 1, 285000)
(AMETHYSTS, US << MARKET, 9996, 1, 285000)","{""AMETHYSTS"": 18, ""STARFRUIT"": 11}",1884,5053,9999
285500,-5050,-238731,"(STARFRUIT, US << MARKET, 5050, 1, 285500)","{""AMETHYSTS"": 18, ""STARFRUIT"": 12}",1965,5055,10002
285700,5051,-233680,"(STARFRUIT, MARKET << US, 5051, 1, 285700)","{""AMETHYSTS"": 18, ""STARFRUIT"": 11}",1910,5052,10001
286400,-15061,-248741,"(AMETHYSTS, US << MARKET, 10004, 1, 286400)
(STARFRUIT, US << MARKET, 5057, 1, 286400)","{""AMETHYSTS"": 19, ""STARFRUIT"": 12}",1895,5053,10000
286500,-5056,-253797,"(STARFRUIT, US << MARKET, 5056, 1, 286500)","{""AMETHYSTS"": 19, ""STARFRUIT"": 13}",1879,5052,10000
286600,-4946,-258743,"(AMETHYSTS, US << MARKET, 10004, 1, 286600)
(STARFRUIT, MARKET << US, 5058, 1, 286600)","{""AMETHYSTS"": 20, ""STARFRUIT"": 12}",1917,5055,10000
286800,0,-258743,,"{""AMETHYSTS"": 20, ""STARFRUIT"": 12}",1833,5053,9997
287000,5056,-253687,"(STARFRUIT, MARKET << US, 5056, 1, 287000)","{""AMETHYSTS"": 20, ""STARFRUIT"": 11}",1949,5056,10001
287200,0,-253687,,"{""AMETHYSTS"": 20, ""STARFRUIT"": 11}",1945,5052,10003
287900,-20188,-273875,"(STARFRUIT, US << MARKET, 5047, 1, 287900)
(STARFRUIT, US << MARKET, 5047, 1, 287900)
(STARFRUIT, US << MARKET, 5047, 1, 287900)
(STARFRUIT, US << MARKET, 5047, 1, 287900)","{""AMETHYSTS"": 20, ""STARFRUIT"": 15}",1875,5050,10000
288900,25275,-248600,"(STARFRUIT, MARKET << US, 5055, 1, 288900)
(STARFRUIT, MARKET << US, 5055, 1, 288900)
(STARFRUIT, MARKET << US, 5055, 1, 288900)
(STARFRUIT, MARKET << US, 5055, 1, 288900)
(STARFRUIT, MARKET << US, 5055, 1, 288900)","{""AMETHYSTS"": 20, ""STARFRUIT"": 10}",1910,5051,10000
289300,30324,-218276,"(STARFRUIT, MARKET << US, 5054, 1, 289300)
(STARFRUIT, MARKET << US, 5054, 1, 289300)
(STARFRUIT, MARKET << US, 5054, 1, 289300)
(STARFRUIT, MARKET << US, 5054, 1, 289300)
(STARFRUIT, MARKET << US, 5054, 1, 289300)
(STARFRUIT, MARKET << US, 5054, 1, 289300)","{""AMETHYSTS"": 20, ""STARFRUIT"": 4}",1940,5054,10000
289600,20200,-198076,"(STARFRUIT, MARKET << US, 5050, 1, 289600)
(STARFRUIT, MARKET << US, 5050, 1, 289600)
(STARFRUIT, MARKET << US, 5050, 1, 289600)
(STARFRUIT, MARKET << US, 5050, 1, 289600)","{""AMETHYSTS"": 20, ""STARFRUIT"": 0}",1924,5053,10000
289900,39810,-158266,"(AMETHYSTS, MARKET << US, 10005, 1, 289900)
(AMETHYSTS, MARKET << US, 10005, 1, 289900)
(AMETHYSTS, MARKET << US, 10005, 1, 289900)
(AMETHYSTS, MARKET << US, 10005, 1, 289900)
(AMETHYSTS, MARKET << US, 9995, 1, 289900)
(AMETHYSTS, MARKET << US, 9995, 1, 289900)
(STARFRUIT, US << MARKET, 5050, 1, 289900)
(STARFRUIT, US << MARKET, 5050, 1, 289900)
(STARFRUIT, US << MARKET, 5050, 1, 289900)
(STARFRUIT, US << MARKET, 5050, 1, 289900)","{""AMETHYSTS"": 14, ""STARFRUIT"": 4}",1942,5052,10000
290200,-10112,-168378,"(STARFRUIT, US << MARKET, 5056, 1, 290200)
(STARFRUIT, US << MARKET, 5056, 1, 290200)","{""AMETHYSTS"": 14, ""STARFRUIT"": 6}",1934,5052,10000
290400,125109,-43269,"(AMETHYSTS, US << MARKET, 10004, 1, 290400)
(AMETHYSTS, US << MARKET, 10004, 1, 290400)
(AMETHYSTS, MARKET << US, 10005, 1, 290400)
(AMETHYSTS, MARKET << US, 10005, 1, 290400)
(AMETHYSTS, MARKET << US, 10004, 1, 290400)
(AMETHYSTS, MARKET << US, 10004, 1, 290400)
(AMETHYSTS, MARKET << US, 10004, 1, 290400)
(AMETHYSTS, MARKET << US, 10004, 1, 290400)
(AMETHYSTS, MARKET << US, 10004, 1, 290400)
(AMETHYSTS, MARKET << US, 10005, 1, 290400)
(AMETHYSTS, MARKET << US, 10004, 1, 290400)
(AMETHYSTS, MARKET << US, 10004, 1, 290400)
(AMETHYSTS, MARKET << US, 10004, 1, 290400)
(AMETHYSTS, MARKET << US, 10004, 1, 290400)
(AMETHYSTS, MARKET << US, 10004, 1, 290400)
(AMETHYSTS, MARKET << US, 10004, 1, 290400)
(STARFRUIT, MARKET << US, 5058, 1, 290400)","{""AMETHYSTS"": 2, ""STARFRUIT"": 5}",2001,5054,10000
290800,30202,-13067,"(AMETHYSTS, MARKET << US, 9998, 1, 290800)
(STARFRUIT, MARKET << US, 5051, 1, 290800)
(STARFRUIT, MARKET << US, 5051, 1, 290800)
(STARFRUIT, MARKET << US, 5051, 1, 290800)
(STARFRUIT, MARKET << US, 5051, 1, 290800)","{""AMETHYSTS"": 1, ""STARFRUIT"": 1}",1980,5050,9997
290900,-14942,-28009,"(AMETHYSTS, US << MARKET, 9996, 1, 290900)
(AMETHYSTS, US << MARKET, 9996, 1, 290900)
(STARFRUIT, MARKET << US, 5050, 1, 290900)","{""AMETHYSTS"": 3, ""STARFRUIT"": 0}",1991,5053,10000
291200,-19996,-48005,"(AMETHYSTS, US << MARKET, 9998, 1, 291200)
(AMETHYSTS, US << MARKET, 9998, 1, 291200)","{""AMETHYSTS"": 5, ""STARFRUIT"": 0}",2000,5051,10001
291400,5049,-42956,"(STARFRUIT, MARKET << US, 5049, 1, 291400)","{""AMETHYSTS"": 5, ""STARFRUIT"": -1}",1992,5052,10000
291500,69965,27009,"(AMETHYSTS, MARKET << US, 9995, 1, 291500)
(AMETHYSTS, MARKET << US, 9995, 1, 291500)
(AMETHYSTS, MARKET << US, 9995, 1, 291500)
(AMETHYSTS, MARKET << US, 9995, 1, 291500)
(AMETHYSTS, MARKET << US, 9995, 1, 291500)
(AMETHYSTS, MARKET << US, 9995, 1, 291500)
(AMETHYSTS, MARKET << US, 9995, 1, 291500)","{""AMETHYSTS"": -2, ""STARFRUIT"": -1}",1957,5052,10000
291600,-20008,7001,"(AMETHYSTS, US << MARKET, 10004, 1, 291600)
(AMETHYSTS, US << MARKET, 10004, 1, 291600)","{""AMETHYSTS"": 0, ""STARFRUIT"": -1}",1948,5053,10001
291900,10100,17101,"(STARFRUIT, MARKET << US, 5050, 1, 291900)
(STARFRUIT, MARKET << US, 5050, 1, 291900)","{""AMETHYSTS"": 0, ""STARFRUIT"": -3}",1954,5049,10000
292200,10112,27213,"(STARFRUIT, MARKET << US, 5056, 1, 292200)
(STARFRUIT, MARKET << US, 5056, 1, 292200)","{""AMETHYSTS"": 0, ""STARFRUIT"": -5}",1943,5054,9999
292400,5057,32270,"(STARFRUIT, MARKET << US, 5057, 1, 292400)","{""AMETHYSTS"": 0, ""STARFRUIT"": -6}",1952,5053,10001
292500,9998,42268,"(AMETHYSTS, MARKET << US, 9998, 1, 292500)","{""AMETHYSTS"": -1, ""STARFRUIT"": -6}",1953,5053,9997
292600,-20118,22150,"(AMETHYSTS, US << MARKET, 10004, 1, 292600)
(STARFRUIT, US << MARKET, 5057, 1, 292600)
(STARFRUIT, US << MARKET, 5057, 1, 292600)","{""AMETHYSTS"": 0, ""STARFRUIT"": -4}",1934,5054,10000
292800,9892,32042,"(AMETHYSTS, MARKET << US, 10002, 1, 292800)
(AMETHYSTS, MARKET << US, 10002, 1, 292800)
(STARFRUIT, US << MARKET, 5056, 1, 292800)
(STARFRUIT, US << MARKET, 5056, 1, 292800)","{""AMETHYSTS"": -2, ""STARFRUIT"": -2}",1922,5057,10003
292900,-20008,12034,"(AMETHYSTS, US << MARKET, 10004, 1, 292900)
(AMETHYSTS, US << MARKET, 10004, 1, 292900)","{""AMETHYSTS"": 0, ""STARFRUIT"": -2}",1928,5053,10000
293500,-30210,-18176,"(AMETHYSTS, US << MARKET, 10000, 1, 293500)
(STARFRUIT, US << MARKET, 5053, 1, 293500)
(STARFRUIT, US << MARKET, 5053, 1, 293500)
(STARFRUIT, US << MARKET, 5053, 1, 293500)
(STARFRUIT, US << MARKET, 5053, 1, 293500)
(STARFRUIT, US << MARKET, 5053, 1, 293500)
(STARFRUIT, US << MARKET, 5053, 1, 293500)
(STARFRUIT, MARKET << US, 5054, 1, 293500)
(STARFRUIT, MARKET << US, 5054, 1, 293500)","{""AMETHYSTS"": 1, ""STARFRUIT"": 2}",1926,5052,9998
293800,-10106,-28282,"(STARFRUIT, US << MARKET, 5053, 1, 293800)
(STARFRUIT, US << MARKET, 5053, 1, 293800)","{""AMETHYSTS"": 1, ""STARFRUIT"": 4}",1942,5056,10000
293900,-30112,-58394,"(AMETHYSTS, US << MARKET, 9998, 1, 293900)
(AMETHYSTS, US << MARKET, 9998, 1, 293900)
(STARFRUIT, US << MARKET, 5058, 1, 293900)
(STARFRUIT, US << MARKET, 5058, 1, 293900)","{""AMETHYSTS"": 3, ""STARFRUIT"": 6}",1957,5058,10001
294200,-20212,-78606,"(STARFRUIT, US << MARKET, 5053, 1, 294200)
(STARFRUIT, US << MARKET, 5053, 1, 294200)
(STARFRUIT, US << MARKET, 5053, 1, 294200)
(STARFRUIT, US << MARKET, 5053, 1, 294200)","{""AMETHYSTS"": 3, ""STARFRUIT"": 10}",1920,5052,10002
294300,-30094,-108700,"(AMETHYSTS, US << MARKET, 9996, 1, 294300)
(AMETHYSTS, US << MARKET, 9996, 1, 294300)
(STARFRUIT, US << MARKET, 5051, 1, 294300)
(STARFRUIT, US << MARKET, 5051, 1, 294300)","{""AMETHYSTS"": 5, ""STARFRUIT"": 12}",1948,5054,10000
294400,-30015,-138715,"(AMETHYSTS, US << MARKET, 10005, 1, 294400)
(AMETHYSTS, US << MARKET, 10005, 1, 294400)
(AMETHYSTS, US << MARKET, 10005, 1, 294400)","{""AMETHYSTS"": 8, ""STARFRUIT"": 12}",1957,5056,10000
294500,9998,-128717,"(AMETHYSTS, MARKET << US, 9998, 1, 294500)","{""AMETHYSTS"": 7, ""STARFRUIT"": 12}",1898,5053,9997
294600,35399,-93318,"(STARFRUIT, MARKET << US, 5057, 1, 294600)
(STARFRUIT, MARKET << US, 5057, 1, 294600)
(STARFRUIT, MARKET << US, 5057, 1, 294600)
(STARFRUIT, MARKET << US, 5057, 1, 294600)
(STARFRUIT, MARKET << US, 5057, 1, 294600)
(STARFRUIT, MARKET << US, 5057, 1, 294600)
(STARFRUIT, MARKET << US, 5057, 1, 294600)","{""AMETHYSTS"": 7, ""STARFRUIT"": 5}",1941,5056,9997
295000,-20204,-113522,"(STARFRUIT, US << MARKET, 5051, 1, 295000)
(STARFRUIT, US << MARKET, 5051, 1, 295000)
(STARFRUIT, US << MARKET, 5051, 1, 295000)
(STARFRUIT, US << MARKET, 5051, 1, 295000)","{""AMETHYSTS"": 7, ""STARFRUIT"": 9}",1921,5050,9999
295600,5049,-108473,"(STARFRUIT, MARKET << US, 5049, 1, 295600)","{""AMETHYSTS"": 7, ""STARFRUIT"": 8}",1915,5052,9996
296400,49990,-58483,"(AMETHYSTS, MARKET << US, 9998, 1, 296400)
(AMETHYSTS, MARKET << US, 9998, 1, 296400)
(AMETHYSTS, MARKET << US, 9998, 1, 296400)
(AMETHYSTS, MARKET << US, 9998, 1, 296400)
(AMETHYSTS, MARKET << US, 9998, 1, 296400)","{""AMETHYSTS"": 2, ""STARFRUIT"": 8}",1943,5053,10001
296800,-50010,-108493,"(AMETHYSTS, US << MARKET, 10002, 1, 296800)
(AMETHYSTS, US << MARKET, 10002, 1, 296800)
(AMETHYSTS, US << MARKET, 10002, 1, 296800)
(AMETHYSTS, US << MARKET, 10002, 1, 296800)
(AMETHYSTS, US << MARKET, 10002, 1, 296800)","{""AMETHYSTS"": 7, ""STARFRUIT"": 8}",1944,5052,10003
297100,96,-108397,"(AMETHYSTS, US << MARKET, 10004, 1, 297100)
(STARFRUIT, MARKET << US, 5050, 1, 297100)
(STARFRUIT, MARKET << US, 5050, 1, 297100)","{""AMETHYSTS"": 8, ""STARFRUIT"": 6}",1921,5053,10000
297600,-9906,-118303,"(AMETHYSTS, US << MARKET, 10002, 1, 297600)
(AMETHYSTS, US << MARKET, 10002, 1, 297600)
(STARFRUIT, MARKET << US, 5049, 1, 297600)
(STARFRUIT, MARKET << US, 5049, 1, 297600)","{""AMETHYSTS"": 10, ""STARFRUIT"": 4}",1935,5052,10003
298400,-19996,-138299,"(AMETHYSTS, US << MARKET, 9998, 1, 298400)
(AMETHYSTS, US << MARKET, 9998, 1, 298400)","{""AMETHYSTS"": 12, ""STARFRUIT"": 4}",1865,5050,9997
298700,20180,-118119,"(STARFRUIT, MARKET << US, 5045, 1, 298700)
(STARFRUIT, MARKET << US, 5045, 1, 298700)
(STARFRUIT, MARKET << US, 5045, 1, 298700)
(STARFRUIT, MARKET << US, 5045, 1, 298700)","{""AMETHYSTS"": 12, ""STARFRUIT"": 0}",1893,5048,10001
298900,-30080,-148199,"(AMETHYSTS, US << MARKET, 9995, 1, 298900)
(AMETHYSTS, US << MARKET, 9995, 1, 298900)
(STARFRUIT, US << MARKET, 5045, 1, 298900)
(STARFRUIT, US << MARKET, 5045, 1, 298900)","{""AMETHYSTS"": 14, ""STARFRUIT"": 2}",1895,5047,10000
299200,-39984,-188183,"(AMETHYSTS, US << MARKET, 9996, 1, 299200)
(AMETHYSTS, US << MARKET, 9996, 1, 299200)
(AMETHYSTS, US << MARKET, 9996, 1, 299200)
(AMETHYSTS, US << MARKET, 9996, 1, 299200)
(AMETHYSTS, US << MARKET, 9996, 1, 299200)
(AMETHYSTS, US << MARKET, 9996, 1, 299200)
(AMETHYSTS, MARKET << US, 9996, 1, 299200)
(AMETHYSTS, MARKET << US, 9996, 1, 299200)","{""AMETHYSTS"": 18, ""STARFRUIT"": 2}",1915,5049,10000
299400,-10192,-198375,"(AMETHYSTS, MARKET << US, 9996, 1, 299400)
(STARFRUIT, US << MARKET, 5047, 1, 299400)
(STARFRUIT, US << MARKET, 5047, 1, 299400)
(STARFRUIT, US << MARKET, 5047, 1, 299400)
(STARFRUIT, US << MARKET, 5047, 1, 299400)","{""AMETHYSTS"": 17, ""STARFRUIT"": 6}",1902,5049,9999
299500,-20200,-218575,"(STARFRUIT, US << MARKET, 5050, 1, 299500)
(STARFRUIT, US << MARKET, 5050, 1, 299500)
(STARFRUIT, US << MARKET, 5050, 1, 299500)
(STARFRUIT, US << MARKET, 5050, 1, 299500)","{""AMETHYSTS"": 17, ""STARFRUIT"": 10}",1854,5048,9997
299600,-5048,-223623,"(STARFRUIT, US << MARKET, 5048, 1, 299600)","{""AMETHYSTS"": 17, ""STARFRUIT"": 11}",1927,5050,10000
299700,-10098,-233721,"(STARFRUIT, US << MARKET, 5049, 1, 299700)
(STARFRUIT, US << MARKET, 5049, 1, 299700)","{""AMETHYSTS"": 17, ""STARFRUIT"": 13}",1903,5048,10000
299800,-14942,-248663,"(AMETHYSTS, US << MARKET, 9998, 1, 299800)
(AMETHYSTS, US << MARKET, 9998, 1, 299800)
(STARFRUIT, MARKET << US, 5054, 1, 299800)","{""AMETHYSTS"": 19, ""STARFRUIT"": 12}",1880,5050,9997
299900,-15044,-263707,"(AMETHYSTS, US << MARKET, 9996, 1, 299900)
(STARFRUIT, US << MARKET, 5048, 1, 299900)","{""AMETHYSTS"": 20, ""STARFRUIT"": 13}",1883,5050,9997
300300,-5053,-268760,"(STARFRUIT, US << MARKET, 5053, 1, 300300)","{""AMETHYSTS"": 20, ""STARFRUIT"": 14}",1954,5051,10000
300400,5048,-263712,"(STARFRUIT, US << MARKET, 5048, 1, 300400)
(STARFRUIT, MARKET << US, 5048, 1, 300400)
(STARFRUIT, MARKET << US, 5048, 1, 300400)","{""AMETHYSTS"": 20, ""STARFRUIT"": 13}",1951,5051,10000
300700,-5054,-268766,"(STARFRUIT, US << MARKET, 5054, 1, 300700)","{""AMETHYSTS"": 20, ""STARFRUIT"": 14}",1934,5050,10000
300800,5049,-263717,"(STARFRUIT, MARKET << US, 5049, 1, 300800)","{""AMETHYSTS"": 20, ""STARFRUIT"": 13}",1959,5052,10000
301200,4850,-258867,"(AMETHYSTS, MARKET << US, 10004, 1, 301200)
(AMETHYSTS, MARKET << US, 10004, 1, 301200)
(STARFRUIT, US << MARKET, 5053, 1, 301200)
(STARFRUIT, US << MARKET, 5053, 1, 301200)
(STARFRUIT, US << MARKET, 5053, 1, 301200)
(STARFRUIT, US << MARKET, 5053, 1, 301200)
(STARFRUIT, MARKET << US, 5054, 1, 301200)","{""AMETHYSTS"": 18, ""STARFRUIT"": 16}",1997,5054,10000
301800,40376,-218491,"(STARFRUIT, MARKET << US, 5047, 1, 301800)
(STARFRUIT, MARKET << US, 5047, 1, 301800)
(STARFRUIT, MARKET << US, 5047, 1, 301800)
(STARFRUIT, MARKET << US, 5047, 1, 301800)
(STARFRUIT, MARKET << US, 5047, 1, 301800)
(STARFRUIT, MARKET << US, 5047, 1, 301800)
(STARFRUIT, MARKET << US, 5047, 1, 301800)
(STARFRUIT, MARKET << US, 5047, 1, 301800)","{""AMETHYSTS"": 18, ""STARFRUIT"": 8}",1963,5050,10003
301900,-10002,-228493,"(AMETHYSTS, US << MARKET, 10002, 1, 301900)","{""AMETHYSTS"": 19, ""STARFRUIT"": 8}",1956,5049,10003
302100,-9998,-238491,"(AMETHYSTS, US << MARKET, 9998, 1, 302100)","{""AMETHYSTS"": 20, ""STARFRUIT"": 8}",1937,5051,10001
302400,5047,-233444,"(STARFRUIT, MARKET << US, 5047, 1, 302400)","{""AMETHYSTS"": 20, ""STARFRUIT"": 7}",1913,5051,10000
302600,0,-233444,,"{""AMETHYSTS"": 20, ""STARFRUIT"": 7}",1846,5050,9997
302700,0,-233444,,"{""AMETHYSTS"": 20, ""STARFRUIT"": 7}",1826,5050,9996
303000,49990,-183454,"(AMETHYSTS, MARKET << US, 9998, 1, 303000)
(AMETHYSTS, MARKET << US, 9998, 1, 303000)
(AMETHYSTS, MARKET << US, 9998, 1, 303000)
(AMETHYSTS, MARKET << US, 9998, 1, 303000)
(AMETHYSTS, MARKET << US, 9998, 1, 303000)","{""AMETHYSTS"": 15, ""STARFRUIT"": 7}",1925,5052,10001
303100,-25045,-208499,"(AMETHYSTS, US << MARKET, 9998, 1, 303100)
(AMETHYSTS, US << MARKET, 9998, 1, 303100)
(STARFRUIT, US << MARKET, 5049, 1, 303100)","{""AMETHYSTS"": 17, ""STARFRUIT"": 8}",1934,5052,10001
303500,25270,-183229,"(STARFRUIT, MARKET << US, 5054, 1, 303500)
(STARFRUIT, MARKET << US, 5054, 1, 303500)
(STARFRUIT, MARKET << US, 5054, 1, 303500)
(STARFRUIT, MARKET << US, 5054, 1, 303500)
(STARFRUIT, MARKET << US, 5054, 1, 303500)","{""AMETHYSTS"": 17, ""STARFRUIT"": 3}",1936,5055,10000
303900,-19996,-203225,"(AMETHYSTS, US << MARKET, 9998, 1, 303900)
(AMETHYSTS, US << MARKET, 9998, 1, 303900)","{""AMETHYSTS"": 19, ""STARFRUIT"": 3}",1877,5053,9997
304400,-10108,-213333,"(STARFRUIT, US << MARKET, 5054, 1, 304400)
(STARFRUIT, US << MARKET, 5054, 1, 304400)","{""AMETHYSTS"": 19, ""STARFRUIT"": 5}",1937,5054,10000
304600,-10104,-223437,"(STARFRUIT, US << MARKET, 5052, 1, 304600)
(STARFRUIT, US << MARKET, 5052, 1, 304600)","{""AMETHYSTS"": 19, ""STARFRUIT"": 7}",1875,5050,9998
305100,20004,-203433,"(AMETHYSTS, MARKET << US, 10002, 1, 305100)
(AMETHYSTS, MARKET << US, 10002, 1, 305100)","{""AMETHYSTS"": 17, ""STARFRUIT"": 7}",1982,5052,10003
305200,-10002,-213435,"(AMETHYSTS, US << MARKET, 10002, 1, 305200)","{""AMETHYSTS"": 18, ""STARFRUIT"": 7}",1990,5053,10003
305300,49990,-163445,"(AMETHYSTS, MARKET << US, 9998, 1, 305300)
(AMETHYSTS, MARKET << US, 9998, 1, 305300)
(AMETHYSTS, MARKET << US, 9998, 1, 305300)
(AMETHYSTS, MARKET << US, 9998, 1, 305300)
(AMETHYSTS, MARKET << US, 9998, 1, 305300)","{""AMETHYSTS"": 13, ""STARFRUIT"": 7}",1880,5052,9997
305500,-20212,-183657,"(STARFRUIT, US << MARKET, 5053, 1, 305500)
(STARFRUIT, US << MARKET, 5053, 1, 305500)
(STARFRUIT, US << MARKET, 5053, 1, 305500)
(STARFRUIT, US << MARKET, 5053, 1, 305500)","{""AMETHYSTS"": 13, ""STARFRUIT"": 11}",1865,5051,9997
305700,-15157,-198814,"(STARFRUIT, US << MARKET, 5052, 1, 305700)
(STARFRUIT, US << MARKET, 5052, 1, 305700)
(STARFRUIT, US << MARKET, 5052, 1, 305700)
(STARFRUIT, US << MARKET, 5052, 1, 305700)
(STARFRUIT, MARKET << US, 5051, 1, 305700)","{""AMETHYSTS"": 13, ""STARFRUIT"": 14}",1886,5050,10000
305900,-25035,-223849,"(AMETHYSTS, US << MARKET, 9996, 1, 305900)
(AMETHYSTS, US << MARKET, 9996, 1, 305900)
(STARFRUIT, US << MARKET, 5049, 1, 305900)
(STARFRUIT, US << MARKET, 5049, 1, 305900)
(STARFRUIT, MARKET << US, 5055, 1, 305900)","{""AMETHYSTS"": 15, ""STARFRUIT"": 15}",1916,5051,10000
306100,15062,-208787,"(AMETHYSTS, US << MARKET, 10004, 1, 306100)
(AMETHYSTS, MARKET << US, 10005, 1, 306100)
(AMETHYSTS, MARKET << US, 10005, 1, 306100)
(STARFRUIT, MARKET << US, 5056, 1, 306100)","{""AMETHYSTS"": 14, ""STARFRUIT"": 14}",1941,5052,10000
306500,19992,-188795,"(AMETHYSTS, MARKET << US, 9996, 1, 306500)
(AMETHYSTS, MARKET << US, 9996, 1, 306500)","{""AMETHYSTS"": 12, ""STARFRUIT"": 14}",1905,5050,10000
306800,40368,-148427,"(STARFRUIT, MARKET << US, 5046, 1, 306800)
(STARFRUIT, MARKET << US, 5046, 1, 306800)
(STARFRUIT, MARKET << US, 5046, 1, 306800)
(STARFRUIT, MARKET << US, 5046, 1, 306800)
(STARFRUIT, MARKET << US, 5046, 1, 306800)
(STARFRUIT, MARKET << US, 5046, 1, 306800)
(STARFRUIT, MARKET << US, 5046, 1, 306800)
(STARFRUIT, MARKET << US, 5046, 1, 306800)","{""AMETHYSTS"": 12, ""STARFRUIT"": 6}",1861,5048,10000
307000,-59988,-208415,"(AMETHYSTS, US << MARKET, 9998, 1, 307000)
(AMETHYSTS, US << MARKET, 9998, 1, 307000)
(AMETHYSTS, US << MARKET, 9998, 1, 307000)
(AMETHYSTS, US << MARKET, 9998, 1, 307000)
(AMETHYSTS, US << MARKET, 9998, 1, 307000)
(AMETHYSTS, US << MARKET, 9998, 1, 307000)","{""AMETHYSTS"": 18, ""STARFRUIT"": 6}",1897,5049,10001
307200,9900,-198515,"(AMETHYSTS, MARKET << US, 9995, 1, 307200)
(AMETHYSTS, MARKET << US, 9995, 1, 307200)
(STARFRUIT, US << MARKET, 5045, 1, 307200)
(STARFRUIT, US << MARKET, 5045, 1, 307200)","{""AMETHYSTS"": 16, ""STARFRUIT"": 8}",1877,5049,10000
307300,30294,-168221,"(STARFRUIT, MARKET << US, 5049, 1, 307300)
(STARFRUIT, MARKET << US, 5049, 1, 307300)
(STARFRUIT, MARKET << US, 5049, 1, 307300)
(STARFRUIT, MARKET << US, 5049, 1, 307300)
(STARFRUIT, MARKET << US, 5049, 1, 307300)
(STARFRUIT, MARKET << US, 5049, 1, 307300)","{""AMETHYSTS"": 16, ""STARFRUIT"": 2}",1825,5047,9997
307500,-10102,-178323,"(STARFRUIT, US << MARKET, 5051, 1, 307500)
(STARFRUIT, US << MARKET, 5051, 1, 307500)","{""AMETHYSTS"": 16, ""STARFRUIT"": 4}",1853,5052,9998
307700,5045,-173278,"(STARFRUIT, MARKET << US, 5045, 1, 307700)","{""AMETHYSTS"": 16, ""STARFRUIT"": 3}",1882,5048,10001
308500,15045,-158233,"(AMETHYSTS, MARKET << US, 9995, 1, 308500)
(STARFRUIT, MARKET << US, 5050, 1, 308500)","{""AMETHYSTS"": 15, ""STARFRUIT"": 2}",1869,5051,10000
308600,15043,-143190,"(AMETHYSTS, MARKET << US, 9998, 1, 308600)
(STARFRUIT, MARKET << US, 5045, 1, 308600)","{""AMETHYSTS"": 14, ""STARFRUIT"": 1}",1868,5044,10001
308900,-25215,-168405,"(STARFRUIT, US << MARKET, 5043, 1, 308900)
(STARFRUIT, US << MARKET, 5043, 1, 308900)
(STARFRUIT, US << MARKET, 5043, 1, 308900)
(STARFRUIT, US << MARKET, 5043, 1, 308900)
(STARFRUIT, US << MARKET, 5043, 1, 308900)","{""AMETHYSTS"": 14, ""STARFRUIT"": 6}",1877,5047,10000
309000,5044,-163361,"(STARFRUIT, MARKET << US, 5044, 1, 309000)","{""AMETHYSTS"": 14, ""STARFRUIT"": 5}",1869,5046,10000
309200,10094,-153267,"(STARFRUIT, MARKET << US, 5047, 1, 309200)
(STARFRUIT, MARKET << US, 5047, 1, 309200)","{""AMETHYSTS"": 14, ""STARFRUIT"": 3}",1829,5046,9997
309300,9998,-143269,"(AMETHYSTS, MARKET << US, 9998, 1, 309300)","{""AMETHYSTS"": 13, ""STARFRUIT"": 3}",1869,5046,10000
309400,-4952,-148221,"(AMETHYSTS, US << MARKET, 10002, 1, 309400)
(STARFRUIT, MARKET << US, 5050, 1, 309400)","{""AMETHYSTS"": 14, ""STARFRUIT"": 2}",1921,5050,10003
309800,-10002,-158223,"(AMETHYSTS, US << MARKET, 10002, 1, 309800)","{""AMETHYSTS"": 15, ""STARFRUIT"": 2}",1920,5049,10003
310000,20004,-138219,"(AMETHYSTS, MARKET << US, 10002, 1, 310000)
(AMETHYSTS, MARKET << US, 10002, 1, 310000)","{""AMETHYSTS"": 13, ""STARFRUIT"": 2}",1916,5048,10003
310100,5050,-133169,"(STARFRUIT, MARKET << US, 5050, 1, 310100)","{""AMETHYSTS"": 13, ""STARFRUIT"": 1}",1878,5047,10000
310500,-19996,-153165,"(AMETHYSTS, US << MARKET, 9998, 1, 310500)
(AMETHYSTS, US << MARKET, 9998, 1, 310500)","{""AMETHYSTS"": 15, ""STARFRUIT"": 1}",1839,5049,9997
310700,15150,-138015,"(STARFRUIT, MARKET << US, 5050, 1, 310700)
(STARFRUIT, MARKET << US, 5050, 1, 310700)
(STARFRUIT, MARKET << US, 5050, 1, 310700)","{""AMETHYSTS"": 15, ""STARFRUIT"": -2}",1883,5051,10000
310800,5050,-132965,"(STARFRUIT, MARKET << US, 5050, 1, 310800)","{""AMETHYSTS"": 15, ""STARFRUIT"": -3}",1882,5051,10000
310900,5046,-127919,"(STARFRUIT, MARKET << US, 5046, 1, 310900)","{""AMETHYSTS"": 15, ""STARFRUIT"": -4}",1916,5045,10001
311000,9998,-117921,"(AMETHYSTS, MARKET << US, 9998, 1, 311000)","{""AMETHYSTS"": 14, ""STARFRUIT"": -4}",1845,5048,9997
311100,5050,-112871,"(STARFRUIT, MARKET << US, 5050, 1, 311100)","{""AMETHYSTS"": 14, ""STARFRUIT"": -5}",1874,5051,10000
311300,5047,-107824,"(STARFRUIT, MARKET << US, 5047, 1, 311300)","{""AMETHYSTS"": 14, ""STARFRUIT"": -6}",1900,5046,10000
311600,-25242,-133066,"(STARFRUIT, US << MARKET, 5048, 1, 311600)
(STARFRUIT, US << MARKET, 5048, 1, 311600)
(STARFRUIT, US << MARKET, 5048, 1, 311600)
(STARFRUIT, US << MARKET, 5048, 1, 311600)
(STARFRUIT, US << MARKET, 5048, 1, 311600)
(STARFRUIT, US << MARKET, 5048, 1, 311600)
(STARFRUIT, MARKET << US, 5046, 1, 311600)","{""AMETHYSTS"": 14, ""STARFRUIT"": -1}",1861,5045,9998
311700,10090,-122976,"(STARFRUIT, MARKET << US, 5045, 1, 311700)
(STARFRUIT, MARKET << US, 5045, 1, 311700)","{""AMETHYSTS"": 14, ""STARFRUIT"": -3}",1866,5048,9999
311800,-10002,-132978,"(AMETHYSTS, US << MARKET, 10002, 1, 311800)","{""AMETHYSTS"": 15, ""STARFRUIT"": -3}",1863,5048,9999
312100,5045,-127933,"(STARFRUIT, MARKET << US, 5045, 1, 312100)","{""AMETHYSTS"": 15, ""STARFRUIT"": -4}",1879,5047,10000
312300,-94,-128027,"(AMETHYSTS, MARKET << US, 9996, 1, 312300)
(STARFRUIT, US << MARKET, 5045, 1, 312300)
(STARFRUIT, US << MARKET, 5045, 1, 312300)","{""AMETHYSTS"": 14, ""STARFRUIT"": -2}",1863,5048,9999
312400,-19996,-148023,"(AMETHYSTS, US << MARKET, 9998, 1, 312400)
(AMETHYSTS, US << MARKET, 9998, 1, 312400)","{""AMETHYSTS"": 16, ""STARFRUIT"": -2}",1819,5047,9996
312500,-20188,-168211,"(STARFRUIT, US << MARKET, 5045, 1, 312500)
(STARFRUIT, US << MARKET, 5045, 1, 312500)
(STARFRUIT, US << MARKET, 5049, 1, 312500)
(STARFRUIT, US << MARKET, 5049, 1, 312500)","{""AMETHYSTS"": 16, ""STARFRUIT"": 2}",1881,5046,10000
312700,-10102,-178313,"(STARFRUIT, US << MARKET, 5051, 1, 312700)
(STARFRUIT, US << MARKET, 5051, 1, 312700)","{""AMETHYSTS"": 16, ""STARFRUIT"": 4}",1863,5048,9999
313500,160064,-18249,"(AMETHYSTS, MARKET << US, 10004, 1, 313500)
(AMETHYSTS, MARKET << US, 10004, 1, 313500)
(AMETHYSTS, MARKET << US, 10004, 1, 313500)
(AMETHYSTS, MARKET << US, 10004, 1, 313500)
(AMETHYSTS, MARKET << US, 10004, 1, 313500)
(AMETHYSTS, MARKET << US, 10004, 1, 313500)
(AMETHYSTS, MARKET << US, 10004, 1, 313500)
(AMETHYSTS, MARKET << US, 10004, 1, 313500)
(AMETHYSTS, MARKET << US, 10004, 1, 313500)
(AMETHYSTS, MARKET << US, 10004, 1, 313500)
(AMETHYSTS, MARKET << US, 10004, 1, 313500)
(AMETHYSTS, MARKET << US, 10004, 1, 313500)
(AMETHYSTS, MARKET << US, 10004, 1, 313500)
(AMETHYSTS, MARKET << US, 10004, 1, 313500)
(AMETHYSTS, MARKET << US, 10004, 1, 313500)
(AMETHYSTS, MARKET << US, 10004, 1, 313500)","{""AMETHYSTS"": 0, ""STARFRUIT"": 4}",1931,5045,10000
314200,-5133,-23382,"(AMETHYSTS, MARKET << US, 9996, 1, 314200)
(STARFRUIT, US << MARKET, 5043, 1, 314200)
(STARFRUIT, US << MARKET, 5043, 1, 314200)
(STARFRUIT, US << MARKET, 5043, 1, 314200)","{""AMETHYSTS"": -1, ""STARFRUIT"": 7}",1941,5046,9999
314400,-25036,-48418,"(AMETHYSTS, US << MARKET, 9996, 1, 314400)
(AMETHYSTS, US << MARKET, 9996, 1, 314400)
(STARFRUIT, US << MARKET, 5044, 1, 314400)","{""AMETHYSTS"": 1, ""STARFRUIT"": 8}",1958,5047,10000
314800,80016,31598,"(AMETHYSTS, MARKET << US, 10002, 1, 314800)
(AMETHYSTS, MARKET << US, 10002, 1, 314800)
(AMETHYSTS, MARKET << US, 10002, 1, 314800)
(AMETHYSTS, MARKET << US, 10002, 1, 314800)
(AMETHYSTS, MARKET << US, 10002, 1, 314800)
(AMETHYSTS, MARKET << US, 10002, 1, 314800)
(AMETHYSTS, MARKET << US, 10002, 1, 314800)
(AMETHYSTS, MARKET << US, 10002, 1, 314800)","{""AMETHYSTS"": -7, ""STARFRUIT"": 8}",1953,5047,10003
314900,-14949,16649,"(AMETHYSTS, US << MARKET, 9996, 1, 314900)
(AMETHYSTS, US << MARKET, 9996, 1, 314900)
(STARFRUIT, MARKET << US, 5043, 1, 314900)","{""AMETHYSTS"": -5, ""STARFRUIT"": 7}",1976,5046,9999
315100,-25039,-8390,"(AMETHYSTS, US << MARKET, 9998, 1, 315100)
(AMETHYSTS, US << MARKET, 9998, 1, 315100)
(STARFRUIT, US << MARKET, 5043, 1, 315100)","{""AMETHYSTS"": -3, ""STARFRUIT"": 8}",1975,5046,10001
315200,30294,21904,"(STARFRUIT, MARKET << US, 5049, 1, 315200)
(STARFRUIT, MARKET << US, 5049, 1, 315200)
(STARFRUIT, MARKET << US, 5049, 1, 315200)
(STARFRUIT, MARKET << US, 5049, 1, 315200)
(STARFRUIT, MARKET << US, 5049, 1, 315200)
(STARFRUIT, MARKET << US, 5049, 1, 315200)","{""AMETHYSTS"": -3, ""STARFRUIT"": 2}",2005,5046,9997
315800,-25235,-3331,"(STARFRUIT, US << MARKET, 5047, 1, 315800)
(STARFRUIT, US << MARKET, 5047, 1, 315800)
(STARFRUIT, US << MARKET, 5047, 1, 315800)
(STARFRUIT, US << MARKET, 5047, 1, 315800)
(STARFRUIT, US << MARKET, 5047, 1, 315800)","{""AMETHYSTS"": -3, ""STARFRUIT"": 7}",1991,5046,10000
316000,-5048,-8379,"(STARFRUIT, US << MARKET, 5048, 1, 316000)","{""AMETHYSTS"": -3, ""STARFRUIT"": 8}",2005,5048,10000
316400,-30194,-38573,"(AMETHYSTS, US << MARKET, 10002, 1, 316400)
(STARFRUIT, US << MARKET, 5048, 1, 316400)
(STARFRUIT, US << MARKET, 5048, 1, 316400)
(STARFRUIT, US << MARKET, 5048, 1, 316400)
(STARFRUIT, US << MARKET, 5048, 1, 316400)","{""AMETHYSTS"": -2, ""STARFRUIT"": 12}",2009,5049,10003
316600,30080,-8493,"(AMETHYSTS, MARKET << US, 9996, 1, 316600)
(AMETHYSTS, MARKET << US, 9996, 1, 316600)
(STARFRUIT, MARKET << US, 5044, 1, 316600)
(STARFRUIT, MARKET << US, 5044, 1, 316600)","{""AMETHYSTS"": -4, ""STARFRUIT"": 10}",1989,5047,9997
317000,15049,6556,"(AMETHYSTS, MARKET << US, 9998, 1, 317000)
(STARFRUIT, MARKET << US, 5051, 1, 317000)","{""AMETHYSTS"": -5, ""STARFRUIT"": 9}",2003,5048,9997
317100,5045,11601,"(STARFRUIT, MARKET << US, 5045, 1, 317100)","{""AMETHYSTS"": -5, ""STARFRUIT"": 8}",1987,5047,9998
317200,-5046,6555,"(STARFRUIT, US << MARKET, 5046, 1, 317200)","{""AMETHYSTS"": -5, ""STARFRUIT"": 9}",1970,5045,9998
317300,9998,16553,"(AMETHYSTS, MARKET << US, 9998, 1, 317300)","{""AMETHYSTS"": -6, ""STARFRUIT"": 9}",2009,5048,9996
317400,-5046,11507,"(STARFRUIT, US << MARKET, 5046, 1, 317400)","{""AMETHYSTS"": -6, ""STARFRUIT"": 10}",1963,5045,9999
317500,-5051,6456,"(STARFRUIT, US << MARKET, 5051, 1, 317500)","{""AMETHYSTS"": -6, ""STARFRUIT"": 11}",1984,5048,10000
317900,5050,11506,"(STARFRUIT, MARKET << US, 5050, 1, 317900)","{""AMETHYSTS"": -6, ""STARFRUIT"": 10}",2016,5051,10000
318500,15146,26652,"(STARFRUIT, US << MARKET, 5050, 1, 318500)
(STARFRUIT, MARKET << US, 5049, 1, 318500)
(STARFRUIT, MARKET << US, 5049, 1, 318500)
(STARFRUIT, MARKET << US, 5049, 1, 318500)
(STARFRUIT, MARKET << US, 5049, 1, 318500)","{""AMETHYSTS"": -6, ""STARFRUIT"": 7}",1980,5046,9999
318600,-29896,-3244,"(AMETHYSTS, US << MARKET, 9996, 1, 318600)
(AMETHYSTS, US << MARKET, 9996, 1, 318600)
(AMETHYSTS, US << MARKET, 9996, 1, 318600)
(AMETHYSTS, US << MARKET, 9996, 1, 318600)
(STARFRUIT, MARKET << US, 5044, 1, 318600)
(STARFRUIT, MARKET << US, 5044, 1, 318600)","{""AMETHYSTS"": -2, ""STARFRUIT"": 5}",1991,5047,10000
319000,-10100,-13344,"(STARFRUIT, US << MARKET, 5050, 1, 319000)
(STARFRUIT, US << MARKET, 5050, 1, 319000)","{""AMETHYSTS"": -2, ""STARFRUIT"": 7}",2006,5050,10000
319300,-19992,-33336,"(AMETHYSTS, US << MARKET, 9996, 1, 319300)
(AMETHYSTS, US << MARKET, 9996, 1, 319300)","{""AMETHYSTS"": 0, ""STARFRUIT"": 7}",2000,5048,9999
319500,130026,96690,"(AMETHYSTS, US << MARKET, 10002, 1, 319500)
(AMETHYSTS, MARKET << US, 10002, 1, 319500)
(AMETHYSTS, MARKET << US, 10002, 1, 319500)
(AMETHYSTS, MARKET << US, 10002, 1, 319500)
(AMETHYSTS, MARKET << US, 10002, 1, 319500)
(AMETHYSTS, MARKET << US, 10002, 1, 319500)
(AMETHYSTS, MARKET << US, 10002, 1, 319500)
(AMETHYSTS, MARKET << US, 10002, 1, 319500)
(AMETHYSTS, MARKET << US, 10002, 1, 319500)
(AMETHYSTS, MARKET << US, 10002, 1, 319500)
(AMETHYSTS, MARKET << US, 10002, 1, 319500)
(AMETHYSTS, MARKET << US, 10002, 1, 319500)
(AMETHYSTS, MARKET << US, 10002, 1, 319500)
(AMETHYSTS, MARKET << US, 10002, 1, 319500)
(AMETHYSTS, MARKET << US, 10002, 1, 319500)","{""AMETHYSTS"": -13, ""STARFRUIT"": 7}",2039,5048,9999
319800,20184,116874,"(STARFRUIT, MARKET << US, 5046, 1, 319800)
(STARFRUIT, MARKET << US, 5046, 1, 319800)
(STARFRUIT, MARKET << US, 5046, 1, 319800)
(STARFRUIT, MARKET << US, 5046, 1, 319800)","{""AMETHYSTS"": -13, ""STARFRUIT"": 3}",1996,5045,10001
320000,-10002,106872,"(AMETHYSTS, US << MARKET, 10002, 1, 320000)","{""AMETHYSTS"": -12, ""STARFRUIT"": 3}",1980,5048,10003
320100,-20010,86862,"(AMETHYSTS, US << MARKET, 10005, 1, 320100)
(AMETHYSTS, US << MARKET, 10005, 1, 320100)","{""AMETHYSTS"": -10, ""STARFRUIT"": 3}",1973,5047,10003
320300,-10002,76860,"(AMETHYSTS, US << MARKET, 10002, 1, 320300)","{""AMETHYSTS"": -9, ""STARFRUIT"": 3}",2007,5046,9999
320600,-14948,61912,"(AMETHYSTS, US << MARKET, 9996, 1, 320600)
(AMETHYSTS, US << MARKET, 9996, 1, 320600)
(STARFRUIT, MARKET << US, 5044, 1, 320600)","{""AMETHYSTS"": -7, ""STARFRUIT"": 2}",2004,5046,10000
320900,5044,66956,"(STARFRUIT, MARKET << US, 5044, 1, 320900)","{""AMETHYSTS"": -7, ""STARFRUIT"": 1}",2003,5047,10000
321000,5043,71999,"(STARFRUIT, MARKET << US, 5043, 1, 321000)","{""AMETHYSTS"": -7, ""STARFRUIT"": 0}",1999,5046,10000
321200,-19996,52003,"(AMETHYSTS, US << MARKET, 9998, 1, 321200)
(AMETHYSTS, US << MARKET, 9998, 1, 321200)","{""AMETHYSTS"": -5, ""STARFRUIT"": 0}",1998,5046,10001
321500,20004,72007,"(AMETHYSTS, MARKET << US, 10002, 1, 321500)
(AMETHYSTS, MARKET << US, 10002, 1, 321500)","{""AMETHYSTS"": -7, ""STARFRUIT"": 0}",1986,5045,10003
321600,-19996,52011,"(AMETHYSTS, US << MARKET, 9998, 1, 321600)
(AMETHYSTS, US << MARKET, 9998, 1, 321600)","{""AMETHYSTS"": -5, ""STARFRUIT"": 0}",2031,5046,9996
321700,40008,92019,"(AMETHYSTS, MARKET << US, 10002, 1, 321700)
(AMETHYSTS, MARKET << US, 10002, 1, 321700)
(AMETHYSTS, MARKET << US, 10002, 1, 321700)
(AMETHYSTS, MARKET << US, 10002, 1, 321700)","{""AMETHYSTS"": -9, ""STARFRUIT"": 0}",2019,5047,10000
322400,15129,107148,"(STARFRUIT, MARKET << US, 5043, 1, 322400)
(STARFRUIT, MARKET << US, 5043, 1, 322400)
(STARFRUIT, MARKET << US, 5043, 1, 322400)","{""AMETHYSTS"": -9, ""STARFRUIT"": -3}",2013,5045,10000
322600,-10278,96870,"(AMETHYSTS, MARKET << US, 10002, 1, 322600)
(AMETHYSTS, MARKET << US, 10002, 1, 322600)
(STARFRUIT, US << MARKET, 5047, 1, 322600)
(STARFRUIT, US << MARKET, 5047, 1, 322600)
(STARFRUIT, US << MARKET, 5047, 1, 322600)
(STARFRUIT, US << MARKET, 5047, 1, 322600)
(STARFRUIT, US << MARKET, 5047, 1, 322600)
(STARFRUIT, US << MARKET, 5047, 1, 322600)","{""AMETHYSTS"": -11, ""STARFRUIT"": 3}",1981,5048,10003
322700,20172,117042,"(STARFRUIT, MARKET << US, 5043, 1, 322700)
(STARFRUIT, MARKET << US, 5043, 1, 322700)
(STARFRUIT, MARKET << US, 5043, 1, 322700)
(STARFRUIT, MARKET << US, 5043, 1, 322700)","{""AMETHYSTS"": -11, ""STARFRUIT"": -1}",1996,5046,10000
322900,29818,146860,"(AMETHYSTS, US << MARKET, 9998, 1, 322900)
(AMETHYSTS, US << MARKET, 9998, 1, 322900)
(AMETHYSTS, MARKET << US, 9998, 1, 322900)
(AMETHYSTS, MARKET << US, 9998, 1, 322900)
(AMETHYSTS, MARKET << US, 9998, 1, 322900)
(AMETHYSTS, MARKET << US, 9998, 1, 322900)
(AMETHYSTS, MARKET << US, 9998, 1, 322900)
(AMETHYSTS, MARKET << US, 9998, 1, 322900)
(AMETHYSTS, MARKET << US, 9998, 1, 322900)
(STARFRUIT, US << MARKET, 5043, 1, 322900)
(STARFRUIT, US << MARKET, 5043, 1, 322900)
(STARFRUIT, US << MARKET, 5043, 1, 322900)
(STARFRUIT, US << MARKET, 5043, 1, 322900)","{""AMETHYSTS"": -16, ""STARFRUIT"": 3}",1979,5045,10001
323000,5048,151908,"(STARFRUIT, MARKET << US, 5048, 1, 323000)","{""AMETHYSTS"": -16, ""STARFRUIT"": 2}",2006,5049,10000
323600,-10098,141810,"(STARFRUIT, US << MARKET, 5049, 1, 323600)
(STARFRUIT, US << MARKET, 5049, 1, 323600)","{""AMETHYSTS"": -16, ""STARFRUIT"": 4}",1990,5049,10001
323700,-9914,131896,"(AMETHYSTS, US << MARKET, 10002, 1, 323700)
(AMETHYSTS, US << MARKET, 10002, 1, 323700)
(STARFRUIT, US << MARKET, 5045, 1, 323700)
(STARFRUIT, US << MARKET, 5045, 1, 323700)
(STARFRUIT, MARKET << US, 5045, 1, 323700)
(STARFRUIT, MARKET << US, 5045, 1, 323700)
(STARFRUIT, MARKET << US, 5045, 1, 323700)
(STARFRUIT, MARKET << US, 5045, 1, 323700)","{""AMETHYSTS"": -14, ""STARFRUIT"": 2}",1942,5044,10003
324100,20104,152000,"(AMETHYSTS, US << MARKET, 10004, 1, 324100)
(AMETHYSTS, MARKET << US, 10004, 1, 324100)
(AMETHYSTS, MARKET << US, 10004, 1, 324100)
(STARFRUIT, MARKET << US, 5050, 1, 324100)
(STARFRUIT, MARKET << US, 5050, 1, 324100)","{""AMETHYSTS"": -15, ""STARFRUIT"": 0}",1985,5047,10001
324600,35133,187133,"(AMETHYSTS, MARKET << US, 10002, 1, 324600)
(AMETHYSTS, MARKET << US, 10002, 1, 324600)
(STARFRUIT, MARKET << US, 5043, 1, 324600)
(STARFRUIT, MARKET << US, 5043, 1, 324600)
(STARFRUIT, MARKET << US, 5043, 1, 324600)","{""AMETHYSTS"": -17, ""STARFRUIT"": -3}",1947,5045,10003
324800,15140,202273,"(STARFRUIT, MARKET << US, 5048, 1, 324800)
(STARFRUIT, MARKET << US, 5048, 1, 324800)
(STARFRUIT, MARKET << US, 5044, 1, 324800)","{""AMETHYSTS"": -17, ""STARFRUIT"": -6}",1998,5043,10001
325200,-20184,182089,"(STARFRUIT, US << MARKET, 5046, 1, 325200)
(STARFRUIT, US << MARKET, 5046, 1, 325200)
(STARFRUIT, US << MARKET, 5046, 1, 325200)
(STARFRUIT, US << MARKET, 5046, 1, 325200)","{""AMETHYSTS"": -17, ""STARFRUIT"": -2}",2033,5045,9998
325400,15042,197131,"(AMETHYSTS, MARKET << US, 9998, 1, 325400)
(STARFRUIT, MARKET << US, 5044, 1, 325400)","{""AMETHYSTS"": -18, ""STARFRUIT"": -3}",1972,5047,10001
325600,-20104,177027,"(AMETHYSTS, US << MARKET, 10004, 1, 325600)
(STARFRUIT, US << MARKET, 5050, 1, 325600)
(STARFRUIT, US << MARKET, 5050, 1, 325600)","{""AMETHYSTS"": -17, ""STARFRUIT"": -1}",1981,5046,10000
326200,-102,176925,"(AMETHYSTS, US << MARKET, 10004, 1, 326200)
(AMETHYSTS, MARKET << US, 10002, 1, 326200)
(AMETHYSTS, MARKET << US, 10002, 1, 326200)
(STARFRUIT, US << MARKET, 5051, 1, 326200)
(STARFRUIT, US << MARKET, 5051, 1, 326200)","{""AMETHYSTS"": -18, ""STARFRUIT"": 1}",1919,5048,10003
326500,-25240,151685,"(STARFRUIT, US << MARKET, 5048, 1, 326500)
(STARFRUIT, US << MARKET, 5048, 1, 326500)
(STARFRUIT, US << MARKET, 5048, 1, 326500)
(STARFRUIT, US << MARKET, 5048, 1, 326500)
(STARFRUIT, US << MARKET, 5048, 1, 326500)","{""AMETHYSTS"": -18, ""STARFRUIT"": 6}",1979,5046,9999
326800,-20184,131501,"(STARFRUIT, US << MARKET, 5046, 1, 326800)
(STARFRUIT, US << MARKET, 5046, 1, 326800)
(STARFRUIT, US << MARKET, 5046, 1, 326800)
(STARFRUIT, US << MARKET, 5046, 1, 326800)","{""AMETHYSTS"": -18, ""STARFRUIT"": 10}",1991,5049,10000
326900,14958,146459,"(AMETHYSTS, MARKET << US, 10002, 1, 326900)
(AMETHYSTS, MARKET << US, 10002, 1, 326900)
(STARFRUIT, US << MARKET, 5046, 1, 326900)","{""AMETHYSTS"": -20, ""STARFRUIT"": 11}",1927,5048,10003
327300,5054,151513,"(STARFRUIT, MARKET << US, 5054, 1, 327300)","{""AMETHYSTS"": -20, ""STARFRUIT"": 10}",2013,5050,10000
327400,-20098,131415,"(AMETHYSTS, US << MARKET, 10002, 1, 327400)
(STARFRUIT, US << MARKET, 5048, 1, 327400)
(STARFRUIT, US << MARKET, 5048, 1, 327400)","{""AMETHYSTS"": -19, ""STARFRUIT"": 12}",1970,5051,10003
327800,-5047,126368,"(STARFRUIT, US << MARKET, 5047, 1, 327800)","{""AMETHYSTS"": -19, ""STARFRUIT"": 13}",2018,5050,10000
328400,-5052,121316,"(STARFRUIT, US << MARKET, 5052, 1, 328400)","{""AMETHYSTS"": -19, ""STARFRUIT"": 14}",2058,5053,10000
328700,-97,121219,"(AMETHYSTS, MARKET << US, 9995, 1, 328700)
(STARFRUIT, US << MARKET, 5046, 1, 328700)
(STARFRUIT, US << MARKET, 5046, 1, 328700)","{""AMETHYSTS"": -20, ""STARFRUIT"": 16}",1987,5048,10000
329500,-9906,111313,"(AMETHYSTS, US << MARKET, 10005, 1, 329500)
(AMETHYSTS, US << MARKET, 10005, 1, 329500)
(STARFRUIT, MARKET << US, 5052, 1, 329500)
(STARFRUIT, MARKET << US, 5052, 1, 329500)","{""AMETHYSTS"": -18, ""STARFRUIT"": 14}",1985,5048,10000
329700,5045,116358,"(STARFRUIT, MARKET << US, 5045, 1, 329700)","{""AMETHYSTS"": -18, ""STARFRUIT"": 13}",1969,5047,10000
330200,-5050,111308,"(STARFRUIT, US << MARKET, 5050, 1, 330200)","{""AMETHYSTS"": -18, ""STARFRUIT"": 14}",2022,5051,10000
330300,9904,121212,"(AMETHYSTS, MARKET << US, 10002, 1, 330300)
(AMETHYSTS, MARKET << US, 10002, 1, 330300)
(STARFRUIT, US << MARKET, 5050, 1, 330300)
(STARFRUIT, US << MARKET, 5050, 1, 330300)","{""AMETHYSTS"": -20, ""STARFRUIT"": 16}",2004,5047,9998
330400,35354,156566,"(STARFRUIT, US << MARKET, 5046, 1, 330400)
(STARFRUIT, MARKET << US, 5050, 1, 330400)
(STARFRUIT, MARKET << US, 5050, 1, 330400)
(STARFRUIT, MARKET << US, 5050, 1, 330400)
(STARFRUIT, MARKET << US, 5050, 1, 330400)
(STARFRUIT, MARKET << US, 5050, 1, 330400)
(STARFRUIT, MARKET << US, 5050, 1, 330400)
(STARFRUIT, MARKET << US, 5050, 1, 330400)
(STARFRUIT, MARKET << US, 5050, 1, 330400)","{""AMETHYSTS"": -20, ""STARFRUIT"": 9}",2005,5051,10001
330600,5045,161611,"(STARFRUIT, MARKET << US, 5045, 1, 330600)","{""AMETHYSTS"": -20, ""STARFRUIT"": 8}",2023,5049,9999
330800,-4952,156659,"(AMETHYSTS, US << MARKET, 10004, 1, 330800)
(STARFRUIT, MARKET << US, 5052, 1, 330800)","{""AMETHYSTS"": -19, ""STARFRUIT"": 7}",1983,5049,10001
331000,40376,197035,"(STARFRUIT, MARKET << US, 5047, 1, 331000)
(STARFRUIT, MARKET << US, 5047, 1, 331000)
(STARFRUIT, MARKET << US, 5047, 1, 331000)
(STARFRUIT, MARKET << US, 5047, 1, 331000)
(STARFRUIT, MARKET << US, 5047, 1, 331000)
(STARFRUIT, MARKET << US, 5047, 1, 331000)
(STARFRUIT, MARKET << US, 5047, 1, 331000)
(STARFRUIT, MARKET << US, 5047, 1, 331000)","{""AMETHYSTS"": -19, ""STARFRUIT"": -1}",2027,5046,9998
331100,-10092,186943,"(STARFRUIT, US << MARKET, 5046, 1, 331100)
(STARFRUIT, US << MARKET, 5046, 1, 331100)","{""AMETHYSTS"": -19, ""STARFRUIT"": 1}",2049,5049,9997
331200,-88,186855,"(AMETHYSTS, MARKET << US, 10002, 1, 331200)
(STARFRUIT, US << MARKET, 5045, 1, 331200)
(STARFRUIT, US << MARKET, 5045, 1, 331200)","{""AMETHYSTS"": -20, ""STARFRUIT"": 3}",1939,5048,10003
331400,0,186855,,"{""AMETHYSTS"": -20, ""STARFRUIT"": 3}",1979,5048,10001
331800,96,186951,"(AMETHYSTS, US << MARKET, 10002, 1, 331800)
(STARFRUIT, MARKET << US, 5049, 1, 331800)
(STARFRUIT, MARKET << US, 5049, 1, 331800)","{""AMETHYSTS"": -19, ""STARFRUIT"": 1}",1944,5050,10003
332100,-14952,171999,"(AMETHYSTS, US << MARKET, 9998, 1, 332100)
(AMETHYSTS, US << MARKET, 9998, 1, 332100)
(STARFRUIT, MARKET << US, 5044, 1, 332100)","{""AMETHYSTS"": -17, ""STARFRUIT"": 0}",1982,5047,10001
332300,9914,181913,"(AMETHYSTS, MARKET << US, 10002, 1, 332300)
(AMETHYSTS, MARKET << US, 10002, 1, 332300)
(STARFRUIT, US << MARKET, 5045, 1, 332300)
(STARFRUIT, US << MARKET, 5045, 1, 332300)","{""AMETHYSTS"": -19, ""STARFRUIT"": 2}",1952,5048,10003
332400,-9906,172007,"(AMETHYSTS, US << MARKET, 10005, 1, 332400)
(AMETHYSTS, US << MARKET, 10005, 1, 332400)
(STARFRUIT, MARKET << US, 5052, 1, 332400)
(STARFRUIT, MARKET << US, 5052, 1, 332400)","{""AMETHYSTS"": -17, ""STARFRUIT"": 0}",2007,5049,10000
332600,10092,182099,"(STARFRUIT, MARKET << US, 5046, 1, 332600)
(STARFRUIT, MARKET << US, 5046, 1, 332600)","{""AMETHYSTS"": -17, ""STARFRUIT"": -2}",2039,5047,9998
332700,30012,212111,"(AMETHYSTS, MARKET << US, 10004, 1, 332700)
(AMETHYSTS, MARKET << US, 10004, 1, 332700)
(AMETHYSTS, MARKET << US, 10004, 1, 332700)","{""AMETHYSTS"": -20, ""STARFRUIT"": -2}",2013,5049,10000
332900,-30264,181847,"(STARFRUIT, US << MARKET, 5044, 1, 332900)
(STARFRUIT, US << MARKET, 5044, 1, 332900)
(STARFRUIT, US << MARKET, 5044, 1, 332900)
(STARFRUIT, US << MARKET, 5044, 1, 332900)
(STARFRUIT, US << MARKET, 5044, 1, 332900)
(STARFRUIT, US << MARKET, 5044, 1, 332900)","{""AMETHYSTS"": -20, ""STARFRUIT"": 4}",2015,5047,10001
333700,-20172,161675,"(STARFRUIT, US << MARKET, 5043, 1, 333700)
(STARFRUIT, US << MARKET, 5043, 1, 333700)
(STARFRUIT, US << MARKET, 5043, 1, 333700)
(STARFRUIT, US << MARKET, 5043, 1, 333700)","{""AMETHYSTS"": -20, ""STARFRUIT"": 8}",2043,5046,10000
334000,-20180,141495,"(STARFRUIT, US << MARKET, 5045, 1, 334000)
(STARFRUIT, US << MARKET, 5045, 1, 334000)
(STARFRUIT, US << MARKET, 5045, 1, 334000)
(STARFRUIT, US << MARKET, 5045, 1, 334000)","{""AMETHYSTS"": -20, ""STARFRUIT"": 12}",2031,5043,9999
336100,5040,146535,"(STARFRUIT, MARKET << US, 5040, 1, 336100)","{""AMETHYSTS"": -20, ""STARFRUIT"": 11}",2008,5043,10000
336700,-25145,121390,"(AMETHYSTS, US << MARKET, 10004, 1, 336700)
(STARFRUIT, US << MARKET, 5047, 1, 336700)
(STARFRUIT, US << MARKET, 5047, 1, 336700)
(STARFRUIT, US << MARKET, 5047, 1, 336700)
(STARFRUIT, US << MARKET, 5047, 1, 336700)
(STARFRUIT, MARKET << US, 5047, 1, 336700)","{""AMETHYSTS"": -19, ""STARFRUIT"": 14}",2006,5044,10000
336900,20176,141566,"(STARFRUIT, MARKET << US, 5044, 1, 336900)
(STARFRUIT, MARKET << US, 5044, 1, 336900)
(STARFRUIT, MARKET << US, 5044, 1, 336900)
(STARFRUIT, MARKET << US, 5044, 1, 336900)","{""AMETHYSTS"": -19, ""STARFRUIT"": 10}",2024,5042,9998
337000,-19996,121570,"(AMETHYSTS, US << MARKET, 9998, 1, 337000)
(AMETHYSTS, US << MARKET, 9998, 1, 337000)","{""AMETHYSTS"": -17, ""STARFRUIT"": 10}",2071,5045,9997
337100,-19996,101574,"(AMETHYSTS, US << MARKET, 9998, 1, 337100)
(AMETHYSTS, US << MARKET, 9998, 1, 337100)","{""AMETHYSTS"": -15, ""STARFRUIT"": 10}",2009,5045,10001
337500,-20196,81378,"(STARFRUIT, US << MARKET, 5049, 1, 337500)
(STARFRUIT, US << MARKET, 5049, 1, 337500)
(STARFRUIT, US << MARKET, 5049, 1, 337500)
(STARFRUIT, US << MARKET, 5049, 1, 337500)","{""AMETHYSTS"": -15, ""STARFRUIT"": 14}",2050,5048,10000
337900,-5049,76329,"(STARFRUIT, US << MARKET, 5049, 1, 337900)","{""AMETHYSTS"": -15, ""STARFRUIT"": 15}",2019,5045,9999
338100,-20172,56157,"(STARFRUIT, US << MARKET, 5043, 1, 338100)
(STARFRUIT, US << MARKET, 5043, 1, 338100)
(STARFRUIT, US << MARKET, 5043, 1, 338100)
(STARFRUIT, US << MARKET, 5043, 1, 338100)","{""AMETHYSTS"": -15, ""STARFRUIT"": 19}",2031,5046,10000
338200,-14947,41210,"(AMETHYSTS, US << MARKET, 9996, 1, 338200)
(AMETHYSTS, US << MARKET, 9996, 1, 338200)
(STARFRUIT, US << MARKET, 5045, 1, 338200)
(STARFRUIT, MARKET << US, 5045, 1, 338200)
(STARFRUIT, MARKET << US, 5045, 1, 338200)","{""AMETHYSTS"": -13, ""STARFRUIT"": 18}",2074,5048,10000
338300,-5045,36165,"(STARFRUIT, US << MARKET, 5045, 1, 338300)","{""AMETHYSTS"": -13, ""STARFRUIT"": 19}",2058,5047,10000
338400,9998,46163,"(AMETHYSTS, MARKET << US, 9998, 1, 338400)","{""AMETHYSTS"": -14, ""STARFRUIT"": 19}",2112,5047,9996
339700,19990,66153,"(AMETHYSTS, MARKET << US, 9995, 1, 339700)
(AMETHYSTS, MARKET << US, 9995, 1, 339700)","{""AMETHYSTS"": -16, ""STARFRUIT"": 19}",1970,5043,10000
340400,-14951,51202,"(AMETHYSTS, US << MARKET, 9996, 1, 340400)
(AMETHYSTS, US << MARKET, 9996, 1, 340400)
(STARFRUIT, MARKET << US, 5041, 1, 340400)","{""AMETHYSTS"": -14, ""STARFRUIT"": 18}",1940,5041,10000
340900,45369,96571,"(STARFRUIT, MARKET << US, 5041, 1, 340900)
(STARFRUIT, MARKET << US, 5041, 1, 340900)
(STARFRUIT, MARKET << US, 5041, 1, 340900)
(STARFRUIT, MARKET << US, 5041, 1, 340900)
(STARFRUIT, MARKET << US, 5041, 1, 340900)
(STARFRUIT, MARKET << US, 5041, 1, 340900)
(STARFRUIT, MARKET << US, 5041, 1, 340900)
(STARFRUIT, MARKET << US, 5041, 1, 340900)
(STARFRUIT, MARKET << US, 5041, 1, 340900)","{""AMETHYSTS"": -14, ""STARFRUIT"": 9}",1967,5044,10000
341100,-10190,86381,"(AMETHYSTS, MARKET << US, 9998, 1, 341100)
(STARFRUIT, US << MARKET, 5047, 1, 341100)
(STARFRUIT, US << MARKET, 5047, 1, 341100)
(STARFRUIT, US << MARKET, 5047, 1, 341100)
(STARFRUIT, US << MARKET, 5047, 1, 341100)","{""AMETHYSTS"": -15, ""STARFRUIT"": 13}",2013,5044,9996
341400,-5049,81332,"(STARFRUIT, US << MARKET, 5049, 1, 341400)","{""AMETHYSTS"": -15, ""STARFRUIT"": 14}",2018,5049,10000
342000,20004,101336,"(AMETHYSTS, MARKET << US, 10002, 1, 342000)
(AMETHYSTS, MARKET << US, 10002, 1, 342000)","{""AMETHYSTS"": -17, ""STARFRUIT"": 14}",1957,5048,10003
342700,15156,116492,"(STARFRUIT, MARKET << US, 5052, 1, 342700)
(STARFRUIT, MARKET << US, 5052, 1, 342700)
(STARFRUIT, MARKET << US, 5052, 1, 342700)","{""AMETHYSTS"": -17, ""STARFRUIT"": 11}",2075,5053,10000
342800,25055,141547,"(AMETHYSTS, US << MARKET, 10004, 1, 342800)
(AMETHYSTS, MARKET << US, 10004, 1, 342800)
(AMETHYSTS, MARKET << US, 10004, 1, 342800)
(AMETHYSTS, MARKET << US, 10004, 1, 342800)
(STARFRUIT, MARKET << US, 5047, 1, 342800)","{""AMETHYSTS"": -19, ""STARFRUIT"": 10}",2047,5050,10000
342900,25138,166685,"(AMETHYSTS, MARKET << US, 9996, 1, 342900)
(STARFRUIT, MARKET << US, 5048, 1, 342900)
(STARFRUIT, MARKET << US, 5047, 1, 342900)
(STARFRUIT, MARKET << US, 5047, 1, 342900)","{""AMETHYSTS"": -20, ""STARFRUIT"": 7}",2035,5050,10000
343200,-30006,136679,"(AMETHYSTS, US << MARKET, 10002, 1, 343200)
(AMETHYSTS, US << MARKET, 10002, 1, 343200)
(AMETHYSTS, US << MARKET, 10002, 1, 343200)","{""AMETHYSTS"": -17, ""STARFRUIT"": 7}",1985,5051,10003
343300,-5048,131631,"(STARFRUIT, US << MARKET, 5048, 1, 343300)","{""AMETHYSTS"": -17, ""STARFRUIT"": 8}",2056,5051,9999
343400,-20220,111411,"(STARFRUIT, US << MARKET, 5055, 1, 343400)
(STARFRUIT, US << MARKET, 5055, 1, 343400)
(STARFRUIT, US << MARKET, 5055, 1, 343400)
(STARFRUIT, US << MARKET, 5055, 1, 343400)","{""AMETHYSTS"": -17, ""STARFRUIT"": 12}",2059,5054,10000
343800,5053,116464,"(STARFRUIT, MARKET << US, 5053, 1, 343800)","{""AMETHYSTS"": -17, ""STARFRUIT"": 11}",2058,5054,10000
344100,9998,126462,"(AMETHYSTS, MARKET << US, 9998, 1, 344100)","{""AMETHYSTS"": -18, ""STARFRUIT"": 11}",2066,5050,9997
344300,20004,146466,"(AMETHYSTS, MARKET << US, 10002, 1, 344300)
(AMETHYSTS, MARKET << US, 10002, 1, 344300)","{""AMETHYSTS"": -20, ""STARFRUIT"": 11}",1967,5051,10003
344800,-99950,46516,"(AMETHYSTS, US << MARKET, 9995, 1, 344800)
(AMETHYSTS, US << MARKET, 9995, 1, 344800)
(AMETHYSTS, US << MARKET, 9995, 1, 344800)
(AMETHYSTS, US << MARKET, 9995, 1, 344800)
(AMETHYSTS, US << MARKET, 9995, 1, 344800)
(AMETHYSTS, US << MARKET, 9995, 1, 344800)
(AMETHYSTS, US << MARKET, 9995, 1, 344800)
(AMETHYSTS, US << MARKET, 9995, 1, 344800)
(AMETHYSTS, US << MARKET, 9995, 1, 344800)
(AMETHYSTS, US << MARKET, 9995, 1, 344800)","{""AMETHYSTS"": -10, ""STARFRUIT"": 11}",2077,5051,10000
344900,9894,56410,"(AMETHYSTS, MARKET << US, 9995, 1, 344900)
(AMETHYSTS, MARKET << US, 9995, 1, 344900)
(STARFRUIT, US << MARKET, 5048, 1, 344900)
(STARFRUIT, US << MARKET, 5048, 1, 344900)","{""AMETHYSTS"": -12, ""STARFRUIT"": 13}",2121,5051,9996
345200,-5054,51356,"(STARFRUIT, US << MARKET, 5054, 1, 345200)","{""AMETHYSTS"": -12, ""STARFRUIT"": 14}",2084,5052,10000
345300,-19996,31360,"(AMETHYSTS, US << MARKET, 9998, 1, 345300)
(AMETHYSTS, US << MARKET, 9998, 1, 345300)","{""AMETHYSTS"": -10, ""STARFRUIT"": 14}",2104,5051,9997
345500,5054,36414,"(STARFRUIT, MARKET << US, 5054, 1, 345500)","{""AMETHYSTS"": -10, ""STARFRUIT"": 13}",2139,5055,9999
346100,-20196,16218,"(STARFRUIT, US << MARKET, 5049, 1, 346100)
(STARFRUIT, US << MARKET, 5049, 1, 346100)
(STARFRUIT, US << MARKET, 5049, 1, 346100)
(STARFRUIT, US << MARKET, 5049, 1, 346100)","{""AMETHYSTS"": -10, ""STARFRUIT"": 17}",2102,5052,10000
346800,90045,106263,"(AMETHYSTS, MARKET << US, 10005, 1, 346800)
(AMETHYSTS, MARKET << US, 10005, 1, 346800)
(AMETHYSTS, MARKET << US, 10005, 1, 346800)
(AMETHYSTS, MARKET << US, 10005, 1, 346800)
(AMETHYSTS, MARKET << US, 10005, 1, 346800)
(AMETHYSTS, MARKET << US, 10005, 1, 346800)
(AMETHYSTS, MARKET << US, 10005, 1, 346800)
(AMETHYSTS, MARKET << US, 10005, 1, 346800)
(AMETHYSTS, MARKET << US, 10005, 1, 346800)","{""AMETHYSTS"": -19, ""STARFRUIT"": 17}",2113,5050,10000
346900,-19996,86267,"(AMETHYSTS, US << MARKET, 9998, 1, 346900)
(AMETHYSTS, US << MARKET, 9998, 1, 346900)","{""AMETHYSTS"": -17, ""STARFRUIT"": 17}",2202,5051,9996
347100,-10002,76265,"(AMETHYSTS, US << MARKET, 10002, 1, 347100)","{""AMETHYSTS"": -16, ""STARFRUIT"": 17}",2067,5050,10003
347300,-20008,56257,"(AMETHYSTS, US << MARKET, 10004, 1, 347300)
(AMETHYSTS, US << MARKET, 10004, 1, 347300)","{""AMETHYSTS"": -14, ""STARFRUIT"": 17}",2107,5050,10000
347900,49975,106232,"(AMETHYSTS, MARKET << US, 9995, 1, 347900)
(AMETHYSTS, MARKET << US, 9995, 1, 347900)
(AMETHYSTS, MARKET << US, 9995, 1, 347900)
(AMETHYSTS, MARKET << US, 9995, 1, 347900)
(AMETHYSTS, MARKET << US, 9995, 1, 347900)","{""AMETHYSTS"": -19, ""STARFRUIT"": 17}",2065,5049,10000
348100,-99980,6252,"(AMETHYSTS, US << MARKET, 9998, 1, 348100)
(AMETHYSTS, US << MARKET, 9998, 1, 348100)
(AMETHYSTS, US << MARKET, 9998, 1, 348100)
(AMETHYSTS, US << MARKET, 9998, 1, 348100)
(AMETHYSTS, US << MARKET, 9998, 1, 348100)
(AMETHYSTS, US << MARKET, 9998, 1, 348100)
(AMETHYSTS, US << MARKET, 9998, 1, 348100)
(AMETHYSTS, US << MARKET, 9998, 1, 348100)
(AMETHYSTS, US << MARKET, 9998, 1, 348100)
(AMETHYSTS, US << MARKET, 9998, 1, 348100)","{""AMETHYSTS"": -9, ""STARFRUIT"": 17}",2076,5049,10001
348700,20180,26432,"(STARFRUIT, MARKET << US, 5045, 1, 348700)
(STARFRUIT, MARKET << US, 5045, 1, 348700)
(STARFRUIT, MARKET << US, 5045, 1, 348700)
(STARFRUIT, MARKET << US, 5045, 1, 348700)","{""AMETHYSTS"": -9, ""STARFRUIT"": 13}",2056,5048,10000
349300,5050,31482,"(STARFRUIT, MARKET << US, 5050, 1, 349300)","{""AMETHYSTS"": -9, ""STARFRUIT"": 12}",2094,5051,10000
350300,40008,71490,"(AMETHYSTS, MARKET << US, 10002, 1, 350300)
(AMETHYSTS, MARKET << US, 10002, 1, 350300)
(AMETHYSTS, MARKET << US, 10002, 1, 350300)
(AMETHYSTS, MARKET << US, 10002, 1, 350300)","{""AMETHYSTS"": -13, ""STARFRUIT"": 12}",2039,5049,10003
350400,-5046,66444,"(STARFRUIT, US << MARKET, 5046, 1, 350400)","{""AMETHYSTS"": -13, ""STARFRUIT"": 13}",2094,5048,9998
350600,35364,101808,"(STARFRUIT, MARKET << US, 5052, 1, 350600)
(STARFRUIT, MARKET << US, 5052, 1, 350600)
(STARFRUIT, MARKET << US, 5052, 1, 350600)
(STARFRUIT, MARKET << US, 5052, 1, 350600)
(STARFRUIT, MARKET << US, 5052, 1, 350600)
(STARFRUIT, MARKET << US, 5052, 1, 350600)
(STARFRUIT, MARKET << US, 5052, 1, 350600)","{""AMETHYSTS"": -13, ""STARFRUIT"": 6}",2102,5049,10000
350900,5053,106861,"(STARFRUIT, MARKET << US, 5053, 1, 350900)","{""AMETHYSTS"": -13, ""STARFRUIT"": 5}",2131,5054,10000
351000,20004,126865,"(AMETHYSTS, MARKET << US, 10002, 1, 351000)
(AMETHYSTS, MARKET << US, 10002, 1, 351000)","{""AMETHYSTS"": -15, ""STARFRUIT"": 5}",2080,5052,10003
351700,9998,136863,"(AMETHYSTS, MARKET << US, 9998, 1, 351700)","{""AMETHYSTS"": -16, ""STARFRUIT"": 5}",2087,5048,10001
351900,-4956,131907,"(AMETHYSTS, US << MARKET, 10002, 1, 351900)
(STARFRUIT, MARKET << US, 5046, 1, 351900)","{""AMETHYSTS"": -15, ""STARFRUIT"": 4}",2107,5050,10000
352800,-20192,111715,"(STARFRUIT, US << MARKET, 5048, 1, 352800)
(STARFRUIT, US << MARKET, 5048, 1, 352800)
(STARFRUIT, US << MARKET, 5048, 1, 352800)
(STARFRUIT, US << MARKET, 5048, 1, 352800)","{""AMETHYSTS"": -15, ""STARFRUIT"": 8}",2076,5047,10001
353100,-10002,101713,"(AMETHYSTS, US << MARKET, 10002, 1, 353100)","{""AMETHYSTS"": -14, ""STARFRUIT"": 8}",2089,5047,10000
353200,-5050,96663,"(STARFRUIT, US << MARKET, 5050, 1, 353200)","{""AMETHYSTS"": -14, ""STARFRUIT"": 9}",2086,5047,10000
353900,4952,101615,"(AMETHYSTS, MARKET << US, 9996, 1, 353900)
(STARFRUIT, US << MARKET, 5044, 1, 353900)","{""AMETHYSTS"": -15, ""STARFRUIT"": 10}",2075,5046,10000
354600,-5044,96571,"(STARFRUIT, US << MARKET, 5044, 1, 354600)","{""AMETHYSTS"": -15, ""STARFRUIT"": 11}",2096,5045,9998
355000,-4953,91618,"(AMETHYSTS, US << MARKET, 10002, 1, 355000)
(STARFRUIT, MARKET << US, 5049, 1, 355000)","{""AMETHYSTS"": -14, ""STARFRUIT"": 10}",2066,5049,10003
355600,-5044,86574,"(STARFRUIT, US << MARKET, 5044, 1, 355600)","{""AMETHYSTS"": -14, ""STARFRUIT"": 11}",2088,5048,10001
355700,50025,136599,"(AMETHYSTS, MARKET << US, 10005, 1, 355700)
(AMETHYSTS, MARKET << US, 10005, 1, 355700)
(AMETHYSTS, MARKET << US, 10005, 1, 355700)
(AMETHYSTS, MARKET << US, 10005, 1, 355700)
(AMETHYSTS, MARKET << US, 10005, 1, 355700)","{""AMETHYSTS"": -19, ""STARFRUIT"": 11}",2116,5047,10000
355800,5044,141643,"(STARFRUIT, MARKET << US, 5044, 1, 355800)","{""AMETHYSTS"": -19, ""STARFRUIT"": 10}",2104,5048,10001
356000,30294,171937,"(STARFRUIT, MARKET << US, 5049, 1, 356000)
(STARFRUIT, MARKET << US, 5049, 1, 356000)
(STARFRUIT, MARKET << US, 5049, 1, 356000)
(STARFRUIT, MARKET << US, 5049, 1, 356000)
(STARFRUIT, MARKET << US, 5049, 1, 356000)
(STARFRUIT, MARKET << US, 5049, 1, 356000)","{""AMETHYSTS"": -19, ""STARFRUIT"": 4}",2121,5046,10000
356100,-20180,151757,"(STARFRUIT, US << MARKET, 5045, 1, 356100)
(STARFRUIT, US << MARKET, 5045, 1, 356100)
(STARFRUIT, US << MARKET, 5045, 1, 356100)
(STARFRUIT, US << MARKET, 5045, 1, 356100)","{""AMETHYSTS"": -19, ""STARFRUIT"": 8}",2122,5048,10001
356800,9998,161755,"(AMETHYSTS, MARKET << US, 9998, 1, 356800)","{""AMETHYSTS"": -20, ""STARFRUIT"": 8}",2199,5048,9997
356900,-5046,156709,"(STARFRUIT, US << MARKET, 5046, 1, 356900)","{""AMETHYSTS"": -20, ""STARFRUIT"": 9}",2150,5049,10000
357100,25234,181943,"(STARFRUIT, MARKET << US, 5047, 1, 357100)
(STARFRUIT, MARKET << US, 5047, 1, 357100)
(STARFRUIT, MARKET << US, 5047, 1, 357100)
(STARFRUIT, MARKET << US, 5047, 1, 357100)
(STARFRUIT, MARKET << US, 5046, 1, 357100)","{""AMETHYSTS"": -20, ""STARFRUIT"": 4}",2167,5046,9998
357200,0,181943,,"{""AMETHYSTS"": -20, ""STARFRUIT"": 4}",2115,5048,10001
357400,-19996,161947,"(AMETHYSTS, US << MARKET, 9998, 1, 357400)
(AMETHYSTS, US << MARKET, 9998, 1, 357400)","{""AMETHYSTS"": -18, ""STARFRUIT"": 4}",2197,5049,9997
357600,-29890,132057,"(AMETHYSTS, US << MARKET, 9995, 1, 357600)
(AMETHYSTS, US << MARKET, 9995, 1, 357600)
(AMETHYSTS, US << MARKET, 9995, 1, 357600)
(AMETHYSTS, US << MARKET, 9995, 1, 357600)
(STARFRUIT, MARKET << US, 5045, 1, 357600)
(STARFRUIT, MARKET << US, 5045, 1, 357600)","{""AMETHYSTS"": -14, ""STARFRUIT"": 2}",2153,5048,10000
358100,5046,137103,"(STARFRUIT, MARKET << US, 5046, 1, 358100)","{""AMETHYSTS"": -14, ""STARFRUIT"": 1}",2153,5050,10000
358500,-19996,117107,"(AMETHYSTS, US << MARKET, 9998, 1, 358500)
(AMETHYSTS, US << MARKET, 9998, 1, 358500)","{""AMETHYSTS"": -12, ""STARFRUIT"": 1}",2193,5050,9997
358600,-25270,91837,"(STARFRUIT, US << MARKET, 5054, 1, 358600)
(STARFRUIT, US << MARKET, 5054, 1, 358600)
(STARFRUIT, US << MARKET, 5054, 1, 358600)
(STARFRUIT, US << MARKET, 5054, 1, 358600)
(STARFRUIT, US << MARKET, 5054, 1, 358600)","{""AMETHYSTS"": -12, ""STARFRUIT"": 6}",2125,5050,10001
358900,10202,102039,"(AMETHYSTS, US << MARKET, 10002, 1, 358900)
(STARFRUIT, MARKET << US, 5051, 1, 358900)
(STARFRUIT, MARKET << US, 5051, 1, 358900)
(STARFRUIT, MARKET << US, 5051, 1, 358900)
(STARFRUIT, MARKET << US, 5051, 1, 358900)","{""AMETHYSTS"": -11, ""STARFRUIT"": 2}",2110,5052,10003
359100,-10004,92035,"(AMETHYSTS, US << MARKET, 10004, 1, 359100)","{""AMETHYSTS"": -10, ""STARFRUIT"": 2}",2139,5052,10000
359300,25062,117097,"(AMETHYSTS, MARKET << US, 10005, 1, 359300)
(AMETHYSTS, MARKET << US, 10005, 1, 359300)
(STARFRUIT, MARKET << US, 5052, 1, 359300)","{""AMETHYSTS"": -12, ""STARFRUIT"": 1}",2146,5049,10000
359700,20004,137101,"(AMETHYSTS, MARKET << US, 10002, 1, 359700)
(AMETHYSTS, MARKET << US, 10002, 1, 359700)","{""AMETHYSTS"": -14, ""STARFRUIT"": 1}",2109,5050,10003
359900,-14944,122157,"(AMETHYSTS, US << MARKET, 9996, 1, 359900)
(AMETHYSTS, US << MARKET, 9996, 1, 359900)
(STARFRUIT, MARKET << US, 5048, 1, 359900)","{""AMETHYSTS"": -12, ""STARFRUIT"": 0}",2157,5048,10000
360000,-4950,117207,"(AMETHYSTS, US << MARKET, 10005, 1, 360000)
(STARFRUIT, MARKET << US, 5055, 1, 360000)","{""AMETHYSTS"": -11, ""STARFRUIT"": -1}",2144,5052,10001
360200,-30318,86889,"(STARFRUIT, US << MARKET, 5053, 1, 360200)
(STARFRUIT, US << MARKET, 5053, 1, 360200)
(STARFRUIT, US << MARKET, 5053, 1, 360200)
(STARFRUIT, US << MARKET, 5053, 1, 360200)
(STARFRUIT, US << MARKET, 5053, 1, 360200)
(STARFRUIT, US << MARKET, 5053, 1, 360200)","{""AMETHYSTS"": -11, ""STARFRUIT"": 5}",2177,5051,9997
360300,19788,106677,"(AMETHYSTS, MARKET << US, 10002, 1, 360300)
(AMETHYSTS, MARKET << US, 10002, 1, 360300)
(AMETHYSTS, MARKET << US, 10002, 1, 360300)
(AMETHYSTS, MARKET << US, 10002, 1, 360300)
(STARFRUIT, US << MARKET, 5055, 1, 360300)
(STARFRUIT, US << MARKET, 5055, 1, 360300)
(STARFRUIT, US << MARKET, 5055, 1, 360300)
(STARFRUIT, US << MARKET, 5055, 1, 360300)","{""AMETHYSTS"": -15, ""STARFRUIT"": 9}",2091,5051,10003
360600,-39984,66693,"(AMETHYSTS, US << MARKET, 9996, 1, 360600)
(AMETHYSTS, US << MARKET, 9996, 1, 360600)
(AMETHYSTS, US << MARKET, 9996, 1, 360600)
(AMETHYSTS, US << MARKET, 9996, 1, 360600)
(AMETHYSTS, US << MARKET, 9996, 1, 360600)
(AMETHYSTS, US << MARKET, 9996, 1, 360600)
(AMETHYSTS, MARKET << US, 9996, 1, 360600)
(AMETHYSTS, MARKET << US, 9996, 1, 360600)","{""AMETHYSTS"": -11, ""STARFRUIT"": 9}",2143,5050,10000
361100,-20196,46497,"(STARFRUIT, US << MARKET, 5049, 1, 361100)
(STARFRUIT, US << MARKET, 5049, 1, 361100)
(STARFRUIT, US << MARKET, 5049, 1, 361100)
(STARFRUIT, US << MARKET, 5049, 1, 361100)","{""AMETHYSTS"": -11, ""STARFRUIT"": 13}",2132,5048,9999
361400,30282,76779,"(STARFRUIT, MARKET << US, 5047, 1, 361400)
(STARFRUIT, MARKET << US, 5047, 1, 361400)
(STARFRUIT, MARKET << US, 5047, 1, 361400)
(STARFRUIT, MARKET << US, 5047, 1, 361400)
(STARFRUIT, MARKET << US, 5047, 1, 361400)
(STARFRUIT, MARKET << US, 5047, 1, 361400)","{""AMETHYSTS"": -11, ""STARFRUIT"": 7}",2129,5050,10000
361800,-5152,71627,"(AMETHYSTS, MARKET << US, 9998, 1, 361800)
(STARFRUIT, US << MARKET, 5050, 1, 361800)
(STARFRUIT, US << MARKET, 5050, 1, 361800)
(STARFRUIT, US << MARKET, 5050, 1, 361800)","{""AMETHYSTS"": -12, ""STARFRUIT"": 10}",2173,5051,9997
362000,69965,141592,"(AMETHYSTS, MARKET << US, 9995, 1, 362000)
(AMETHYSTS, MARKET << US, 9995, 1, 362000)
(AMETHYSTS, MARKET << US, 9995, 1, 362000)
(AMETHYSTS, MARKET << US, 9995, 1, 362000)
(AMETHYSTS, MARKET << US, 9995, 1, 362000)
(AMETHYSTS, MARKET << US, 9995, 1, 362000)
(AMETHYSTS, MARKET << US, 9995, 1, 362000)","{""AMETHYSTS"": -19, ""STARFRUIT"": 10}",2082,5049,10000
362100,-10002,131590,"(AMETHYSTS, US << MARKET, 10002, 1, 362100)","{""AMETHYSTS"": -18, ""STARFRUIT"": 10}",2096,5047,9998
362300,-15150,116440,"(STARFRUIT, US << MARKET, 5050, 1, 362300)
(STARFRUIT, US << MARKET, 5050, 1, 362300)
(STARFRUIT, US << MARKET, 5050, 1, 362300)","{""AMETHYSTS"": -18, ""STARFRUIT"": 13}",2103,5051,10000
362900,-5051,111389,"(STARFRUIT, US << MARKET, 5051, 1, 362900)","{""AMETHYSTS"": -18, ""STARFRUIT"": 14}",2103,5051,10000
363100,9998,121387,"(AMETHYSTS, MARKET << US, 9998, 1, 363100)","{""AMETHYSTS"": -19, ""STARFRUIT"": 14}",2135,5048,9996
363200,-30116,91271,"(AMETHYSTS, US << MARKET, 10005, 1, 363200)
(AMETHYSTS, US << MARKET, 10005, 1, 363200)
(STARFRUIT, US << MARKET, 5053, 1, 363200)
(STARFRUIT, US << MARKET, 5053, 1, 363200)","{""AMETHYSTS"": -17, ""STARFRUIT"": 16}",2055,5049,10000
363300,-5046,86225,"(STARFRUIT, US << MARKET, 5046, 1, 363300)","{""AMETHYSTS"": -17, ""STARFRUIT"": 17}",2024,5047,10000
363600,45156,131381,"(AMETHYSTS, MARKET << US, 10002, 1, 363600)
(AMETHYSTS, MARKET << US, 10002, 1, 363600)
(AMETHYSTS, MARKET << US, 10002, 1, 363600)
(STARFRUIT, US << MARKET, 5046, 1, 363600)
(STARFRUIT, MARKET << US, 5049, 1, 363600)
(STARFRUIT, MARKET << US, 5049, 1, 363600)
(STARFRUIT, MARKET << US, 5049, 1, 363600)
(STARFRUIT, MARKET << US, 5049, 1, 363600)","{""AMETHYSTS"": -20, ""STARFRUIT"": 14}",1979,5047,10003
363700,-20212,111169,"(STARFRUIT, US << MARKET, 5053, 1, 363700)
(STARFRUIT, US << MARKET, 5053, 1, 363700)
(STARFRUIT, US << MARKET, 5053, 1, 363700)
(STARFRUIT, US << MARKET, 5053, 1, 363700)","{""AMETHYSTS"": -20, ""STARFRUIT"": 18}",2051,5049,10000
364000,-20004,91165,"(AMETHYSTS, US << MARKET, 10002, 1, 364000)
(AMETHYSTS, US << MARKET, 10002, 1, 364000)","{""AMETHYSTS"": -18, ""STARFRUIT"": 18}",2083,5049,9998
364100,-19996,71169,"(AMETHYSTS, US << MARKET, 9998, 1, 364100)
(AMETHYSTS, US << MARKET, 9998, 1, 364100)","{""AMETHYSTS"": -16, ""STARFRUIT"": 18}",2117,5050,9997
364300,-5053,66116,"(STARFRUIT, US << MARKET, 5053, 1, 364300)","{""AMETHYSTS"": -16, ""STARFRUIT"": 19}",2142,5054,10000
364400,9998,76114,"(AMETHYSTS, MARKET << US, 9998, 1, 364400)","{""AMETHYSTS"": -17, ""STARFRUIT"": 19}",2151,5051,9996
365000,-20004,56110,"(AMETHYSTS, US << MARKET, 10002, 1, 365000)
(AMETHYSTS, US << MARKET, 10002, 1, 365000)
(AMETHYSTS, US << MARKET, 10002, 1, 365000)
(AMETHYSTS, US << MARKET, 10002, 1, 365000)
(AMETHYSTS, MARKET << US, 10002, 1, 365000)
(AMETHYSTS, MARKET << US, 10002, 1, 365000)","{""AMETHYSTS"": -15, ""STARFRUIT"": 19}",2034,5051,10003
365100,9998,66108,"(AMETHYSTS, MARKET << US, 9998, 1, 365100)","{""AMETHYSTS"": -16, ""STARFRUIT"": 19}",2023,5049,10001
365200,24959,91067,"(AMETHYSTS, MARKET << US, 10004, 1, 365200)
(AMETHYSTS, MARKET << US, 10004, 1, 365200)
(AMETHYSTS, MARKET << US, 10004, 1, 365200)
(STARFRUIT, US << MARKET, 5053, 1, 365200)","{""AMETHYSTS"": -19, ""STARFRUIT"": 20}",2087,5051,10000
365400,0,91067,,"{""AMETHYSTS"": -19, ""STARFRUIT"": 20}",2144,5051,9997
365600,25155,116222,"(AMETHYSTS, MARKET << US, 10004, 1, 365600)
(STARFRUIT, MARKET << US, 5052, 1, 365600)
(STARFRUIT, MARKET << US, 5052, 1, 365600)
(STARFRUIT, MARKET << US, 5047, 1, 365600)","{""AMETHYSTS"": -20, ""STARFRUIT"": 17}",2089,5051,10000
365900,0,116222,,"{""AMETHYSTS"": -20, ""STARFRUIT"": 17}",2072,5050,10000
366000,-15054,101168,"(AMETHYSTS, US << MARKET, 10002, 1, 366000)
(STARFRUIT, US << MARKET, 5052, 1, 366000)","{""AMETHYSTS"": -19, ""STARFRUIT"": 18}",1975,5048,10003
366100,45477,146645,"(STARFRUIT, MARKET << US, 5053, 1, 366100)
(STARFRUIT, MARKET << US, 5053, 1, 366100)
(STARFRUIT, MARKET << US, 5053, 1, 366100)
(STARFRUIT, MARKET << US, 5053, 1, 366100)
(STARFRUIT, MARKET << US, 5053, 1, 366100)
(STARFRUIT, MARKET << US, 5053, 1, 366100)
(STARFRUIT, MARKET << US, 5053, 1, 366100)
(STARFRUIT, MARKET << US, 5053, 1, 366100)
(STARFRUIT, MARKET << US, 5053, 1, 366100)","{""AMETHYSTS"": -19, ""STARFRUIT"": 9}",2086,5049,10000
366700,-5051,141594,"(STARFRUIT, US << MARKET, 5051, 1, 366700)","{""AMETHYSTS"": -19, ""STARFRUIT"": 10}",2104,5051,10000
367000,25240,166834,"(STARFRUIT, MARKET << US, 5048, 1, 367000)
(STARFRUIT, MARKET << US, 5048, 1, 367000)
(STARFRUIT, MARKET << US, 5048, 1, 367000)
(STARFRUIT, MARKET << US, 5048, 1, 367000)
(STARFRUIT, MARKET << US, 5048, 1, 367000)","{""AMETHYSTS"": -19, ""STARFRUIT"": 5}",2126,5047,9997
367400,-106,166728,"(AMETHYSTS, MARKET << US, 9998, 1, 367400)
(STARFRUIT, US << MARKET, 5052, 1, 367400)
(STARFRUIT, US << MARKET, 5052, 1, 367400)","{""AMETHYSTS"": -20, ""STARFRUIT"": 7}",2144,5048,9996
367700,-20212,146516,"(STARFRUIT, US << MARKET, 5053, 1, 367700)
(STARFRUIT, US << MARKET, 5053, 1, 367700)
(STARFRUIT, US << MARKET, 5053, 1, 367700)
(STARFRUIT, US << MARKET, 5053, 1, 367700)","{""AMETHYSTS"": -20, ""STARFRUIT"": 11}",2055,5049,10000
368000,0,146516,,"{""AMETHYSTS"": -20, ""STARFRUIT"": 11}",2075,5049,9999
368700,35334,181850,"(STARFRUIT, MARKET << US, 5048, 1, 368700)
(STARFRUIT, MARKET << US, 5048, 1, 368700)
(STARFRUIT, MARKET << US, 5048, 1, 368700)
(STARFRUIT, MARKET << US, 5048, 1, 368700)
(STARFRUIT, MARKET << US, 5048, 1, 368700)
(STARFRUIT, MARKET << US, 5047, 1, 368700)
(STARFRUIT, MARKET << US, 5047, 1, 368700)","{""AMETHYSTS"": -20, ""STARFRUIT"": 4}",1978,5047,10003
368900,0,181850,,"{""AMETHYSTS"": -20, ""STARFRUIT"": 4}",2114,5051,9997
369000,5048,186898,"(STARFRUIT, MARKET << US, 5048, 1, 369000)","{""AMETHYSTS"": -20, ""STARFRUIT"": 3}",2068,5050,9999
369100,0,186898,,"{""AMETHYSTS"": -20, ""STARFRUIT"": 3}",2108,5050,9997
369200,10106,197004,"(STARFRUIT, MARKET << US, 5053, 1, 369200)
(STARFRUIT, MARKET << US, 5053, 1, 369200)","{""AMETHYSTS"": -20, ""STARFRUIT"": 1}",2034,5050,10001
369600,0,197004,,"{""AMETHYSTS"": -20, ""STARFRUIT"": 1}",1992,5048,10003
369700,-4837,192167,"(AMETHYSTS, US << MARKET, 9998, 1, 369700)
(AMETHYSTS, US << MARKET, 9998, 1, 369700)
(STARFRUIT, MARKET << US, 5053, 1, 369700)
(STARFRUIT, MARKET << US, 5053, 1, 369700)
(STARFRUIT, MARKET << US, 5053, 1, 369700)","{""AMETHYSTS"": -18, ""STARFRUIT"": -2}",2123,5049,9997
369900,-20204,171963,"(STARFRUIT, US << MARKET, 5051, 1, 369900)
(STARFRUIT, US << MARKET, 5051, 1, 369900)
(STARFRUIT, US << MARKET, 5051, 1, 369900)
(STARFRUIT, US << MARKET, 5051, 1, 369900)","{""AMETHYSTS"": -18, ""STARFRUIT"": 2}",2067,5052,10000
370500,5047,177010,"(STARFRUIT, MARKET << US, 5047, 1, 370500)","{""AMETHYSTS"": -18, ""STARFRUIT"": 1}",2056,5046,10000
370900,35142,212152,"(AMETHYSTS, MARKET << US, 10002, 1, 370900)
(AMETHYSTS, MARKET << US, 10002, 1, 370900)
(STARFRUIT, MARKET << US, 5046, 1, 370900)
(STARFRUIT, MARKET << US, 5046, 1, 370900)
(STARFRUIT, MARKET << US, 5046, 1, 370900)","{""AMETHYSTS"": -20, ""STARFRUIT"": -2}",2074,5049,9999
371600,-34962,177190,"(AMETHYSTS, US << MARKET, 10002, 1, 371600)
(AMETHYSTS, US << MARKET, 10002, 1, 371600)
(AMETHYSTS, US << MARKET, 10002, 1, 371600)
(AMETHYSTS, US << MARKET, 10002, 1, 371600)
(STARFRUIT, MARKET << US, 5046, 1, 371600)","{""AMETHYSTS"": -16, ""STARFRUIT"": -3}",1995,5049,10003
372000,10092,187282,"(STARFRUIT, MARKET << US, 5046, 1, 372000)
(STARFRUIT, MARKET << US, 5046, 1, 372000)","{""AMETHYSTS"": -16, ""STARFRUIT"": -5}",2057,5045,10000
372700,20212,207494,"(STARFRUIT, MARKET << US, 5053, 1, 372700)
(STARFRUIT, MARKET << US, 5053, 1, 372700)
(STARFRUIT, MARKET << US, 5053, 1, 372700)
(STARFRUIT, MARKET << US, 5053, 1, 372700)","{""AMETHYSTS"": -16, ""STARFRUIT"": -9}",2005,5049,10003
372800,25055,232549,"(AMETHYSTS, MARKET << US, 10004, 1, 372800)
(AMETHYSTS, MARKET << US, 10004, 1, 372800)
(STARFRUIT, MARKET << US, 5047, 1, 372800)","{""AMETHYSTS"": -18, ""STARFRUIT"": -10}",2089,5046,10000
373200,9998,242547,"(AMETHYSTS, MARKET << US, 9998, 1, 373200)","{""AMETHYSTS"": -19, ""STARFRUIT"": -10}",1980,5051,10003
373600,-92,242455,"(AMETHYSTS, MARKET << US, 9998, 1, 373600)
(STARFRUIT, US << MARKET, 5045, 1, 373600)
(STARFRUIT, US << MARKET, 5045, 1, 373600)","{""AMETHYSTS"": -20, ""STARFRUIT"": -8}",2051,5048,10001
373800,0,242455,,"{""AMETHYSTS"": -20, ""STARFRUIT"": -8}",2095,5045,10000
373900,0,242455,,"{""AMETHYSTS"": -20, ""STARFRUIT"": -8}",2131,5048,9997
374700,-19996,222459,"(AMETHYSTS, US << MARKET, 9998, 1, 374700)
(AMETHYSTS, US << MARKET, 9998, 1, 374700)","{""AMETHYSTS"": -18, ""STARFRUIT"": -8}",2105,5051,9997
375400,-10094,212365,"(STARFRUIT, US << MARKET, 5047, 1, 375400)
(STARFRUIT, US << MARKET, 5047, 1, 375400)","{""AMETHYSTS"": -18, ""STARFRUIT"": -6}",2047,5050,10001
375500,-20200,192165,"(STARFRUIT, US << MARKET, 5050, 1, 375500)
(STARFRUIT, US << MARKET, 5050, 1, 375500)
(STARFRUIT, US << MARKET, 5050, 1, 375500)
(STARFRUIT, US << MARKET, 5050, 1, 375500)","{""AMETHYSTS"": -18, ""STARFRUIT"": -2}",2103,5049,9998
375700,-30288,161877,"(STARFRUIT, US << MARKET, 5048, 1, 375700)
(STARFRUIT, US << MARKET, 5048, 1, 375700)
(STARFRUIT, US << MARKET, 5048, 1, 375700)
(STARFRUIT, US << MARKET, 5048, 1, 375700)
(STARFRUIT, US << MARKET, 5048, 1, 375700)
(STARFRUIT, US << MARKET, 5048, 1, 375700)","{""AMETHYSTS"": -18, ""STARFRUIT"": 4}",2065,5047,10000
375900,9998,171875,"(AMETHYSTS, MARKET << US, 9998, 1, 375900)","{""AMETHYSTS"": -19, ""STARFRUIT"": 4}",2128,5049,9997
376000,-19996,151879,"(AMETHYSTS, US << MARKET, 9998, 1, 376000)
(AMETHYSTS, US << MARKET, 9998, 1, 376000)","{""AMETHYSTS"": -17, ""STARFRUIT"": 4}",2130,5050,9997
376100,-20004,131875,"(AMETHYSTS, US << MARKET, 10002, 1, 376100)
(AMETHYSTS, US << MARKET, 10002, 1, 376100)","{""AMETHYSTS"": -15, ""STARFRUIT"": 4}",2030,5050,10003
376400,-40114,91761,"(AMETHYSTS, US << MARKET, 10002, 1, 376400)
(AMETHYSTS, US << MARKET, 10002, 1, 376400)
(AMETHYSTS, US << MARKET, 10002, 1, 376400)
(STARFRUIT, US << MARKET, 5054, 1, 376400)
(STARFRUIT, US << MARKET, 5054, 1, 376400)","{""AMETHYSTS"": -12, ""STARFRUIT"": 6}",2061,5052,10001
376800,-30106,61655,"(AMETHYSTS, US << MARKET, 9998, 1, 376800)
(AMETHYSTS, US << MARKET, 9998, 1, 376800)
(STARFRUIT, US << MARKET, 5055, 1, 376800)
(STARFRUIT, US << MARKET, 5055, 1, 376800)","{""AMETHYSTS"": -10, ""STARFRUIT"": 8}",2093,5051,9997
377000,-19996,41659,"(AMETHYSTS, US << MARKET, 9998, 1, 377000)
(AMETHYSTS, US << MARKET, 9998, 1, 377000)","{""AMETHYSTS"": -8, ""STARFRUIT"": 8}",2059,5051,10001
377200,25157,66816,"(AMETHYSTS, MARKET << US, 9998, 1, 377200)
(STARFRUIT, MARKET << US, 5053, 1, 377200)
(STARFRUIT, MARKET << US, 5053, 1, 377200)
(STARFRUIT, MARKET << US, 5053, 1, 377200)","{""AMETHYSTS"": -9, ""STARFRUIT"": 5}",2057,5050,10001
377300,-15156,51660,"(STARFRUIT, US << MARKET, 5052, 1, 377300)
(STARFRUIT, US << MARKET, 5052, 1, 377300)
(STARFRUIT, US << MARKET, 5052, 1, 377300)
(STARFRUIT, US << MARKET, 5052, 1, 377300)
(STARFRUIT, MARKET << US, 5052, 1, 377300)","{""AMETHYSTS"": -9, ""STARFRUIT"": 8}",2102,5053,9998
377400,-4950,46710,"(AMETHYSTS, US << MARKET, 10004, 1, 377400)
(STARFRUIT, MARKET << US, 5054, 1, 377400)","{""AMETHYSTS"": -8, ""STARFRUIT"": 7}",2060,5050,10000
377600,40376,87086,"(STARFRUIT, MARKET << US, 5047, 1, 377600)
(STARFRUIT, MARKET << US, 5047, 1, 377600)
(STARFRUIT, MARKET << US, 5047, 1, 377600)
(STARFRUIT, MARKET << US, 5047, 1, 377600)
(STARFRUIT, MARKET << US, 5047, 1, 377600)
(STARFRUIT, MARKET << US, 5047, 1, 377600)
(STARFRUIT, MARKET << US, 5047, 1, 377600)
(STARFRUIT, MARKET << US, 5047, 1, 377600)","{""AMETHYSTS"": -8, ""STARFRUIT"": -1}",2036,5050,10000
378000,9998,97084,"(AMETHYSTS, MARKET << US, 9998, 1, 378000)","{""AMETHYSTS"": -9, ""STARFRUIT"": -1}",2061,5050,9997
378400,50010,147094,"(AMETHYSTS, US << MARKET, 10002, 1, 378400)
(AMETHYSTS, MARKET << US, 10002, 1, 378400)
(AMETHYSTS, MARKET << US, 10002, 1, 378400)
(AMETHYSTS, MARKET << US, 10002, 1, 378400)
(AMETHYSTS, MARKET << US, 10002, 1, 378400)
(AMETHYSTS, MARKET << US, 10002, 1, 378400)
(AMETHYSTS, MARKET << US, 10002, 1, 378400)","{""AMETHYSTS"": -14, ""STARFRUIT"": -1}",2060,5048,9999
378500,9898,156992,"(AMETHYSTS, MARKET << US, 10002, 1, 378500)
(AMETHYSTS, MARKET << US, 10002, 1, 378500)
(STARFRUIT, US << MARKET, 5053, 1, 378500)
(STARFRUIT, US << MARKET, 5053, 1, 378500)","{""AMETHYSTS"": -16, ""STARFRUIT"": 1}",1997,5053,10003
379100,-10108,146884,"(STARFRUIT, US << MARKET, 5054, 1, 379100)
(STARFRUIT, US << MARKET, 5054, 1, 379100)","{""AMETHYSTS"": -16, ""STARFRUIT"": 3}",2046,5054,10000
379400,10100,156984,"(STARFRUIT, MARKET << US, 5050, 1, 379400)
(STARFRUIT, MARKET << US, 5050, 1, 379400)","{""AMETHYSTS"": -16, ""STARFRUIT"": 1}",2033,5049,10000
379500,5054,162038,"(STARFRUIT, MARKET << US, 5054, 1, 379500)","{""AMETHYSTS"": -16, ""STARFRUIT"": 0}",2038,5054,10000
379600,-10096,151942,"(STARFRUIT, US << MARKET, 5048, 1, 379600)
(STARFRUIT, US << MARKET, 5048, 1, 379600)","{""AMETHYSTS"": -16, ""STARFRUIT"": 2}",2036,5047,10000
379800,5048,156990,"(STARFRUIT, MARKET << US, 5048, 1, 379800)","{""AMETHYSTS"": -16, ""STARFRUIT"": 1}",2038,5048,10000
380200,5054,162044,"(STARFRUIT, MARKET << US, 5054, 1, 380200)","{""AMETHYSTS"": -16, ""STARFRUIT"": 0}",2044,5054,10000
380900,-10098,151946,"(STARFRUIT, US << MARKET, 5049, 1, 380900)
(STARFRUIT, US << MARKET, 5049, 1, 380900)","{""AMETHYSTS"": -16, ""STARFRUIT"": 2}",2042,5048,10000
381100,29910,181856,"(AMETHYSTS, MARKET << US, 10002, 1, 381100)
(AMETHYSTS, MARKET << US, 10002, 1, 381100)
(AMETHYSTS, MARKET << US, 10002, 1, 381100)
(AMETHYSTS, MARKET << US, 10002, 1, 381100)
(STARFRUIT, US << MARKET, 5049, 1, 381100)
(STARFRUIT, US << MARKET, 5049, 1, 381100)","{""AMETHYSTS"": -20, ""STARFRUIT"": 4}",2084,5052,9999
381300,5056,186912,"(STARFRUIT, MARKET << US, 5056, 1, 381300)","{""AMETHYSTS"": -20, ""STARFRUIT"": 3}",2068,5052,10000
381500,5055,191967,"(STARFRUIT, MARKET << US, 5055, 1, 381500)","{""AMETHYSTS"": -20, ""STARFRUIT"": 2}",2097,5055,9999
381700,5051,197018,"(STARFRUIT, MARKET << US, 5051, 1, 381700)","{""AMETHYSTS"": -20, ""STARFRUIT"": 1}",2128,5050,9997
381800,10110,207128,"(STARFRUIT, MARKET << US, 5055, 1, 381800)
(STARFRUIT, MARKET << US, 5055, 1, 381800)","{""AMETHYSTS"": -20, ""STARFRUIT"": -1}",2076,5052,10000
381900,10100,217228,"(STARFRUIT, MARKET << US, 5050, 1, 381900)
(STARFRUIT, MARKET << US, 5050, 1, 381900)","{""AMETHYSTS"": -20, ""STARFRUIT"": -3}",2069,5053,10000
382000,-10110,207118,"(STARFRUIT, US << MARKET, 5055, 1, 382000)
(STARFRUIT, US << MARKET, 5055, 1, 382000)","{""AMETHYSTS"": -20, ""STARFRUIT"": -1}",2066,5052,10000
382200,-59970,147148,"(AMETHYSTS, US << MARKET, 9995, 1, 382200)
(AMETHYSTS, US << MARKET, 9995, 1, 382200)
(AMETHYSTS, US << MARKET, 9995, 1, 382200)
(AMETHYSTS, US << MARKET, 9995, 1, 382200)
(AMETHYSTS, US << MARKET, 9995, 1, 382200)
(AMETHYSTS, US << MARKET, 9995, 1, 382200)","{""AMETHYSTS"": -14, ""STARFRUIT"": -1}",2095,5053,10000
382500,-19996,127152,"(AMETHYSTS, US << MARKET, 9998, 1, 382500)
(AMETHYSTS, US << MARKET, 9998, 1, 382500)","{""AMETHYSTS"": -12, ""STARFRUIT"": -1}",2147,5053,9996
383000,-30300,96852,"(STARFRUIT, US << MARKET, 5050, 1, 383000)
(STARFRUIT, US << MARKET, 5050, 1, 383000)
(STARFRUIT, US << MARKET, 5050, 1, 383000)
(STARFRUIT, US << MARKET, 5050, 1, 383000)
(STARFRUIT, US << MARKET, 5050, 1, 383000)
(STARFRUIT, US << MARKET, 5050, 1, 383000)","{""AMETHYSTS"": -12, ""STARFRUIT"": 5}",2117,5053,10000
383400,-15162,81690,"(STARFRUIT, US << MARKET, 5054, 1, 383400)
(STARFRUIT, US << MARKET, 5054, 1, 383400)
(STARFRUIT, US << MARKET, 5054, 1, 383400)","{""AMETHYSTS"": -12, ""STARFRUIT"": 8}",2130,5055,10000
383600,5055,86745,"(STARFRUIT, MARKET << US, 5055, 1, 383600)","{""AMETHYSTS"": -12, ""STARFRUIT"": 7}",2161,5056,9998
383900,9872,96617,"(AMETHYSTS, US << MARKET, 10004, 1, 383900)
(AMETHYSTS, US << MARKET, 10004, 1, 383900)
(AMETHYSTS, MARKET << US, 9998, 1, 383900)
(AMETHYSTS, MARKET << US, 9998, 1, 383900)
(AMETHYSTS, MARKET << US, 9998, 1, 383900)
(AMETHYSTS, MARKET << US, 9998, 1, 383900)
(STARFRUIT, US << MARKET, 5056, 1, 383900)
(STARFRUIT, US << MARKET, 5056, 1, 383900)","{""AMETHYSTS"": -14, ""STARFRUIT"": 9}",2071,5052,10001
384000,-20196,76421,"(STARFRUIT, US << MARKET, 5049, 1, 384000)
(STARFRUIT, US << MARKET, 5049, 1, 384000)
(STARFRUIT, US << MARKET, 5049, 1, 384000)
(STARFRUIT, US << MARKET, 5049, 1, 384000)","{""AMETHYSTS"": -14, ""STARFRUIT"": 13}",2097,5052,10000
384200,-20192,56229,"(STARFRUIT, US << MARKET, 5048, 1, 384200)
(STARFRUIT, US << MARKET, 5048, 1, 384200)
(STARFRUIT, US << MARKET, 5048, 1, 384200)
(STARFRUIT, US << MARKET, 5048, 1, 384200)","{""AMETHYSTS"": -14, ""STARFRUIT"": 17}",2096,5051,10000
384600,-15060,41169,"(AMETHYSTS, US << MARKET, 10005, 1, 384600)
(STARFRUIT, US << MARKET, 5055, 1, 384600)","{""AMETHYSTS"": -13, ""STARFRUIT"": 18}",2105,5052,10000
384900,9998,51167,"(AMETHYSTS, MARKET << US, 9998, 1, 384900)","{""AMETHYSTS"": -14, ""STARFRUIT"": 18}",2085,5051,10000
385000,-25038,26129,"(AMETHYSTS, US << MARKET, 9995, 1, 385000)
(AMETHYSTS, US << MARKET, 9995, 1, 385000)
(STARFRUIT, US << MARKET, 5048, 1, 385000)","{""AMETHYSTS"": -12, ""STARFRUIT"": 19}",2098,5051,10000
385300,35047,61176,"(AMETHYSTS, MARKET << US, 10002, 1, 385300)
(AMETHYSTS, MARKET << US, 10002, 1, 385300)
(AMETHYSTS, MARKET << US, 9995, 1, 385300)
(STARFRUIT, MARKET << US, 5048, 1, 385300)","{""AMETHYSTS"": -15, ""STARFRUIT"": 18}",2124,5051,9998
385600,-5054,56122,"(STARFRUIT, US << MARKET, 5054, 1, 385600)","{""AMETHYSTS"": -15, ""STARFRUIT"": 19}",2148,5054,10000
385800,-5055,51067,"(STARFRUIT, US << MARKET, 5055, 1, 385800)","{""AMETHYSTS"": -15, ""STARFRUIT"": 20}",2167,5055,10000
385900,-10002,41065,"(AMETHYSTS, US << MARKET, 10002, 1, 385900)","{""AMETHYSTS"": -14, ""STARFRUIT"": 20}",2063,5052,10003
386100,45274,86339,"(AMETHYSTS, MARKET << US, 10002, 1, 386100)
(AMETHYSTS, MARKET << US, 10002, 1, 386100)
(STARFRUIT, MARKET << US, 5054, 1, 386100)
(STARFRUIT, MARKET << US, 5054, 1, 386100)
(STARFRUIT, MARKET << US, 5054, 1, 386100)
(STARFRUIT, MARKET << US, 5054, 1, 386100)
(STARFRUIT, MARKET << US, 5054, 1, 386100)","{""AMETHYSTS"": -16, ""STARFRUIT"": 15}",2116,5055,10003
386200,-30120,56219,"(AMETHYSTS, US << MARKET, 10004, 1, 386200)
(AMETHYSTS, US << MARKET, 10004, 1, 386200)
(STARFRUIT, US << MARKET, 5056, 1, 386200)
(STARFRUIT, US << MARKET, 5056, 1, 386200)","{""AMETHYSTS"": -14, ""STARFRUIT"": 17}",2078,5053,10003
386300,5055,61274,"(STARFRUIT, MARKET << US, 5055, 1, 386300)","{""AMETHYSTS"": -14, ""STARFRUIT"": 16}",2134,5052,9998
386400,40008,101282,"(AMETHYSTS, MARKET << US, 10002, 1, 386400)
(AMETHYSTS, MARKET << US, 10002, 1, 386400)
(AMETHYSTS, MARKET << US, 10002, 1, 386400)
(AMETHYSTS, MARKET << US, 10002, 1, 386400)","{""AMETHYSTS"": -18, ""STARFRUIT"": 16}",2060,5052,10003
386600,-39992,61290,"(AMETHYSTS, US << MARKET, 9998, 1, 386600)
(AMETHYSTS, US << MARKET, 9998, 1, 386600)
(AMETHYSTS, US << MARKET, 9998, 1, 386600)
(AMETHYSTS, US << MARKET, 9998, 1, 386600)","{""AMETHYSTS"": -14, ""STARFRUIT"": 16}",2164,5052,9997
386700,-9896,51394,"(AMETHYSTS, US << MARKET, 10004, 1, 386700)
(AMETHYSTS, US << MARKET, 10004, 1, 386700)
(STARFRUIT, MARKET << US, 5056, 1, 386700)
(STARFRUIT, MARKET << US, 5056, 1, 386700)","{""AMETHYSTS"": -12, ""STARFRUIT"": 14}",2100,5053,10003
386800,-40008,11386,"(AMETHYSTS, US << MARKET, 10002, 1, 386800)
(AMETHYSTS, US << MARKET, 10002, 1, 386800)
(AMETHYSTS, US << MARKET, 10002, 1, 386800)
(AMETHYSTS, US << MARKET, 10002, 1, 386800)","{""AMETHYSTS"": -8, ""STARFRUIT"": 14}",2104,5053,10003
387700,-5056,6330,"(STARFRUIT, US << MARKET, 5056, 1, 387700)","{""AMETHYSTS"": -8, ""STARFRUIT"": 15}",2125,5053,10000
387900,-5057,1273,"(STARFRUIT, US << MARKET, 5057, 1, 387900)","{""AMETHYSTS"": -8, ""STARFRUIT"": 16}",2177,5057,10001
388000,19996,21269,"(AMETHYSTS, MARKET << US, 9998, 1, 388000)
(AMETHYSTS, MARKET << US, 9998, 1, 388000)","{""AMETHYSTS"": -10, ""STARFRUIT"": 16}",2147,5053,9997
388200,-20228,1041,"(STARFRUIT, US << MARKET, 5057, 1, 388200)
(STARFRUIT, US << MARKET, 5057, 1, 388200)
(STARFRUIT, US << MARKET, 5057, 1, 388200)
(STARFRUIT, US << MARKET, 5057, 1, 388200)","{""AMETHYSTS"": -10, ""STARFRUIT"": 20}",2201,5058,10000
388700,50540,51581,"(STARFRUIT, MARKET << US, 5054, 1, 388700)
(STARFRUIT, MARKET << US, 5054, 1, 388700)
(STARFRUIT, MARKET << US, 5054, 1, 388700)
(STARFRUIT, MARKET << US, 5054, 1, 388700)
(STARFRUIT, MARKET << US, 5054, 1, 388700)
(STARFRUIT, MARKET << US, 5054, 1, 388700)
(STARFRUIT, MARKET << US, 5054, 1, 388700)
(STARFRUIT, MARKET << US, 5054, 1, 388700)
(STARFRUIT, MARKET << US, 5054, 1, 388700)
(STARFRUIT, MARKET << US, 5054, 1, 388700)","{""AMETHYSTS"": -10, ""STARFRUIT"": 10}",2141,5056,10000
389000,-15064,36517,"(AMETHYSTS, US << MARKET, 10004, 1, 389000)
(STARFRUIT, US << MARKET, 5060, 1, 389000)","{""AMETHYSTS"": -9, ""STARFRUIT"": 11}",2135,5057,10001
389200,-5059,31458,"(STARFRUIT, US << MARKET, 5059, 1, 389200)","{""AMETHYSTS"": -9, ""STARFRUIT"": 12}",2196,5060,9998
389300,99960,131418,"(AMETHYSTS, MARKET << US, 9996, 1, 389300)
(AMETHYSTS, MARKET << US, 9996, 1, 389300)
(AMETHYSTS, MARKET << US, 9996, 1, 389300)
(AMETHYSTS, MARKET << US, 9996, 1, 389300)
(AMETHYSTS, MARKET << US, 9996, 1, 389300)
(AMETHYSTS, MARKET << US, 9996, 1, 389300)
(AMETHYSTS, MARKET << US, 9996, 1, 389300)
(AMETHYSTS, MARKET << US, 9996, 1, 389300)
(AMETHYSTS, MARKET << US, 9996, 1, 389300)
(AMETHYSTS, MARKET << US, 9996, 1, 389300)","{""AMETHYSTS"": -19, ""STARFRUIT"": 12}",2102,5057,10000
389400,-5194,126224,"(AMETHYSTS, MARKET << US, 9995, 1, 389400)
(STARFRUIT, US << MARKET, 5061, 1, 389400)
(STARFRUIT, US << MARKET, 5061, 1, 389400)
(STARFRUIT, US << MARKET, 5061, 1, 389400)
(STARFRUIT, US << MARKET, 5061, 1, 389400)
(STARFRUIT, MARKET << US, 5055, 1, 389400)","{""AMETHYSTS"": -20, ""STARFRUIT"": 15}",2094,5058,10000
389700,15168,141392,"(STARFRUIT, MARKET << US, 5056, 1, 389700)
(STARFRUIT, MARKET << US, 5056, 1, 389700)
(STARFRUIT, MARKET << US, 5056, 1, 389700)","{""AMETHYSTS"": -20, ""STARFRUIT"": 12}",2052,5055,10000
389900,-10002,131390,"(AMETHYSTS, US << MARKET, 10002, 1, 389900)","{""AMETHYSTS"": -19, ""STARFRUIT"": 12}",2029,5058,10003
390200,-4943,126447,"(AMETHYSTS, US << MARKET, 10004, 1, 390200)
(STARFRUIT, MARKET << US, 5061, 1, 390200)","{""AMETHYSTS"": -18, ""STARFRUIT"": 11}",2107,5060,10000
390400,-20228,106219,"(STARFRUIT, US << MARKET, 5057, 1, 390400)
(STARFRUIT, US << MARKET, 5057, 1, 390400)
(STARFRUIT, US << MARKET, 5057, 1, 390400)
(STARFRUIT, US << MARKET, 5057, 1, 390400)","{""AMETHYSTS"": -18, ""STARFRUIT"": 15}",2077,5056,9999
390600,-19996,86223,"(AMETHYSTS, US << MARKET, 9998, 1, 390600)
(AMETHYSTS, US << MARKET, 9998, 1, 390600)","{""AMETHYSTS"": -16, ""STARFRUIT"": 15}",2062,5057,10001
391200,15165,101388,"(STARFRUIT, MARKET << US, 5055, 1, 391200)
(STARFRUIT, MARKET << US, 5055, 1, 391200)
(STARFRUIT, MARKET << US, 5055, 1, 391200)","{""AMETHYSTS"": -16, ""STARFRUIT"": 12}",2036,5054,10000
391500,45073,146461,"(AMETHYSTS, MARKET << US, 10005, 1, 391500)
(AMETHYSTS, MARKET << US, 10005, 1, 391500)
(AMETHYSTS, MARKET << US, 10005, 1, 391500)
(AMETHYSTS, MARKET << US, 10005, 1, 391500)
(STARFRUIT, MARKET << US, 5053, 1, 391500)","{""AMETHYSTS"": -20, ""STARFRUIT"": 11}",2077,5056,10000
392000,-9884,136577,"(AMETHYSTS, US << MARKET, 9996, 1, 392000)
(AMETHYSTS, US << MARKET, 9996, 1, 392000)
(STARFRUIT, MARKET << US, 5054, 1, 392000)
(STARFRUIT, MARKET << US, 5054, 1, 392000)","{""AMETHYSTS"": -18, ""STARFRUIT"": 9}",2090,5057,10000
392200,10106,146683,"(STARFRUIT, MARKET << US, 5053, 1, 392200)
(STARFRUIT, MARKET << US, 5053, 1, 392200)","{""AMETHYSTS"": -18, ""STARFRUIT"": 7}",2050,5055,10001
392300,40464,187147,"(STARFRUIT, MARKET << US, 5058, 1, 392300)
(STARFRUIT, MARKET << US, 5058, 1, 392300)
(STARFRUIT, MARKET << US, 5058, 1, 392300)
(STARFRUIT, MARKET << US, 5058, 1, 392300)
(STARFRUIT, MARKET << US, 5058, 1, 392300)
(STARFRUIT, MARKET << US, 5058, 1, 392300)
(STARFRUIT, MARKET << US, 5058, 1, 392300)
(STARFRUIT, MARKET << US, 5058, 1, 392300)","{""AMETHYSTS"": -18, ""STARFRUIT"": -1}",2088,5059,10000
392800,-228,186919,"(AMETHYSTS, MARKET << US, 10004, 1, 392800)
(AMETHYSTS, MARKET << US, 10004, 1, 392800)
(STARFRUIT, US << MARKET, 5059, 1, 392800)
(STARFRUIT, US << MARKET, 5059, 1, 392800)
(STARFRUIT, US << MARKET, 5059, 1, 392800)
(STARFRUIT, US << MARKET, 5059, 1, 392800)","{""AMETHYSTS"": -20, ""STARFRUIT"": 3}",2087,5056,10000
393000,0,186919,,"{""AMETHYSTS"": -20, ""STARFRUIT"": 3}",2147,5056,9997
393300,-20232,166687,"(STARFRUIT, US << MARKET, 5058, 1, 393300)
(STARFRUIT, US << MARKET, 5058, 1, 393300)
(STARFRUIT, US << MARKET, 5058, 1, 393300)
(STARFRUIT, US << MARKET, 5058, 1, 393300)","{""AMETHYSTS"": -20, ""STARFRUIT"": 7}",2120,5059,9999
393700,-15180,151507,"(STARFRUIT, US << MARKET, 5060, 1, 393700)
(STARFRUIT, US << MARKET, 5060, 1, 393700)
(STARFRUIT, US << MARKET, 5060, 1, 393700)
(STARFRUIT, US << MARKET, 5060, 1, 393700)
(STARFRUIT, MARKET << US, 5060, 1, 393700)","{""AMETHYSTS"": -20, ""STARFRUIT"": 10}",2077,5057,10000
393800,-30102,121405,"(AMETHYSTS, US << MARKET, 9998, 1, 393800)
(AMETHYSTS, US << MARKET, 9998, 1, 393800)
(STARFRUIT, US << MARKET, 5053, 1, 393800)
(STARFRUIT, US << MARKET, 5053, 1, 393800)","{""AMETHYSTS"": -18, ""STARFRUIT"": 12}",2119,5055,9997
394100,-210080,-88675,"(AMETHYSTS, US << MARKET, 9998, 1, 394100)
(AMETHYSTS, US << MARKET, 9998, 1, 394100)
(AMETHYSTS, US << MARKET, 9998, 1, 394100)
(AMETHYSTS, US << MARKET, 9998, 1, 394100)
(AMETHYSTS, US << MARKET, 9998, 1, 394100)
(AMETHYSTS, US << MARKET, 9998, 1, 394100)
(AMETHYSTS, US << MARKET, 9998, 1, 394100)
(AMETHYSTS, US << MARKET, 9998, 1, 394100)
(AMETHYSTS, US << MARKET, 9998, 1, 394100)
(AMETHYSTS, US << MARKET, 9998, 1, 394100)
(AMETHYSTS, US << MARKET, 9998, 1, 394100)
(AMETHYSTS, US << MARKET, 9998, 1, 394100)
(AMETHYSTS, US << MARKET, 9998, 1, 394100)
(AMETHYSTS, US << MARKET, 9998, 1, 394100)
(AMETHYSTS, US << MARKET, 9998, 1, 394100)
(AMETHYSTS, US << MARKET, 9998, 1, 394100)
(AMETHYSTS, US << MARKET, 9998, 1, 394100)
(AMETHYSTS, US << MARKET, 9998, 1, 394100)
(AMETHYSTS, US << MARKET, 9998, 1, 394100)
(AMETHYSTS, US << MARKET, 9998, 1, 394100)
(STARFRUIT, US << MARKET, 5060, 1, 394100)
(STARFRUIT, US << MARKET, 5060, 1, 394100)","{""AMETHYSTS"": 2, ""STARFRUIT"": 14}",2103,5056,9997
394200,-25049,-113724,"(AMETHYSTS, US << MARKET, 9998, 1, 394200)
(AMETHYSTS, US << MARKET, 9998, 1, 394200)
(STARFRUIT, US << MARKET, 5053, 1, 394200)","{""AMETHYSTS"": 4, ""STARFRUIT"": 15}",2104,5056,9997
394300,25068,-88656,"(AMETHYSTS, MARKET << US, 10004, 1, 394300)
(AMETHYSTS, MARKET << US, 10004, 1, 394300)
(STARFRUIT, MARKET << US, 5060, 1, 394300)","{""AMETHYSTS"": 2, ""STARFRUIT"": 14}",2128,5056,10000
394600,25043,-63613,"(AMETHYSTS, MARKET << US, 9995, 1, 394600)
(AMETHYSTS, MARKET << US, 9995, 1, 394600)
(STARFRUIT, MARKET << US, 5053, 1, 394600)","{""AMETHYSTS"": 0, ""STARFRUIT"": 13}",2063,5052,10000
395300,-99980,-163593,"(AMETHYSTS, US << MARKET, 9998, 1, 395300)
(AMETHYSTS, US << MARKET, 9998, 1, 395300)
(AMETHYSTS, US << MARKET, 9998, 1, 395300)
(AMETHYSTS, US << MARKET, 9998, 1, 395300)
(AMETHYSTS, US << MARKET, 9998, 1, 395300)
(AMETHYSTS, US << MARKET, 9998, 1, 395300)
(AMETHYSTS, US << MARKET, 9998, 1, 395300)
(AMETHYSTS, US << MARKET, 9998, 1, 395300)
(AMETHYSTS, US << MARKET, 9998, 1, 395300)
(AMETHYSTS, US << MARKET, 9998, 1, 395300)","{""AMETHYSTS"": 10, ""STARFRUIT"": 13}",2069,5054,9996
395400,-20232,-183825,"(STARFRUIT, US << MARKET, 5058, 1, 395400)
(STARFRUIT, US << MARKET, 5058, 1, 395400)
(STARFRUIT, US << MARKET, 5058, 1, 395400)
(STARFRUIT, US << MARKET, 5058, 1, 395400)","{""AMETHYSTS"": 10, ""STARFRUIT"": 17}",2093,5054,10000
395600,-25049,-208874,"(AMETHYSTS, US << MARKET, 9998, 1, 395600)
(AMETHYSTS, US << MARKET, 9998, 1, 395600)
(STARFRUIT, US << MARKET, 5053, 1, 395600)","{""AMETHYSTS"": 12, ""STARFRUIT"": 18}",2146,5056,10001
395800,45531,-163343,"(STARFRUIT, MARKET << US, 5059, 1, 395800)
(STARFRUIT, MARKET << US, 5059, 1, 395800)
(STARFRUIT, MARKET << US, 5059, 1, 395800)
(STARFRUIT, MARKET << US, 5059, 1, 395800)
(STARFRUIT, MARKET << US, 5059, 1, 395800)
(STARFRUIT, MARKET << US, 5059, 1, 395800)
(STARFRUIT, MARKET << US, 5059, 1, 395800)
(STARFRUIT, MARKET << US, 5059, 1, 395800)
(STARFRUIT, MARKET << US, 5059, 1, 395800)","{""AMETHYSTS"": 12, ""STARFRUIT"": 9}",2152,5055,10000
396100,-39992,-203335,"(AMETHYSTS, US << MARKET, 9998, 1, 396100)
(AMETHYSTS, US << MARKET, 9998, 1, 396100)
(AMETHYSTS, US << MARKET, 9998, 1, 396100)
(AMETHYSTS, US << MARKET, 9998, 1, 396100)","{""AMETHYSTS"": 16, ""STARFRUIT"": 9}",2169,5056,10000
396200,155027,-48308,"(AMETHYSTS, MARKET << US, 10005, 1, 396200)
(AMETHYSTS, MARKET << US, 10005, 1, 396200)
(AMETHYSTS, MARKET << US, 10005, 1, 396200)
(AMETHYSTS, MARKET << US, 10005, 1, 396200)
(AMETHYSTS, MARKET << US, 10005, 1, 396200)
(AMETHYSTS, MARKET << US, 10005, 1, 396200)
(AMETHYSTS, MARKET << US, 10005, 1, 396200)
(AMETHYSTS, MARKET << US, 10005, 1, 396200)
(AMETHYSTS, MARKET << US, 10005, 1, 396200)
(AMETHYSTS, MARKET << US, 10005, 1, 396200)
(AMETHYSTS, MARKET << US, 10005, 1, 396200)
(AMETHYSTS, MARKET << US, 10005, 1, 396200)
(AMETHYSTS, MARKET << US, 10005, 1, 396200)
(AMETHYSTS, MARKET << US, 10005, 1, 396200)
(AMETHYSTS, MARKET << US, 10005, 1, 396200)
(AMETHYSTS, MARKET << US, 10005, 1, 396200)
(STARFRUIT, US << MARKET, 5053, 1, 396200)","{""AMETHYSTS"": 0, ""STARFRUIT"": 10}",2252,5056,10000
396300,20004,-28304,"(AMETHYSTS, MARKET << US, 10002, 1, 396300)
(AMETHYSTS, MARKET << US, 10002, 1, 396300)","{""AMETHYSTS"": -2, ""STARFRUIT"": 10}",2240,5055,10003
397000,9886,-18418,"(AMETHYSTS, MARKET << US, 10004, 1, 397000)
(AMETHYSTS, MARKET << US, 10004, 1, 397000)
(STARFRUIT, US << MARKET, 5061, 1, 397000)
(STARFRUIT, US << MARKET, 5061, 1, 397000)","{""AMETHYSTS"": -4, ""STARFRUIT"": 12}",2278,5058,10000
397300,-10002,-28420,"(AMETHYSTS, US << MARKET, 10002, 1, 397300)","{""AMETHYSTS"": -3, ""STARFRUIT"": 12}",2255,5056,9999
397600,-29872,-58292,"(AMETHYSTS, US << MARKET, 9995, 1, 397600)
(AMETHYSTS, US << MARKET, 9995, 1, 397600)
(AMETHYSTS, US << MARKET, 9995, 1, 397600)
(AMETHYSTS, US << MARKET, 9995, 1, 397600)
(STARFRUIT, MARKET << US, 5054, 1, 397600)
(STARFRUIT, MARKET << US, 5054, 1, 397600)","{""AMETHYSTS"": 1, ""STARFRUIT"": 10}",2278,5057,10000
397700,45046,-13246,"(AMETHYSTS, MARKET << US, 9998, 1, 397700)
(AMETHYSTS, MARKET << US, 9998, 1, 397700)
(AMETHYSTS, MARKET << US, 9998, 1, 397700)
(AMETHYSTS, MARKET << US, 9998, 1, 397700)
(STARFRUIT, MARKET << US, 5054, 1, 397700)","{""AMETHYSTS"": -3, ""STARFRUIT"": 9}",2267,5056,9997
398000,150060,136814,"(AMETHYSTS, US << MARKET, 10004, 1, 398000)
(AMETHYSTS, MARKET << US, 10004, 1, 398000)
(AMETHYSTS, MARKET << US, 10004, 1, 398000)
(AMETHYSTS, MARKET << US, 10004, 1, 398000)
(AMETHYSTS, MARKET << US, 10004, 1, 398000)
(AMETHYSTS, MARKET << US, 10004, 1, 398000)
(AMETHYSTS, MARKET << US, 10004, 1, 398000)
(AMETHYSTS, MARKET << US, 10004, 1, 398000)
(AMETHYSTS, MARKET << US, 10004, 1, 398000)
(AMETHYSTS, MARKET << US, 10004, 1, 398000)
(AMETHYSTS, MARKET << US, 10004, 1, 398000)
(AMETHYSTS, MARKET << US, 10004, 1, 398000)
(AMETHYSTS, MARKET << US, 10004, 1, 398000)
(AMETHYSTS, MARKET << US, 10004, 1, 398000)
(AMETHYSTS, MARKET << US, 10004, 1, 398000)
(AMETHYSTS, MARKET << US, 10004, 1, 398000)
(AMETHYSTS, MARKET << US, 10004, 1, 398000)","{""AMETHYSTS"": -18, ""STARFRUIT"": 9}",2327,5057,10000
398400,-19996,116818,"(AMETHYSTS, US << MARKET, 9998, 1, 398400)
(AMETHYSTS, US << MARKET, 9998, 1, 398400)","{""AMETHYSTS"": -16, ""STARFRUIT"": 9}",2395,5057,9996
398700,5054,121872,"(STARFRUIT, MARKET << US, 5054, 1, 398700)","{""AMETHYSTS"": -16, ""STARFRUIT"": 8}",2344,5057,9999
399000,-5059,116813,"(STARFRUIT, US << MARKET, 5059, 1, 399000)","{""AMETHYSTS"": -16, ""STARFRUIT"": 9}",2301,5056,10001
399100,5054,121867,"(STARFRUIT, MARKET << US, 5054, 1, 399100)","{""AMETHYSTS"": -16, ""STARFRUIT"": 8}",2315,5056,10000
399900,-39984,81883,"(AMETHYSTS, US << MARKET, 9996, 1, 399900)
(AMETHYSTS, US << MARKET, 9996, 1, 399900)
(AMETHYSTS, US << MARKET, 9996, 1, 399900)
(AMETHYSTS, US << MARKET, 9996, 1, 399900)","{""AMETHYSTS"": -12, ""STARFRUIT"": 8}",2339,5057,10000
400000,5053,86936,"(STARFRUIT, MARKET << US, 5053, 1, 400000)","{""AMETHYSTS"": -12, ""STARFRUIT"": 7}",2311,5057,10002
400300,5053,91989,"(STARFRUIT, MARKET << US, 5053, 1, 400300)","{""AMETHYSTS"": -12, ""STARFRUIT"": 6}",2319,5055,10000
400700,5053,97042,"(STARFRUIT, MARKET << US, 5053, 1, 400700)","{""AMETHYSTS"": -12, ""STARFRUIT"": 5}",2329,5055,9999
400800,10116,107158,"(STARFRUIT, MARKET << US, 5058, 1, 400800)
(STARFRUIT, MARKET << US, 5058, 1, 400800)","{""AMETHYSTS"": -12, ""STARFRUIT"": 3}",2335,5059,10000
401100,40200,147358,"(AMETHYSTS, MARKET << US, 9996, 1, 401100)
(AMETHYSTS, MARKET << US, 9996, 1, 401100)
(STARFRUIT, MARKET << US, 5052, 1, 401100)
(STARFRUIT, MARKET << US, 5052, 1, 401100)
(STARFRUIT, MARKET << US, 5052, 1, 401100)
(STARFRUIT, MARKET << US, 5052, 1, 401100)","{""AMETHYSTS"": -14, ""STARFRUIT"": -1}",2303,5055,10000
401300,10106,157464,"(STARFRUIT, MARKET << US, 5053, 1, 401300)
(STARFRUIT, MARKET << US, 5053, 1, 401300)","{""AMETHYSTS"": -14, ""STARFRUIT"": -3}",2355,5055,9996
402400,-10002,147462,"(AMETHYSTS, US << MARKET, 10002, 1, 402400)","{""AMETHYSTS"": -13, ""STARFRUIT"": -3}",2304,5057,9999
402600,5060,152522,"(STARFRUIT, MARKET << US, 5060, 1, 402600)","{""AMETHYSTS"": -13, ""STARFRUIT"": -4}",2269,5060,10001
403400,-10002,142520,"(AMETHYSTS, US << MARKET, 10002, 1, 403400)","{""AMETHYSTS"": -12, ""STARFRUIT"": -4}",2336,5055,9997
403600,70014,212534,"(AMETHYSTS, MARKET << US, 10002, 1, 403600)
(AMETHYSTS, MARKET << US, 10002, 1, 403600)
(AMETHYSTS, MARKET << US, 10002, 1, 403600)
(AMETHYSTS, MARKET << US, 10002, 1, 403600)
(AMETHYSTS, MARKET << US, 10002, 1, 403600)
(AMETHYSTS, MARKET << US, 10002, 1, 403600)
(AMETHYSTS, MARKET << US, 10002, 1, 403600)","{""AMETHYSTS"": -19, ""STARFRUIT"": -4}",2237,5060,10003
404300,-10120,202414,"(STARFRUIT, US << MARKET, 5060, 1, 404300)
(STARFRUIT, US << MARKET, 5060, 1, 404300)","{""AMETHYSTS"": -19, ""STARFRUIT"": -2}",2294,5060,10000
404400,-10108,192306,"(STARFRUIT, US << MARKET, 5054, 1, 404400)
(STARFRUIT, US << MARKET, 5054, 1, 404400)","{""AMETHYSTS"": -19, ""STARFRUIT"": 0}",2306,5057,10000
404500,20127,212433,"(AMETHYSTS, MARKET << US, 10005, 1, 404500)
(STARFRUIT, MARKET << US, 5061, 1, 404500)
(STARFRUIT, MARKET << US, 5061, 1, 404500)","{""AMETHYSTS"": -20, ""STARFRUIT"": -2}",2319,5057,10000
404700,-70350,142083,"(AMETHYSTS, US << MARKET, 9996, 1, 404700)
(AMETHYSTS, US << MARKET, 9996, 1, 404700)
(AMETHYSTS, US << MARKET, 9996, 1, 404700)
(AMETHYSTS, US << MARKET, 9996, 1, 404700)
(STARFRUIT, US << MARKET, 5061, 1, 404700)
(STARFRUIT, US << MARKET, 5061, 1, 404700)
(STARFRUIT, US << MARKET, 5061, 1, 404700)
(STARFRUIT, US << MARKET, 5061, 1, 404700)
(STARFRUIT, US << MARKET, 5061, 1, 404700)
(STARFRUIT, US << MARKET, 5061, 1, 404700)","{""AMETHYSTS"": -16, ""STARFRUIT"": 4}",2359,5057,9997
404800,-199900,-57817,"(AMETHYSTS, US << MARKET, 9995, 1, 404800)
(AMETHYSTS, US << MARKET, 9995, 1, 404800)
(AMETHYSTS, US << MARKET, 9995, 1, 404800)
(AMETHYSTS, US << MARKET, 9995, 1, 404800)
(AMETHYSTS, US << MARKET, 9995, 1, 404800)
(AMETHYSTS, US << MARKET, 9995, 1, 404800)
(AMETHYSTS, US << MARKET, 9995, 1, 404800)
(AMETHYSTS, US << MARKET, 9995, 1, 404800)
(AMETHYSTS, US << MARKET, 9995, 1, 404800)
(AMETHYSTS, US << MARKET, 9995, 1, 404800)
(AMETHYSTS, US << MARKET, 9995, 1, 404800)
(AMETHYSTS, US << MARKET, 9995, 1, 404800)
(AMETHYSTS, US << MARKET, 9995, 1, 404800)
(AMETHYSTS, US << MARKET, 9995, 1, 404800)
(AMETHYSTS, US << MARKET, 9995, 1, 404800)
(AMETHYSTS, US << MARKET, 9995, 1, 404800)
(AMETHYSTS, US << MARKET, 9995, 1, 404800)
(AMETHYSTS, US << MARKET, 9995, 1, 404800)
(AMETHYSTS, US << MARKET, 9995, 1, 404800)
(AMETHYSTS, US << MARKET, 9995, 1, 404800)","{""AMETHYSTS"": 4, ""STARFRUIT"": 4}",2407,5056,10000
405000,-20122,-77939,"(AMETHYSTS, US << MARKET, 10002, 1, 405000)
(STARFRUIT, US << MARKET, 5060, 1, 405000)
(STARFRUIT, US << MARKET, 5060, 1, 405000)","{""AMETHYSTS"": 5, ""STARFRUIT"": 6}",2398,5057,9999
405300,-9998,-87937,"(AMETHYSTS, US << MARKET, 9998, 1, 405300)
(AMETHYSTS, US << MARKET, 9998, 1, 405300)
(AMETHYSTS, MARKET << US, 9998, 1, 405300)","{""AMETHYSTS"": 6, ""STARFRUIT"": 6}",2405,5056,10001
405600,-90072,-178009,"(AMETHYSTS, US << MARKET, 9995, 1, 405600)
(AMETHYSTS, US << MARKET, 9995, 1, 405600)
(AMETHYSTS, US << MARKET, 9995, 1, 405600)
(AMETHYSTS, US << MARKET, 9995, 1, 405600)
(AMETHYSTS, US << MARKET, 9996, 1, 405600)
(AMETHYSTS, US << MARKET, 9996, 1, 405600)
(AMETHYSTS, US << MARKET, 9996, 1, 405600)
(AMETHYSTS, US << MARKET, 9996, 1, 405600)
(AMETHYSTS, US << MARKET, 9996, 1, 405600)
(AMETHYSTS, US << MARKET, 9996, 1, 405600)
(AMETHYSTS, US << MARKET, 9996, 1, 405600)
(AMETHYSTS, US << MARKET, 9996, 1, 405600)
(AMETHYSTS, US << MARKET, 9995, 1, 405600)
(AMETHYSTS, MARKET << US, 9996, 1, 405600)
(AMETHYSTS, MARKET << US, 9996, 1, 405600)
(AMETHYSTS, MARKET << US, 9995, 1, 405600)
(AMETHYSTS, MARKET << US, 9995, 1, 405600)
(AMETHYSTS, MARKET << US, 9995, 1, 405600)
(STARFRUIT, US << MARKET, 5053, 1, 405600)
(STARFRUIT, US << MARKET, 5053, 1, 405600)","{""AMETHYSTS"": 14, ""STARFRUIT"": 8}",2431,5055,10000
407600,-5049,-183058,"(AMETHYSTS, US << MARKET, 10004, 1, 407600)
(AMETHYSTS, US << MARKET, 10004, 1, 407600)
(AMETHYSTS, MARKET << US, 10004, 1, 407600)
(AMETHYSTS, MARKET << US, 10004, 1, 407600)
(STARFRUIT, US << MARKET, 5049, 1, 407600)","{""AMETHYSTS"": 14, ""STARFRUIT"": 9}",2428,5054,10000
407700,60012,-123046,"(AMETHYSTS, MARKET << US, 10002, 1, 407700)
(AMETHYSTS, MARKET << US, 10002, 1, 407700)
(AMETHYSTS, MARKET << US, 10002, 1, 407700)
(AMETHYSTS, MARKET << US, 10002, 1, 407700)
(AMETHYSTS, MARKET << US, 10002, 1, 407700)
(AMETHYSTS, MARKET << US, 10002, 1, 407700)","{""AMETHYSTS"": 8, ""STARFRUIT"": 9}",2437,5051,10003
408200,135211,12165,"(AMETHYSTS, MARKET << US, 9996, 1, 408200)
(AMETHYSTS, MARKET << US, 9996, 1, 408200)
(AMETHYSTS, MARKET << US, 9996, 1, 408200)
(AMETHYSTS, MARKET << US, 9996, 1, 408200)
(AMETHYSTS, MARKET << US, 9996, 1, 408200)
(AMETHYSTS, MARKET << US, 9996, 1, 408200)
(AMETHYSTS, MARKET << US, 9996, 1, 408200)
(AMETHYSTS, MARKET << US, 9996, 1, 408200)
(AMETHYSTS, MARKET << US, 9996, 1, 408200)
(AMETHYSTS, MARKET << US, 9996, 1, 408200)
(AMETHYSTS, MARKET << US, 9996, 1, 408200)
(STARFRUIT, MARKET << US, 5051, 1, 408200)
(STARFRUIT, MARKET << US, 5051, 1, 408200)
(STARFRUIT, MARKET << US, 5051, 1, 408200)
(STARFRUIT, MARKET << US, 5051, 1, 408200)
(STARFRUIT, MARKET << US, 5051, 1, 408200)","{""AMETHYSTS"": -3, ""STARFRUIT"": 4}",2367,5049,9998
408400,30106,42271,"(AMETHYSTS, MARKET << US, 9998, 1, 408400)
(AMETHYSTS, MARKET << US, 9998, 1, 408400)
(STARFRUIT, MARKET << US, 5055, 1, 408400)
(STARFRUIT, MARKET << US, 5055, 1, 408400)","{""AMETHYSTS"": -5, ""STARFRUIT"": 2}",2393,5051,9996
408600,-4950,37321,"(AMETHYSTS, US << MARKET, 10004, 1, 408600)
(STARFRUIT, MARKET << US, 5054, 1, 408600)","{""AMETHYSTS"": -4, ""STARFRUIT"": 1}",2368,5051,10001
409000,-10002,27319,"(AMETHYSTS, US << MARKET, 10002, 1, 409000)","{""AMETHYSTS"": -3, ""STARFRUIT"": 1}",2360,5050,10003
409100,10104,37423,"(STARFRUIT, MARKET << US, 5052, 1, 409100)
(STARFRUIT, MARKET << US, 5052, 1, 409100)","{""AMETHYSTS"": -3, ""STARFRUIT"": -1}",2364,5053,10002
409400,35150,72573,"(AMETHYSTS, MARKET << US, 10000, 1, 409400)
(AMETHYSTS, MARKET << US, 10000, 1, 409400)
(STARFRUIT, MARKET << US, 5050, 1, 409400)
(STARFRUIT, MARKET << US, 5050, 1, 409400)
(STARFRUIT, MARKET << US, 5050, 1, 409400)","{""AMETHYSTS"": -5, ""STARFRUIT"": -4}",2391,5048,9998
410000,5048,77621,"(STARFRUIT, MARKET << US, 5048, 1, 410000)","{""AMETHYSTS"": -5, ""STARFRUIT"": -5}",2356,5052,10001
410100,-24848,52773,"(AMETHYSTS, US << MARKET, 9998, 1, 410100)
(AMETHYSTS, US << MARKET, 9998, 1, 410100)
(AMETHYSTS, US << MARKET, 9998, 1, 410100)
(AMETHYSTS, US << MARKET, 9998, 1, 410100)
(STARFRUIT, MARKET << US, 5048, 1, 410100)
(STARFRUIT, MARKET << US, 5048, 1, 410100)
(STARFRUIT, MARKET << US, 5048, 1, 410100)","{""AMETHYSTS"": -1, ""STARFRUIT"": -8}",2364,5051,10001
410200,-19996,32777,"(AMETHYSTS, US << MARKET, 9998, 1, 410200)
(AMETHYSTS, US << MARKET, 9998, 1, 410200)","{""AMETHYSTS"": 1, ""STARFRUIT"": -8}",2373,5050,9996
410400,-10094,22683,"(STARFRUIT, US << MARKET, 5047, 1, 410400)
(STARFRUIT, US << MARKET, 5047, 1, 410400)","{""AMETHYSTS"": 1, ""STARFRUIT"": -6}",2384,5050,10001
410800,-184,22499,"(AMETHYSTS, MARKET << US, 10002, 1, 410800)
(AMETHYSTS, MARKET << US, 10002, 1, 410800)
(STARFRUIT, US << MARKET, 5047, 1, 410800)
(STARFRUIT, US << MARKET, 5047, 1, 410800)
(STARFRUIT, US << MARKET, 5047, 1, 410800)
(STARFRUIT, US << MARKET, 5047, 1, 410800)","{""AMETHYSTS"": -1, ""STARFRUIT"": -2}",2398,5049,10003
411200,10096,32595,"(STARFRUIT, MARKET << US, 5048, 1, 411200)
(STARFRUIT, MARKET << US, 5048, 1, 411200)","{""AMETHYSTS"": -1, ""STARFRUIT"": -4}",2391,5051,10000
411400,10096,42691,"(STARFRUIT, MARKET << US, 5048, 1, 411400)
(STARFRUIT, MARKET << US, 5048, 1, 411400)","{""AMETHYSTS"": -1, ""STARFRUIT"": -6}",2385,5051,10000
411500,-39992,2699,"(AMETHYSTS, US << MARKET, 9998, 1, 411500)
(AMETHYSTS, US << MARKET, 9998, 1, 411500)
(AMETHYSTS, US << MARKET, 9998, 1, 411500)
(AMETHYSTS, US << MARKET, 9998, 1, 411500)","{""AMETHYSTS"": 3, ""STARFRUIT"": -6}",2414,5048,10001
411700,-10108,-7409,"(STARFRUIT, US << MARKET, 5054, 1, 411700)
(STARFRUIT, US << MARKET, 5054, 1, 411700)","{""AMETHYSTS"": 3, ""STARFRUIT"": -4}",2381,5054,10002
411800,5053,-2356,"(STARFRUIT, MARKET << US, 5053, 1, 411800)","{""AMETHYSTS"": 3, ""STARFRUIT"": -5}",2382,5053,10001
411900,-10106,-12462,"(STARFRUIT, US << MARKET, 5053, 1, 411900)
(STARFRUIT, US << MARKET, 5053, 1, 411900)","{""AMETHYSTS"": 3, ""STARFRUIT"": -3}",2382,5052,10000
412600,10108,-2354,"(STARFRUIT, MARKET << US, 5054, 1, 412600)
(STARFRUIT, MARKET << US, 5054, 1, 412600)","{""AMETHYSTS"": 3, ""STARFRUIT"": -5}",2391,5051,10000
413100,-30276,-32630,"(STARFRUIT, US << MARKET, 5046, 1, 413100)
(STARFRUIT, US << MARKET, 5046, 1, 413100)
(STARFRUIT, US << MARKET, 5046, 1, 413100)
(STARFRUIT, US << MARKET, 5046, 1, 413100)
(STARFRUIT, US << MARKET, 5046, 1, 413100)
(STARFRUIT, US << MARKET, 5046, 1, 413100)
(STARFRUIT, US << MARKET, 5046, 1, 413100)
(STARFRUIT, MARKET << US, 5046, 1, 413100)","{""AMETHYSTS"": 3, ""STARFRUIT"": 1}",2421,5048,10001
413300,-10102,-42732,"(STARFRUIT, US << MARKET, 5051, 1, 413300)
(STARFRUIT, US << MARKET, 5051, 1, 413300)","{""AMETHYSTS"": 3, ""STARFRUIT"": 3}",2409,5047,10000
413500,-10002,-52734,"(AMETHYSTS, US << MARKET, 10002, 1, 413500)","{""AMETHYSTS"": 4, ""STARFRUIT"": 3}",2409,5049,9999
413800,-39984,-92718,"(AMETHYSTS, US << MARKET, 9996, 1, 413800)
(AMETHYSTS, US << MARKET, 9996, 1, 413800)
(AMETHYSTS, US << MARKET, 9996, 1, 413800)
(AMETHYSTS, US << MARKET, 9996, 1, 413800)","{""AMETHYSTS"": 8, ""STARFRUIT"": 3}",2411,5051,9997
414400,25060,-67658,"(AMETHYSTS, MARKET << US, 10004, 1, 414400)
(AMETHYSTS, MARKET << US, 10004, 1, 414400)
(STARFRUIT, MARKET << US, 5052, 1, 414400)","{""AMETHYSTS"": 6, ""STARFRUIT"": 2}",2438,5048,10000
414600,-74932,-142590,"(AMETHYSTS, US << MARKET, 9998, 1, 414600)
(AMETHYSTS, US << MARKET, 9998, 1, 414600)
(AMETHYSTS, US << MARKET, 9998, 1, 414600)
(AMETHYSTS, US << MARKET, 9998, 1, 414600)
(AMETHYSTS, US << MARKET, 9998, 1, 414600)
(AMETHYSTS, US << MARKET, 9998, 1, 414600)
(AMETHYSTS, US << MARKET, 9998, 1, 414600)
(AMETHYSTS, US << MARKET, 9998, 1, 414600)
(STARFRUIT, MARKET << US, 5052, 1, 414600)","{""AMETHYSTS"": 14, ""STARFRUIT"": 1}",2416,5048,9997
415000,-30006,-172596,"(AMETHYSTS, US << MARKET, 10002, 1, 415000)
(AMETHYSTS, US << MARKET, 10002, 1, 415000)
(AMETHYSTS, US << MARKET, 10002, 1, 415000)","{""AMETHYSTS"": 17, ""STARFRUIT"": 1}",2502,5047,10003
415200,5049,-167547,"(STARFRUIT, MARKET << US, 5049, 1, 415200)","{""AMETHYSTS"": 17, ""STARFRUIT"": 0}",2453,5046,10000
415300,9998,-157549,"(AMETHYSTS, MARKET << US, 9998, 1, 415300)","{""AMETHYSTS"": 16, ""STARFRUIT"": 0}",2403,5048,9997
415600,19830,-137719,"(AMETHYSTS, MARKET << US, 10005, 1, 415600)
(AMETHYSTS, MARKET << US, 10005, 1, 415600)
(AMETHYSTS, MARKET << US, 10005, 1, 415600)
(AMETHYSTS, MARKET << US, 10005, 1, 415600)
(STARFRUIT, US << MARKET, 5044, 1, 415600)
(STARFRUIT, US << MARKET, 5044, 1, 415600)
(STARFRUIT, US << MARKET, 5051, 1, 415600)
(STARFRUIT, US << MARKET, 5051, 1, 415600)","{""AMETHYSTS"": 12, ""STARFRUIT"": 4}",2469,5047,10000
415800,-49980,-187699,"(AMETHYSTS, US << MARKET, 9996, 1, 415800)
(AMETHYSTS, US << MARKET, 9996, 1, 415800)
(AMETHYSTS, US << MARKET, 9996, 1, 415800)
(AMETHYSTS, US << MARKET, 9996, 1, 415800)
(AMETHYSTS, US << MARKET, 9996, 1, 415800)
(AMETHYSTS, US << MARKET, 9996, 1, 415800)
(AMETHYSTS, US << MARKET, 9996, 1, 415800)
(AMETHYSTS, MARKET << US, 9996, 1, 415800)
(AMETHYSTS, MARKET << US, 9996, 1, 415800)","{""AMETHYSTS"": 17, ""STARFRUIT"": 4}",2476,5048,9999
416100,5050,-182649,"(STARFRUIT, MARKET << US, 5050, 1, 416100)","{""AMETHYSTS"": 17, ""STARFRUIT"": 3}",2467,5050,9998
416200,-19996,-202645,"(AMETHYSTS, US << MARKET, 9998, 1, 416200)
(AMETHYSTS, US << MARKET, 9998, 1, 416200)","{""AMETHYSTS"": 19, ""STARFRUIT"": 3}",2439,5047,9997
416600,9996,-192649,"(AMETHYSTS, US << MARKET, 9996, 1, 416600)
(AMETHYSTS, MARKET << US, 9996, 1, 416600)
(AMETHYSTS, MARKET << US, 9996, 1, 416600)","{""AMETHYSTS"": 18, ""STARFRUIT"": 3}",2480,5049,9999
416800,-10106,-202755,"(AMETHYSTS, US << MARKET, 9996, 1, 416800)
(AMETHYSTS, US << MARKET, 9996, 1, 416800)
(AMETHYSTS, MARKET << US, 9996, 1, 416800)
(AMETHYSTS, MARKET << US, 9996, 1, 416800)
(STARFRUIT, US << MARKET, 5053, 1, 416800)
(STARFRUIT, US << MARKET, 5053, 1, 416800)","{""AMETHYSTS"": 18, ""STARFRUIT"": 5}",2495,5050,10000
417000,19996,-182759,"(AMETHYSTS, MARKET << US, 9998, 1, 417000)
(AMETHYSTS, MARKET << US, 9998, 1, 417000)","{""AMETHYSTS"": 16, ""STARFRUIT"": 5}",2432,5051,9996
417100,25230,-157529,"(STARFRUIT, MARKET << US, 5046, 1, 417100)
(STARFRUIT, MARKET << US, 5046, 1, 417100)
(STARFRUIT, MARKET << US, 5046, 1, 417100)
(STARFRUIT, MARKET << US, 5046, 1, 417100)
(STARFRUIT, MARKET << US, 5046, 1, 417100)","{""AMETHYSTS"": 16, ""STARFRUIT"": 0}",2487,5049,10001
417300,20004,-137525,"(AMETHYSTS, MARKET << US, 10002, 1, 417300)
(AMETHYSTS, MARKET << US, 10002, 1, 417300)","{""AMETHYSTS"": 14, ""STARFRUIT"": 0}",2517,5048,10003
417500,5045,-132480,"(STARFRUIT, MARKET << US, 5045, 1, 417500)","{""AMETHYSTS"": 14, ""STARFRUIT"": -1}",2514,5048,10003
417600,5047,-127433,"(STARFRUIT, US << MARKET, 5047, 1, 417600)
(STARFRUIT, US << MARKET, 5047, 1, 417600)
(STARFRUIT, MARKET << US, 5047, 1, 417600)
(STARFRUIT, MARKET << US, 5047, 1, 417600)
(STARFRUIT, MARKET << US, 5047, 1, 417600)","{""AMETHYSTS"": 14, ""STARFRUIT"": -2}",2475,5046,10000
418000,10090,-117343,"(STARFRUIT, MARKET << US, 5045, 1, 418000)
(STARFRUIT, MARKET << US, 5045, 1, 418000)","{""AMETHYSTS"": 14, ""STARFRUIT"": -4}",2465,5048,10000
418200,-60168,-177511,"(AMETHYSTS, US << MARKET, 9996, 1, 418200)
(AMETHYSTS, US << MARKET, 9996, 1, 418200)
(AMETHYSTS, US << MARKET, 9996, 1, 418200)
(AMETHYSTS, US << MARKET, 9996, 1, 418200)
(STARFRUIT, US << MARKET, 5046, 1, 418200)
(STARFRUIT, US << MARKET, 5046, 1, 418200)
(STARFRUIT, US << MARKET, 5046, 1, 418200)
(STARFRUIT, US << MARKET, 5046, 1, 418200)","{""AMETHYSTS"": 18, ""STARFRUIT"": 0}",2489,5048,10000
418400,50122,-127389,"(AMETHYSTS, MARKET << US, 10004, 1, 418400)
(AMETHYSTS, MARKET << US, 10004, 1, 418400)
(AMETHYSTS, MARKET << US, 10004, 1, 418400)
(AMETHYSTS, MARKET << US, 10004, 1, 418400)
(STARFRUIT, MARKET << US, 5053, 1, 418400)
(STARFRUIT, MARKET << US, 5053, 1, 418400)","{""AMETHYSTS"": 14, ""STARFRUIT"": -2}",2527,5049,10001
418800,5052,-122337,"(STARFRUIT, MARKET << US, 5052, 1, 418800)","{""AMETHYSTS"": 14, ""STARFRUIT"": -3}",2507,5052,10000
418900,215144,92807,"(AMETHYSTS, MARKET << US, 10005, 1, 418900)
(AMETHYSTS, MARKET << US, 10005, 1, 418900)
(AMETHYSTS, MARKET << US, 10005, 1, 418900)
(AMETHYSTS, MARKET << US, 10005, 1, 418900)
(AMETHYSTS, MARKET << US, 10005, 1, 418900)
(AMETHYSTS, MARKET << US, 10005, 1, 418900)
(AMETHYSTS, MARKET << US, 10005, 1, 418900)
(AMETHYSTS, MARKET << US, 10005, 1, 418900)
(AMETHYSTS, MARKET << US, 10005, 1, 418900)
(AMETHYSTS, MARKET << US, 10005, 1, 418900)
(AMETHYSTS, MARKET << US, 10005, 1, 418900)
(AMETHYSTS, MARKET << US, 10005, 1, 418900)
(AMETHYSTS, MARKET << US, 10005, 1, 418900)
(AMETHYSTS, MARKET << US, 10005, 1, 418900)
(AMETHYSTS, MARKET << US, 10005, 1, 418900)
(AMETHYSTS, MARKET << US, 10005, 1, 418900)
(AMETHYSTS, MARKET << US, 10005, 1, 418900)
(AMETHYSTS, MARKET << US, 10005, 1, 418900)
(AMETHYSTS, MARKET << US, 10005, 1, 418900)
(AMETHYSTS, MARKET << US, 10005, 1, 418900)
(AMETHYSTS, MARKET << US, 9998, 1, 418900)
(STARFRUIT, MARKET << US, 5046, 1, 418900)","{""AMETHYSTS"": -7, ""STARFRUIT"": -4}",2604,5049,10001
419600,-94,92713,"(AMETHYSTS, MARKET << US, 9996, 1, 419600)
(STARFRUIT, US << MARKET, 5045, 1, 419600)
(STARFRUIT, US << MARKET, 5045, 1, 419600)","{""AMETHYSTS"": -8, ""STARFRUIT"": -2}",2617,5048,10000
419700,20008,112721,"(AMETHYSTS, MARKET << US, 10004, 1, 419700)
(AMETHYSTS, MARKET << US, 10004, 1, 419700)","{""AMETHYSTS"": -10, ""STARFRUIT"": -2}",2615,5048,10001
420000,-10100,102621,"(STARFRUIT, US << MARKET, 5050, 1, 420000)
(STARFRUIT, US << MARKET, 5050, 1, 420000)","{""AMETHYSTS"": -10, ""STARFRUIT"": 0}",2611,5050,10001
420200,9890,112511,"(AMETHYSTS, MARKET << US, 9995, 1, 420200)
(AMETHYSTS, MARKET << US, 9995, 1, 420200)
(STARFRUIT, US << MARKET, 5050, 1, 420200)
(STARFRUIT, US << MARKET, 5050, 1, 420200)","{""AMETHYSTS"": -12, ""STARFRUIT"": 2}",2613,5051,10000
420300,70028,182539,"(AMETHYSTS, US << MARKET, 10004, 1, 420300)
(AMETHYSTS, MARKET << US, 10004, 1, 420300)
(AMETHYSTS, MARKET << US, 10004, 1, 420300)
(AMETHYSTS, MARKET << US, 10004, 1, 420300)
(AMETHYSTS, MARKET << US, 10004, 1, 420300)
(AMETHYSTS, MARKET << US, 10004, 1, 420300)
(AMETHYSTS, MARKET << US, 10004, 1, 420300)
(AMETHYSTS, MARKET << US, 10004, 1, 420300)
(AMETHYSTS, MARKET << US, 10004, 1, 420300)","{""AMETHYSTS"": -19, ""STARFRUIT"": 2}",2633,5047,10000
420400,-10100,172439,"(STARFRUIT, US << MARKET, 5050, 1, 420400)
(STARFRUIT, US << MARKET, 5050, 1, 420400)","{""AMETHYSTS"": -19, ""STARFRUIT"": 4}",2643,5051,10000
420800,-19996,152443,"(AMETHYSTS, US << MARKET, 9998, 1, 420800)
(AMETHYSTS, US << MARKET, 9998, 1, 420800)","{""AMETHYSTS"": -17, ""STARFRUIT"": 4}",2613,5051,10002
421400,30084,182527,"(AMETHYSTS, MARKET << US, 9996, 1, 421400)
(AMETHYSTS, MARKET << US, 9996, 1, 421400)
(STARFRUIT, MARKET << US, 5046, 1, 421400)
(STARFRUIT, MARKET << US, 5046, 1, 421400)","{""AMETHYSTS"": -19, ""STARFRUIT"": 2}",2625,5049,10000
422200,-40008,142519,"(AMETHYSTS, US << MARKET, 10002, 1, 422200)
(AMETHYSTS, US << MARKET, 10002, 1, 422200)
(AMETHYSTS, US << MARKET, 10002, 1, 422200)
(AMETHYSTS, US << MARKET, 10002, 1, 422200)","{""AMETHYSTS"": -15, ""STARFRUIT"": 2}",2570,5048,10003
422300,-10090,132429,"(STARFRUIT, US << MARKET, 5045, 1, 422300)
(STARFRUIT, US << MARKET, 5045, 1, 422300)","{""AMETHYSTS"": -15, ""STARFRUIT"": 4}",2621,5048,10000
422600,15147,147576,"(STARFRUIT, MARKET << US, 5049, 1, 422600)
(STARFRUIT, MARKET << US, 5049, 1, 422600)
(STARFRUIT, MARKET << US, 5049, 1, 422600)","{""AMETHYSTS"": -15, ""STARFRUIT"": 1}",2625,5049,10000
422700,-10098,137478,"(STARFRUIT, US << MARKET, 5049, 1, 422700)
(STARFRUIT, US << MARKET, 5049, 1, 422700)","{""AMETHYSTS"": -15, ""STARFRUIT"": 3}",2613,5050,10001
423300,30202,167680,"(AMETHYSTS, MARKET << US, 9998, 1, 423300)
(STARFRUIT, MARKET << US, 5051, 1, 423300)
(STARFRUIT, MARKET << US, 5051, 1, 423300)
(STARFRUIT, MARKET << US, 5051, 1, 423300)
(STARFRUIT, MARKET << US, 5051, 1, 423300)","{""AMETHYSTS"": -16, ""STARFRUIT"": -1}",2681,5047,9997
423400,-19996,147684,"(AMETHYSTS, US << MARKET, 9998, 1, 423400)
(AMETHYSTS, US << MARKET, 9998, 1, 423400)","{""AMETHYSTS"": -14, ""STARFRUIT"": -1}",2636,5048,10000
423700,-10092,137592,"(STARFRUIT, US << MARKET, 5046, 1, 423700)
(STARFRUIT, US << MARKET, 5046, 1, 423700)","{""AMETHYSTS"": -14, ""STARFRUIT"": 1}",2637,5045,10000
424800,-119940,17652,"(AMETHYSTS, US << MARKET, 9995, 1, 424800)
(AMETHYSTS, US << MARKET, 9995, 1, 424800)
(AMETHYSTS, US << MARKET, 9995, 1, 424800)
(AMETHYSTS, US << MARKET, 9995, 1, 424800)
(AMETHYSTS, US << MARKET, 9995, 1, 424800)
(AMETHYSTS, US << MARKET, 9995, 1, 424800)
(AMETHYSTS, US << MARKET, 9995, 1, 424800)
(AMETHYSTS, US << MARKET, 9995, 1, 424800)
(AMETHYSTS, US << MARKET, 9995, 1, 424800)
(AMETHYSTS, US << MARKET, 9995, 1, 424800)
(AMETHYSTS, US << MARKET, 9995, 1, 424800)
(AMETHYSTS, US << MARKET, 9995, 1, 424800)","{""AMETHYSTS"": -2, ""STARFRUIT"": 1}",2701,5049,10000
425100,5051,22703,"(STARFRUIT, MARKET << US, 5051, 1, 425100)","{""AMETHYSTS"": -2, ""STARFRUIT"": 0}",2703,5047,10000
425300,-39992,-17289,"(AMETHYSTS, US << MARKET, 9998, 1, 425300)
(AMETHYSTS, US << MARKET, 9998, 1, 425300)
(AMETHYSTS, US << MARKET, 9998, 1, 425300)
(AMETHYSTS, US << MARKET, 9998, 1, 425300)","{""AMETHYSTS"": 2, ""STARFRUIT"": 0}",2705,5047,9997
425500,-10100,-27389,"(STARFRUIT, US << MARKET, 5050, 1, 425500)
(STARFRUIT, US << MARKET, 5050, 1, 425500)","{""AMETHYSTS"": 2, ""STARFRUIT"": 2}",2711,5050,10000
425700,5044,-22345,"(STARFRUIT, MARKET << US, 5044, 1, 425700)","{""AMETHYSTS"": 2, ""STARFRUIT"": 1}",2703,5046,10001
425800,-4971,-27316,"(AMETHYSTS, US << MARKET, 10000, 1, 425800)
(AMETHYSTS, US << MARKET, 10000, 1, 425800)
(AMETHYSTS, US << MARKET, 10000, 1, 425800)
(AMETHYSTS, US << MARKET, 10000, 1, 425800)
(AMETHYSTS, MARKET << US, 10000, 1, 425800)
(AMETHYSTS, MARKET << US, 9998, 1, 425800)
(AMETHYSTS, MARKET << US, 9998, 1, 425800)
(STARFRUIT, US << MARKET, 5051, 1, 425800)
(STARFRUIT, US << MARKET, 5051, 1, 425800)
(STARFRUIT, MARKET << US, 5045, 1, 425800)
(STARFRUIT, MARKET << US, 5045, 1, 425800)
(STARFRUIT, MARKET << US, 5045, 1, 425800)","{""AMETHYSTS"": 3, ""STARFRUIT"": 0}",2690,5049,10002
425900,49990,22674,"(AMETHYSTS, MARKET << US, 9998, 1, 425900)
(AMETHYSTS, MARKET << US, 9998, 1, 425900)
(AMETHYSTS, MARKET << US, 9998, 1, 425900)
(AMETHYSTS, MARKET << US, 9998, 1, 425900)
(AMETHYSTS, MARKET << US, 9998, 1, 425900)","{""AMETHYSTS"": -2, ""STARFRUIT"": 0}",2680,5047,9997
426500,-10098,12576,"(STARFRUIT, US << MARKET, 5049, 1, 426500)
(STARFRUIT, US << MARKET, 5049, 1, 426500)","{""AMETHYSTS"": -2, ""STARFRUIT"": 2}",2674,5049,10000
426600,99980,112556,"(AMETHYSTS, MARKET << US, 9998, 1, 426600)
(AMETHYSTS, MARKET << US, 9998, 1, 426600)
(AMETHYSTS, MARKET << US, 9998, 1, 426600)
(AMETHYSTS, MARKET << US, 9998, 1, 426600)
(AMETHYSTS, MARKET << US, 9998, 1, 426600)
(AMETHYSTS, MARKET << US, 9998, 1, 426600)
(AMETHYSTS, MARKET << US, 9998, 1, 426600)
(AMETHYSTS, MARKET << US, 9998, 1, 426600)
(AMETHYSTS, MARKET << US, 9998, 1, 426600)
(AMETHYSTS, MARKET << US, 9998, 1, 426600)","{""AMETHYSTS"": -12, ""STARFRUIT"": 2}",2636,5046,10001
426800,5048,117604,"(STARFRUIT, MARKET << US, 5048, 1, 426800)","{""AMETHYSTS"": -12, ""STARFRUIT"": 1}",2653,5049,10000
427100,-10098,107506,"(STARFRUIT, US << MARKET, 5049, 1, 427100)
(STARFRUIT, US << MARKET, 5049, 1, 427100)","{""AMETHYSTS"": -12, ""STARFRUIT"": 3}",2641,5049,10001
427500,-80016,27490,"(AMETHYSTS, US << MARKET, 10002, 1, 427500)
(AMETHYSTS, US << MARKET, 10002, 1, 427500)
(AMETHYSTS, US << MARKET, 10002, 1, 427500)
(AMETHYSTS, US << MARKET, 10002, 1, 427500)
(AMETHYSTS, US << MARKET, 10002, 1, 427500)
(AMETHYSTS, US << MARKET, 10002, 1, 427500)
(AMETHYSTS, US << MARKET, 10002, 1, 427500)
(AMETHYSTS, US << MARKET, 10002, 1, 427500)","{""AMETHYSTS"": -4, ""STARFRUIT"": 3}",2635,5047,9999
427800,-10088,17402,"(STARFRUIT, US << MARKET, 5044, 1, 427800)
(STARFRUIT, US << MARKET, 5044, 1, 427800)","{""AMETHYSTS"": -4, ""STARFRUIT"": 5}",2632,5046,10000
428000,25220,42622,"(STARFRUIT, MARKET << US, 5044, 1, 428000)
(STARFRUIT, MARKET << US, 5044, 1, 428000)
(STARFRUIT, MARKET << US, 5044, 1, 428000)
(STARFRUIT, MARKET << US, 5044, 1, 428000)
(STARFRUIT, MARKET << US, 5044, 1, 428000)","{""AMETHYSTS"": -4, ""STARFRUIT"": 0}",2618,5047,10001
428200,-10002,32620,"(AMETHYSTS, US << MARKET, 10002, 1, 428200)","{""AMETHYSTS"": -3, ""STARFRUIT"": 0}",2623,5047,9999
428300,9906,42526,"(AMETHYSTS, MARKET << US, 9998, 1, 428300)
(AMETHYSTS, MARKET << US, 9998, 1, 428300)
(STARFRUIT, US << MARKET, 5045, 1, 428300)
(STARFRUIT, US << MARKET, 5045, 1, 428300)","{""AMETHYSTS"": -5, ""STARFRUIT"": 2}",2637,5048,9997
428900,-10090,32436,"(STARFRUIT, US << MARKET, 5045, 1, 428900)
(STARFRUIT, US << MARKET, 5045, 1, 428900)","{""AMETHYSTS"": -5, ""STARFRUIT"": 4}",2628,5048,10000
429000,20008,52444,"(AMETHYSTS, MARKET << US, 10004, 1, 429000)
(AMETHYSTS, MARKET << US, 10004, 1, 429000)","{""AMETHYSTS"": -7, ""STARFRUIT"": 4}",2636,5048,10000
429100,-29894,22550,"(AMETHYSTS, US << MARKET, 9996, 1, 429100)
(AMETHYSTS, US << MARKET, 9996, 1, 429100)
(AMETHYSTS, US << MARKET, 9996, 1, 429100)
(AMETHYSTS, US << MARKET, 9996, 1, 429100)
(STARFRUIT, MARKET << US, 5045, 1, 429100)
(STARFRUIT, MARKET << US, 5045, 1, 429100)","{""AMETHYSTS"": -3, ""STARFRUIT"": 2}",2644,5047,10000
429600,-30092,-7542,"(AMETHYSTS, US << MARKET, 9996, 1, 429600)
(AMETHYSTS, US << MARKET, 9996, 1, 429600)
(STARFRUIT, US << MARKET, 5050, 1, 429600)
(STARFRUIT, US << MARKET, 5050, 1, 429600)","{""AMETHYSTS"": -1, ""STARFRUIT"": 4}",2662,5051,10000
429800,-10092,-17634,"(STARFRUIT, US << MARKET, 5046, 1, 429800)
(STARFRUIT, US << MARKET, 5046, 1, 429800)","{""AMETHYSTS"": -1, ""STARFRUIT"": 6}",2654,5048,10000
429900,15042,-2592,"(AMETHYSTS, MARKET << US, 9996, 1, 429900)
(STARFRUIT, MARKET << US, 5046, 1, 429900)","{""AMETHYSTS"": -2, ""STARFRUIT"": 5}",2653,5049,10000
430000,20188,17596,"(STARFRUIT, MARKET << US, 5047, 1, 430000)
(STARFRUIT, MARKET << US, 5047, 1, 430000)
(STARFRUIT, MARKET << US, 5047, 1, 430000)
(STARFRUIT, MARKET << US, 5047, 1, 430000)","{""AMETHYSTS"": -2, ""STARFRUIT"": 1}",2646,5050,10000
430200,-19996,-2400,"(AMETHYSTS, US << MARKET, 9998, 1, 430200)
(AMETHYSTS, US << MARKET, 9998, 1, 430200)","{""AMETHYSTS"": 0, ""STARFRUIT"": 1}",2649,5049,9997
430400,80016,77616,"(AMETHYSTS, MARKET << US, 10002, 1, 430400)
(AMETHYSTS, MARKET << US, 10002, 1, 430400)
(AMETHYSTS, MARKET << US, 10002, 1, 430400)
(AMETHYSTS, MARKET << US, 10002, 1, 430400)
(AMETHYSTS, MARKET << US, 10002, 1, 430400)
(AMETHYSTS, MARKET << US, 10002, 1, 430400)
(AMETHYSTS, MARKET << US, 10002, 1, 430400)
(AMETHYSTS, MARKET << US, 10002, 1, 430400)","{""AMETHYSTS"": -8, ""STARFRUIT"": 1}",2689,5049,9997
431100,-10094,67522,"(STARFRUIT, US << MARKET, 5047, 1, 431100)
(STARFRUIT, US << MARKET, 5047, 1, 431100)","{""AMETHYSTS"": -8, ""STARFRUIT"": 3}",2672,5050,10000
431400,5051,72573,"(STARFRUIT, MARKET << US, 5051, 1, 431400)","{""AMETHYSTS"": -8, ""STARFRUIT"": 2}",2677,5052,10000
431500,-25255,47318,"(STARFRUIT, US << MARKET, 5051, 1, 431500)
(STARFRUIT, US << MARKET, 5051, 1, 431500)
(STARFRUIT, US << MARKET, 5051, 1, 431500)
(STARFRUIT, US << MARKET, 5051, 1, 431500)
(STARFRUIT, US << MARKET, 5051, 1, 431500)","{""AMETHYSTS"": -8, ""STARFRUIT"": 7}",2706,5052,9997
431900,-10002,37316,"(AMETHYSTS, US << MARKET, 10002, 1, 431900)","{""AMETHYSTS"": -7, ""STARFRUIT"": 7}",2645,5050,10003
433000,-5055,32261,"(STARFRUIT, US << MARKET, 5055, 1, 433000)","{""AMETHYSTS"": -7, ""STARFRUIT"": 8}",2701,5055,10000
433100,-15057,17204,"(AMETHYSTS, US << MARKET, 10002, 1, 433100)
(STARFRUIT, US << MARKET, 5055, 1, 433100)","{""AMETHYSTS"": -6, ""STARFRUIT"": 9}",2681,5055,10003
433500,-29884,-12680,"(AMETHYSTS, US << MARKET, 9996, 1, 433500)
(AMETHYSTS, US << MARKET, 9996, 1, 433500)
(AMETHYSTS, US << MARKET, 9996, 1, 433500)
(AMETHYSTS, US << MARKET, 9996, 1, 433500)
(STARFRUIT, MARKET << US, 5050, 1, 433500)
(STARFRUIT, MARKET << US, 5050, 1, 433500)","{""AMETHYSTS"": -2, ""STARFRUIT"": 7}",2691,5053,10000
433800,20004,7324,"(AMETHYSTS, MARKET << US, 10002, 1, 433800)
(AMETHYSTS, MARKET << US, 10002, 1, 433800)","{""AMETHYSTS"": -4, ""STARFRUIT"": 7}",2683,5053,10003
434500,20004,27328,"(AMETHYSTS, MARKET << US, 10004, 1, 434500)
(AMETHYSTS, MARKET << US, 10004, 1, 434500)
(STARFRUIT, US << MARKET, 5053, 1, 434500)
(STARFRUIT, MARKET << US, 5049, 1, 434500)","{""AMETHYSTS"": -6, ""STARFRUIT"": 7}",2685,5051,10000
434600,-89982,-62654,"(AMETHYSTS, US << MARKET, 9998, 1, 434600)
(AMETHYSTS, US << MARKET, 9998, 1, 434600)
(AMETHYSTS, US << MARKET, 9998, 1, 434600)
(AMETHYSTS, US << MARKET, 9998, 1, 434600)
(AMETHYSTS, US << MARKET, 9998, 1, 434600)
(AMETHYSTS, US << MARKET, 9998, 1, 434600)
(AMETHYSTS, US << MARKET, 9998, 1, 434600)
(AMETHYSTS, US << MARKET, 9998, 1, 434600)
(AMETHYSTS, US << MARKET, 9998, 1, 434600)
(AMETHYSTS, US << MARKET, 9998, 1, 434600)
(AMETHYSTS, US << MARKET, 9998, 1, 434600)
(AMETHYSTS, US << MARKET, 9998, 1, 434600)
(AMETHYSTS, MARKET << US, 9998, 1, 434600)
(AMETHYSTS, MARKET << US, 9998, 1, 434600)
(AMETHYSTS, MARKET << US, 9998, 1, 434600)","{""AMETHYSTS"": 3, ""STARFRUIT"": 7}",2694,5051,9997
434900,4947,-57707,"(AMETHYSTS, MARKET << US, 9996, 1, 434900)
(STARFRUIT, US << MARKET, 5049, 1, 434900)","{""AMETHYSTS"": 2, ""STARFRUIT"": 8}",2709,5052,10000
435000,-19996,-77703,"(AMETHYSTS, US << MARKET, 9998, 1, 435000)
(AMETHYSTS, US << MARKET, 9998, 1, 435000)","{""AMETHYSTS"": 4, ""STARFRUIT"": 8}",2717,5052,10001
435600,-5049,-82752,"(STARFRUIT, US << MARKET, 5049, 1, 435600)","{""AMETHYSTS"": 4, ""STARFRUIT"": 9}",2708,5052,9998
435700,-14947,-97699,"(AMETHYSTS, US << MARKET, 10000, 1, 435700)
(AMETHYSTS, US << MARKET, 10000, 1, 435700)
(STARFRUIT, US << MARKET, 5049, 1, 435700)
(STARFRUIT, MARKET << US, 5051, 1, 435700)
(STARFRUIT, MARKET << US, 5051, 1, 435700)","{""AMETHYSTS"": 6, ""STARFRUIT"": 8}",2731,5053,10001
436400,5053,-92646,"(STARFRUIT, MARKET << US, 5053, 1, 436400)","{""AMETHYSTS"": 6, ""STARFRUIT"": 7}",2704,5050,10000
436500,-10002,-102648,"(AMETHYSTS, US << MARKET, 10002, 1, 436500)","{""AMETHYSTS"": 7, ""STARFRUIT"": 7}",2737,5052,10003
436900,-4954,-107602,"(AMETHYSTS, US << MARKET, 10002, 1, 436900)
(STARFRUIT, MARKET << US, 5048, 1, 436900)","{""AMETHYSTS"": 8, ""STARFRUIT"": 6}",2722,5050,10003
437000,25280,-82322,"(STARFRUIT, MARKET << US, 5056, 1, 437000)
(STARFRUIT, MARKET << US, 5056, 1, 437000)
(STARFRUIT, MARKET << US, 5056, 1, 437000)
(STARFRUIT, MARKET << US, 5056, 1, 437000)
(STARFRUIT, MARKET << US, 5056, 1, 437000)","{""AMETHYSTS"": 8, ""STARFRUIT"": 1}",2738,5052,10001
437300,15050,-67272,"(AMETHYSTS, MARKET << US, 9996, 1, 437300)
(STARFRUIT, MARKET << US, 5054, 1, 437300)","{""AMETHYSTS"": 7, ""STARFRUIT"": 0}",2707,5054,9997
437500,30288,-36984,"(STARFRUIT, MARKET << US, 5048, 1, 437500)
(STARFRUIT, MARKET << US, 5048, 1, 437500)
(STARFRUIT, MARKET << US, 5048, 1, 437500)
(STARFRUIT, MARKET << US, 5048, 1, 437500)
(STARFRUIT, MARKET << US, 5048, 1, 437500)
(STARFRUIT, MARKET << US, 5048, 1, 437500)","{""AMETHYSTS"": 7, ""STARFRUIT"": -6}",2710,5051,10000
437800,-40408,-77392,"(STARFRUIT, US << MARKET, 5051, 1, 437800)
(STARFRUIT, US << MARKET, 5051, 1, 437800)
(STARFRUIT, US << MARKET, 5051, 1, 437800)
(STARFRUIT, US << MARKET, 5051, 1, 437800)
(STARFRUIT, US << MARKET, 5051, 1, 437800)
(STARFRUIT, US << MARKET, 5051, 1, 437800)
(STARFRUIT, US << MARKET, 5051, 1, 437800)
(STARFRUIT, US << MARKET, 5051, 1, 437800)","{""AMETHYSTS"": 7, ""STARFRUIT"": 2}",2685,5049,9997
438000,-10098,-87490,"(STARFRUIT, US << MARKET, 5049, 1, 438000)
(STARFRUIT, US << MARKET, 5049, 1, 438000)","{""AMETHYSTS"": 7, ""STARFRUIT"": 4}",2695,5048,9999
438600,-35146,-122636,"(AMETHYSTS, US << MARKET, 9998, 1, 438600)
(AMETHYSTS, US << MARKET, 9998, 1, 438600)
(STARFRUIT, US << MARKET, 5050, 1, 438600)
(STARFRUIT, US << MARKET, 5050, 1, 438600)
(STARFRUIT, US << MARKET, 5050, 1, 438600)
(STARFRUIT, US << MARKET, 5050, 1, 438600)
(STARFRUIT, MARKET << US, 5050, 1, 438600)","{""AMETHYSTS"": 9, ""STARFRUIT"": 7}",2699,5053,9996
438700,-4952,-127588,"(AMETHYSTS, US << MARKET, 10002, 1, 438700)
(STARFRUIT, MARKET << US, 5050, 1, 438700)","{""AMETHYSTS"": 10, ""STARFRUIT"": 6}",2760,5053,10003
438800,-14946,-142534,"(AMETHYSTS, US << MARKET, 9998, 1, 438800)
(AMETHYSTS, US << MARKET, 9998, 1, 438800)
(STARFRUIT, MARKET << US, 5050, 1, 438800)","{""AMETHYSTS"": 12, ""STARFRUIT"": 5}",2690,5052,9997
439000,10100,-132434,"(STARFRUIT, MARKET << US, 5050, 1, 439000)
(STARFRUIT, MARKET << US, 5050, 1, 439000)","{""AMETHYSTS"": 12, ""STARFRUIT"": 3}",2725,5053,10000
439100,10102,-122332,"(STARFRUIT, MARKET << US, 5051, 1, 439100)
(STARFRUIT, MARKET << US, 5051, 1, 439100)","{""AMETHYSTS"": 12, ""STARFRUIT"": 1}",2722,5054,10000
439300,-40232,-162564,"(AMETHYSTS, US << MARKET, 10004, 1, 439300)
(AMETHYSTS, US << MARKET, 10004, 1, 439300)
(STARFRUIT, US << MARKET, 5056, 1, 439300)
(STARFRUIT, US << MARKET, 5056, 1, 439300)
(STARFRUIT, US << MARKET, 5056, 1, 439300)
(STARFRUIT, US << MARKET, 5056, 1, 439300)","{""AMETHYSTS"": 14, ""STARFRUIT"": 5}",2706,5054,10000
439500,19996,-142568,"(AMETHYSTS, MARKET << US, 9998, 1, 439500)
(AMETHYSTS, MARKET << US, 9998, 1, 439500)","{""AMETHYSTS"": 12, ""STARFRUIT"": 5}",2654,5054,9996
439600,9892,-132676,"(AMETHYSTS, MARKET << US, 10002, 1, 439600)
(AMETHYSTS, MARKET << US, 10002, 1, 439600)
(STARFRUIT, US << MARKET, 5056, 1, 439600)
(STARFRUIT, US << MARKET, 5056, 1, 439600)
(STARFRUIT, US << MARKET, 5056, 1, 439600)
(STARFRUIT, US << MARKET, 5056, 1, 439600)
(STARFRUIT, MARKET << US, 5056, 1, 439600)
(STARFRUIT, MARKET << US, 5056, 1, 439600)","{""AMETHYSTS"": 10, ""STARFRUIT"": 7}",2675,5053,9998
439700,-10002,-142678,"(AMETHYSTS, US << MARKET, 10002, 1, 439700)","{""AMETHYSTS"": 11, ""STARFRUIT"": 7}",2733,5054,10003
439800,-5051,-147729,"(STARFRUIT, US << MARKET, 5051, 1, 439800)","{""AMETHYSTS"": 11, ""STARFRUIT"": 8}",2703,5054,10000
440000,9888,-137841,"(AMETHYSTS, MARKET << US, 10002, 1, 440000)
(AMETHYSTS, MARKET << US, 10002, 1, 440000)
(STARFRUIT, US << MARKET, 5058, 1, 440000)
(STARFRUIT, US << MARKET, 5058, 1, 440000)","{""AMETHYSTS"": 9, ""STARFRUIT"": 10}",2720,5057,9999
440100,80016,-57825,"(AMETHYSTS, MARKET << US, 10002, 1, 440100)
(AMETHYSTS, MARKET << US, 10002, 1, 440100)
(AMETHYSTS, MARKET << US, 10002, 1, 440100)
(AMETHYSTS, MARKET << US, 10002, 1, 440100)
(AMETHYSTS, MARKET << US, 10002, 1, 440100)
(AMETHYSTS, MARKET << US, 10002, 1, 440100)
(AMETHYSTS, MARKET << US, 10002, 1, 440100)
(AMETHYSTS, MARKET << US, 10002, 1, 440100)","{""AMETHYSTS"": 1, ""STARFRUIT"": 10}",2728,5055,10003
441200,5050,-52775,"(STARFRUIT, MARKET << US, 5050, 1, 441200)","{""AMETHYSTS"": 1, ""STARFRUIT"": 9}",2666,5049,10000
441300,-20004,-72779,"(AMETHYSTS, US << MARKET, 10002, 1, 441300)
(AMETHYSTS, US << MARKET, 10002, 1, 441300)","{""AMETHYSTS"": 3, ""STARFRUIT"": 9}",2707,5053,10003
441400,-5055,-77834,"(STARFRUIT, US << MARKET, 5055, 1, 441400)","{""AMETHYSTS"": 3, ""STARFRUIT"": 10}",2686,5052,10000
441700,-25052,-102886,"(AMETHYSTS, US << MARKET, 9998, 1, 441700)
(AMETHYSTS, US << MARKET, 9998, 1, 441700)
(STARFRUIT, US << MARKET, 5055, 1, 441700)
(STARFRUIT, US << MARKET, 5055, 1, 441700)
(STARFRUIT, MARKET << US, 5054, 1, 441700)","{""AMETHYSTS"": 5, ""STARFRUIT"": 11}",2688,5054,9996
442200,20004,-82882,"(AMETHYSTS, MARKET << US, 10002, 1, 442200)
(AMETHYSTS, MARKET << US, 10002, 1, 442200)","{""AMETHYSTS"": 3, ""STARFRUIT"": 11}",2688,5051,10003
442400,-25058,-107940,"(AMETHYSTS, US << MARKET, 10002, 1, 442400)
(AMETHYSTS, US << MARKET, 10002, 1, 442400)
(STARFRUIT, US << MARKET, 5054, 1, 442400)","{""AMETHYSTS"": 5, ""STARFRUIT"": 12}",2703,5054,9999
442600,35343,-72597,"(STARFRUIT, MARKET << US, 5049, 1, 442600)
(STARFRUIT, MARKET << US, 5049, 1, 442600)
(STARFRUIT, MARKET << US, 5049, 1, 442600)
(STARFRUIT, MARKET << US, 5049, 1, 442600)
(STARFRUIT, MARKET << US, 5049, 1, 442600)
(STARFRUIT, MARKET << US, 5049, 1, 442600)
(STARFRUIT, MARKET << US, 5049, 1, 442600)","{""AMETHYSTS"": 5, ""STARFRUIT"": 5}",2663,5052,10000
443100,15233,-57364,"(AMETHYSTS, US << MARKET, 10002, 1, 443100)
(STARFRUIT, MARKET << US, 5047, 1, 443100)
(STARFRUIT, MARKET << US, 5047, 1, 443100)
(STARFRUIT, MARKET << US, 5047, 1, 443100)
(STARFRUIT, MARKET << US, 5047, 1, 443100)
(STARFRUIT, MARKET << US, 5047, 1, 443100)","{""AMETHYSTS"": 6, ""STARFRUIT"": 0}",2630,5050,9999
443300,5048,-52316,"(STARFRUIT, MARKET << US, 5048, 1, 443300)","{""AMETHYSTS"": 6, ""STARFRUIT"": -1}",2637,5047,10000
444000,20204,-32112,"(STARFRUIT, MARKET << US, 5051, 1, 444000)
(STARFRUIT, MARKET << US, 5051, 1, 444000)
(STARFRUIT, MARKET << US, 5051, 1, 444000)
(STARFRUIT, MARKET << US, 5051, 1, 444000)","{""AMETHYSTS"": 6, ""STARFRUIT"": -5}",2633,5051,10000
444500,20216,-11896,"(STARFRUIT, MARKET << US, 5054, 1, 444500)
(STARFRUIT, MARKET << US, 5054, 1, 444500)
(STARFRUIT, MARKET << US, 5054, 1, 444500)
(STARFRUIT, MARKET << US, 5054, 1, 444500)","{""AMETHYSTS"": 6, ""STARFRUIT"": -9}",2651,5051,10001
444600,20212,8316,"(STARFRUIT, MARKET << US, 5053, 1, 444600)
(STARFRUIT, MARKET << US, 5053, 1, 444600)
(STARFRUIT, MARKET << US, 5053, 1, 444600)
(STARFRUIT, MARKET << US, 5053, 1, 444600)","{""AMETHYSTS"": 6, ""STARFRUIT"": -13}",2685,5049,10001
444700,-129948,-121632,"(AMETHYSTS, US << MARKET, 9996, 1, 444700)
(AMETHYSTS, US << MARKET, 9996, 1, 444700)
(AMETHYSTS, US << MARKET, 9996, 1, 444700)
(AMETHYSTS, US << MARKET, 9996, 1, 444700)
(AMETHYSTS, US << MARKET, 9996, 1, 444700)
(AMETHYSTS, US << MARKET, 9996, 1, 444700)
(AMETHYSTS, US << MARKET, 9996, 1, 444700)
(AMETHYSTS, US << MARKET, 9996, 1, 444700)
(AMETHYSTS, US << MARKET, 9996, 1, 444700)
(AMETHYSTS, US << MARKET, 9996, 1, 444700)
(AMETHYSTS, US << MARKET, 9996, 1, 444700)
(AMETHYSTS, US << MARKET, 9996, 1, 444700)
(AMETHYSTS, US << MARKET, 9996, 1, 444700)","{""AMETHYSTS"": 19, ""STARFRUIT"": -13}",2661,5050,9997
444800,-10094,-131726,"(STARFRUIT, US << MARKET, 5047, 1, 444800)
(STARFRUIT, US << MARKET, 5047, 1, 444800)","{""AMETHYSTS"": 19, ""STARFRUIT"": -11}",2732,5051,10001
445100,0,-131726,,"{""AMETHYSTS"": 19, ""STARFRUIT"": -11}",2699,5054,10001
445200,-111,-131837,"(AMETHYSTS, MARKET << US, 9995, 1, 445200)
(STARFRUIT, US << MARKET, 5053, 1, 445200)
(STARFRUIT, US << MARKET, 5053, 1, 445200)","{""AMETHYSTS"": 18, ""STARFRUIT"": -9}",2686,5053,10000
445400,-35490,-167327,"(AMETHYSTS, MARKET << US, 9996, 1, 445400)
(STARFRUIT, US << MARKET, 5054, 1, 445400)
(STARFRUIT, US << MARKET, 5054, 1, 445400)
(STARFRUIT, US << MARKET, 5054, 1, 445400)
(STARFRUIT, US << MARKET, 5054, 1, 445400)
(STARFRUIT, US << MARKET, 5054, 1, 445400)
(STARFRUIT, US << MARKET, 5054, 1, 445400)
(STARFRUIT, US << MARKET, 5054, 1, 445400)
(STARFRUIT, US << MARKET, 5054, 1, 445400)
(STARFRUIT, US << MARKET, 5054, 1, 445400)","{""AMETHYSTS"": 17, ""STARFRUIT"": 0}",2673,5054,10000
445700,-9896,-177223,"(AMETHYSTS, US << MARKET, 9998, 1, 445700)
(AMETHYSTS, US << MARKET, 9998, 1, 445700)
(STARFRUIT, MARKET << US, 5050, 1, 445700)
(STARFRUIT, MARKET << US, 5050, 1, 445700)","{""AMETHYSTS"": 19, ""STARFRUIT"": -2}",2622,5049,9997
446100,5050,-172173,"(STARFRUIT, MARKET << US, 5050, 1, 446100)","{""AMETHYSTS"": 19, ""STARFRUIT"": -3}",2680,5049,10000
446300,39992,-132181,"(AMETHYSTS, MARKET << US, 9998, 1, 446300)
(AMETHYSTS, MARKET << US, 9998, 1, 446300)
(AMETHYSTS, MARKET << US, 9998, 1, 446300)
(AMETHYSTS, MARKET << US, 9998, 1, 446300)","{""AMETHYSTS"": 15, ""STARFRUIT"": -3}",2603,5052,9996
446400,9998,-122183,"(AMETHYSTS, MARKET << US, 9998, 1, 446400)","{""AMETHYSTS"": 14, ""STARFRUIT"": -3}",2675,5052,10001
446600,-35357,-157540,"(STARFRUIT, US << MARKET, 5051, 1, 446600)
(STARFRUIT, US << MARKET, 5051, 1, 446600)
(STARFRUIT, US << MARKET, 5051, 1, 446600)
(STARFRUIT, US << MARKET, 5051, 1, 446600)
(STARFRUIT, US << MARKET, 5051, 1, 446600)
(STARFRUIT, US << MARKET, 5051, 1, 446600)
(STARFRUIT, US << MARKET, 5051, 1, 446600)","{""AMETHYSTS"": 14, ""STARFRUIT"": 4}",2628,5049,9998
446800,60012,-97528,"(AMETHYSTS, MARKET << US, 10002, 1, 446800)
(AMETHYSTS, MARKET << US, 10002, 1, 446800)
(AMETHYSTS, MARKET << US, 10002, 1, 446800)
(AMETHYSTS, MARKET << US, 10002, 1, 446800)
(AMETHYSTS, MARKET << US, 10002, 1, 446800)
(AMETHYSTS, MARKET << US, 10002, 1, 446800)","{""AMETHYSTS"": 8, ""STARFRUIT"": 4}",2692,5049,10003
447000,5053,-92475,"(STARFRUIT, MARKET << US, 5053, 1, 447000)","{""AMETHYSTS"": 8, ""STARFRUIT"": 3}",2678,5051,10000
447100,5053,-87422,"(STARFRUIT, MARKET << US, 5053, 1, 447100)","{""AMETHYSTS"": 8, ""STARFRUIT"": 2}",2684,5053,10000
447200,-25260,-112682,"(STARFRUIT, US << MARKET, 5052, 1, 447200)
(STARFRUIT, US << MARKET, 5052, 1, 447200)
(STARFRUIT, US << MARKET, 5052, 1, 447200)
(STARFRUIT, US << MARKET, 5052, 1, 447200)
(STARFRUIT, US << MARKET, 5052, 1, 447200)","{""AMETHYSTS"": 8, ""STARFRUIT"": 7}",2705,5053,10002
447800,25045,-87637,"(AMETHYSTS, US << MARKET, 9998, 1, 447800)
(AMETHYSTS, US << MARKET, 9998, 1, 447800)
(AMETHYSTS, US << MARKET, 9998, 1, 447800)
(AMETHYSTS, US << MARKET, 9998, 1, 447800)
(AMETHYSTS, MARKET << US, 9998, 1, 447800)
(AMETHYSTS, MARKET << US, 9998, 1, 447800)
(AMETHYSTS, MARKET << US, 9998, 1, 447800)
(AMETHYSTS, MARKET << US, 9998, 1, 447800)
(AMETHYSTS, MARKET << US, 9998, 1, 447800)
(AMETHYSTS, MARKET << US, 9998, 1, 447800)
(STARFRUIT, MARKET << US, 5049, 1, 447800)","{""AMETHYSTS"": 6, ""STARFRUIT"": 6}",2657,5048,10001
447900,5165,-82472,"(AMETHYSTS, US << MARKET, 10002, 1, 447900)
(STARFRUIT, US << MARKET, 5054, 1, 447900)
(STARFRUIT, US << MARKET, 5054, 1, 447900)
(STARFRUIT, MARKET << US, 5055, 1, 447900)
(STARFRUIT, MARKET << US, 5055, 1, 447900)
(STARFRUIT, MARKET << US, 5055, 1, 447900)
(STARFRUIT, MARKET << US, 5055, 1, 447900)
(STARFRUIT, MARKET << US, 5055, 1, 447900)","{""AMETHYSTS"": 7, ""STARFRUIT"": 3}",2711,5054,10003
448200,-20114,-102586,"(AMETHYSTS, US << MARKET, 10004, 1, 448200)
(STARFRUIT, US << MARKET, 5055, 1, 448200)
(STARFRUIT, US << MARKET, 5055, 1, 448200)","{""AMETHYSTS"": 8, ""STARFRUIT"": 5}",2669,5051,10000
448400,9998,-92588,"(AMETHYSTS, MARKET << US, 9998, 1, 448400)","{""AMETHYSTS"": 7, ""STARFRUIT"": 5}",2684,5053,10001
448600,-10002,-102590,"(AMETHYSTS, US << MARKET, 10002, 1, 448600)","{""AMETHYSTS"": 8, ""STARFRUIT"": 5}",2699,5053,10003
448800,-14946,-117536,"(AMETHYSTS, US << MARKET, 9998, 1, 448800)
(AMETHYSTS, US << MARKET, 9998, 1, 448800)
(STARFRUIT, MARKET << US, 5050, 1, 448800)","{""AMETHYSTS"": 10, ""STARFRUIT"": 4}",2620,5049,9996
449500,210117,92581,"(AMETHYSTS, US << MARKET, 10002, 1, 449500)
(AMETHYSTS, US << MARKET, 10002, 1, 449500)
(AMETHYSTS, US << MARKET, 10002, 1, 449500)
(AMETHYSTS, US << MARKET, 10002, 1, 449500)
(AMETHYSTS, US << MARKET, 10002, 1, 449500)
(AMETHYSTS, MARKET << US, 10005, 1, 449500)
(AMETHYSTS, MARKET << US, 10005, 1, 449500)
(AMETHYSTS, MARKET << US, 10005, 1, 449500)
(AMETHYSTS, MARKET << US, 10005, 1, 449500)
(AMETHYSTS, MARKET << US, 10005, 1, 449500)
(AMETHYSTS, MARKET << US, 10005, 1, 449500)
(AMETHYSTS, MARKET << US, 10005, 1, 449500)
(AMETHYSTS, MARKET << US, 10005, 1, 449500)
(AMETHYSTS, MARKET << US, 10005, 1, 449500)
(AMETHYSTS, MARKET << US, 10005, 1, 449500)
(AMETHYSTS, MARKET << US, 10005, 1, 449500)
(AMETHYSTS, MARKET << US, 10005, 1, 449500)
(AMETHYSTS, MARKET << US, 10005, 1, 449500)
(AMETHYSTS, MARKET << US, 10005, 1, 449500)
(AMETHYSTS, MARKET << US, 10005, 1, 449500)
(AMETHYSTS, MARKET << US, 10005, 1, 449500)
(AMETHYSTS, MARKET << US, 10005, 1, 449500)
(AMETHYSTS, MARKET << US, 10005, 1, 449500)
(AMETHYSTS, MARKET << US, 10005, 1, 449500)
(AMETHYSTS, MARKET << US, 10005, 1, 449500)
(AMETHYSTS, MARKET << US, 10005, 1, 449500)
(AMETHYSTS, MARKET << US, 10005, 1, 449500)
(AMETHYSTS, MARKET << US, 10005, 1, 449500)
(AMETHYSTS, MARKET << US, 10005, 1, 449500)
(AMETHYSTS, MARKET << US, 10005, 1, 449500)
(AMETHYSTS, MARKET << US, 10002, 1, 449500)","{""AMETHYSTS"": -11, ""STARFRUIT"": 4}",2768,5055,10003
449700,-179964,-87383,"(AMETHYSTS, US << MARKET, 9998, 1, 449700)
(AMETHYSTS, US << MARKET, 9998, 1, 449700)
(AMETHYSTS, US << MARKET, 9998, 1, 449700)
(AMETHYSTS, US << MARKET, 9998, 1, 449700)
(AMETHYSTS, US << MARKET, 9998, 1, 449700)
(AMETHYSTS, US << MARKET, 9998, 1, 449700)
(AMETHYSTS, US << MARKET, 9998, 1, 449700)
(AMETHYSTS, US << MARKET, 9998, 1, 449700)
(AMETHYSTS, US << MARKET, 9998, 1, 449700)
(AMETHYSTS, US << MARKET, 9998, 1, 449700)
(AMETHYSTS, US << MARKET, 9998, 1, 449700)
(AMETHYSTS, US << MARKET, 9998, 1, 449700)
(AMETHYSTS, US << MARKET, 9998, 1, 449700)
(AMETHYSTS, US << MARKET, 9998, 1, 449700)
(AMETHYSTS, US << MARKET, 9998, 1, 449700)
(AMETHYSTS, US << MARKET, 9998, 1, 449700)
(AMETHYSTS, US << MARKET, 9998, 1, 449700)
(AMETHYSTS, US << MARKET, 9998, 1, 449700)","{""AMETHYSTS"": 7, ""STARFRUIT"": 4}",2852,5057,10001
449900,15047,-72336,"(AMETHYSTS, MARKET << US, 9995, 1, 449900)
(STARFRUIT, MARKET << US, 5052, 1, 449900)","{""AMETHYSTS"": 6, ""STARFRUIT"": 3}",2814,5054,9998
450100,5057,-67279,"(STARFRUIT, MARKET << US, 5057, 1, 450100)","{""AMETHYSTS"": 6, ""STARFRUIT"": 2}",2829,5054,10000
450700,10002,-57277,"(AMETHYSTS, US << MARKET, 10004, 1, 450700)
(AMETHYSTS, US << MARKET, 10004, 1, 450700)
(AMETHYSTS, US << MARKET, 10004, 1, 450700)
(AMETHYSTS, US << MARKET, 10004, 1, 450700)
(AMETHYSTS, US << MARKET, 10004, 1, 450700)
(AMETHYSTS, MARKET << US, 10004, 1, 450700)
(AMETHYSTS, MARKET << US, 10004, 1, 450700)
(AMETHYSTS, MARKET << US, 10004, 1, 450700)
(AMETHYSTS, MARKET << US, 10004, 1, 450700)
(AMETHYSTS, MARKET << US, 10004, 1, 450700)
(AMETHYSTS, MARKET << US, 10002, 1, 450700)","{""AMETHYSTS"": 5, ""STARFRUIT"": 2}",2850,5056,10003
450900,10104,-47173,"(AMETHYSTS, US << MARKET, 9998, 1, 450900)
(AMETHYSTS, US << MARKET, 9998, 1, 450900)
(AMETHYSTS, MARKET << US, 9998, 1, 450900)
(AMETHYSTS, MARKET << US, 9998, 1, 450900)
(STARFRUIT, MARKET << US, 5052, 1, 450900)
(STARFRUIT, MARKET << US, 5052, 1, 450900)","{""AMETHYSTS"": 5, ""STARFRUIT"": 0}",2832,5054,10001
451400,-30312,-77485,"(STARFRUIT, US << MARKET, 5052, 1, 451400)
(STARFRUIT, US << MARKET, 5052, 1, 451400)
(STARFRUIT, US << MARKET, 5052, 1, 451400)
(STARFRUIT, US << MARKET, 5052, 1, 451400)
(STARFRUIT, US << MARKET, 5052, 1, 451400)
(STARFRUIT, US << MARKET, 5052, 1, 451400)","{""AMETHYSTS"": 5, ""STARFRUIT"": 6}",2821,5051,10000
451500,-50098,-127583,"(AMETHYSTS, US << MARKET, 9998, 1, 451500)
(AMETHYSTS, US << MARKET, 9998, 1, 451500)
(AMETHYSTS, US << MARKET, 9998, 1, 451500)
(AMETHYSTS, US << MARKET, 9998, 1, 451500)
(STARFRUIT, US << MARKET, 5053, 1, 451500)
(STARFRUIT, US << MARKET, 5053, 1, 451500)","{""AMETHYSTS"": 9, ""STARFRUIT"": 8}",2866,5055,10001
451600,10114,-117469,"(STARFRUIT, MARKET << US, 5057, 1, 451600)
(STARFRUIT, MARKET << US, 5057, 1, 451600)","{""AMETHYSTS"": 9, ""STARFRUIT"": 6}",2846,5054,9999
452000,80016,-37453,"(AMETHYSTS, MARKET << US, 10002, 1, 452000)
(AMETHYSTS, MARKET << US, 10002, 1, 452000)
(AMETHYSTS, MARKET << US, 10002, 1, 452000)
(AMETHYSTS, MARKET << US, 10002, 1, 452000)
(AMETHYSTS, MARKET << US, 10002, 1, 452000)
(AMETHYSTS, MARKET << US, 10002, 1, 452000)
(AMETHYSTS, MARKET << US, 10002, 1, 452000)
(AMETHYSTS, MARKET << US, 10002, 1, 452000)","{""AMETHYSTS"": 1, ""STARFRUIT"": 6}",2886,5056,10003
452100,-20212,-57665,"(STARFRUIT, US << MARKET, 5053, 1, 452100)
(STARFRUIT, US << MARKET, 5053, 1, 452100)
(STARFRUIT, US << MARKET, 5053, 1, 452100)
(STARFRUIT, US << MARKET, 5053, 1, 452100)","{""AMETHYSTS"": 1, ""STARFRUIT"": 10}",2895,5056,10000
452300,-20220,-77885,"(STARFRUIT, US << MARKET, 5055, 1, 452300)
(STARFRUIT, US << MARKET, 5055, 1, 452300)
(STARFRUIT, US << MARKET, 5055, 1, 452300)
(STARFRUIT, US << MARKET, 5055, 1, 452300)","{""AMETHYSTS"": 1, ""STARFRUIT"": 14}",2869,5054,9998
452500,20228,-57657,"(STARFRUIT, MARKET << US, 5057, 1, 452500)
(STARFRUIT, MARKET << US, 5057, 1, 452500)
(STARFRUIT, MARKET << US, 5057, 1, 452500)
(STARFRUIT, MARKET << US, 5057, 1, 452500)","{""AMETHYSTS"": 1, ""STARFRUIT"": 10}",2890,5055,9997
452900,-15165,-72822,"(STARFRUIT, US << MARKET, 5055, 1, 452900)
(STARFRUIT, US << MARKET, 5055, 1, 452900)
(STARFRUIT, US << MARKET, 5055, 1, 452900)
(STARFRUIT, US << MARKET, 5055, 1, 452900)
(STARFRUIT, MARKET << US, 5055, 1, 452900)","{""AMETHYSTS"": 1, ""STARFRUIT"": 13}",2930,5058,9998
453300,-14941,-87763,"(AMETHYSTS, US << MARKET, 9998, 1, 453300)
(AMETHYSTS, US << MARKET, 9998, 1, 453300)
(STARFRUIT, MARKET << US, 5055, 1, 453300)","{""AMETHYSTS"": 3, ""STARFRUIT"": 12}",2936,5058,10001
453400,228,-87535,"(AMETHYSTS, US << MARKET, 10005, 1, 453400)
(AMETHYSTS, US << MARKET, 10005, 1, 453400)
(STARFRUIT, MARKET << US, 5060, 1, 453400)
(STARFRUIT, MARKET << US, 5060, 1, 453400)
(STARFRUIT, MARKET << US, 5059, 1, 453400)
(STARFRUIT, MARKET << US, 5059, 1, 453400)","{""AMETHYSTS"": 5, ""STARFRUIT"": 8}",2913,5056,10000
453700,-5061,-92596,"(STARFRUIT, US << MARKET, 5061, 1, 453700)","{""AMETHYSTS"": 5, ""STARFRUIT"": 9}",2907,5057,9998
453800,-5056,-97652,"(STARFRUIT, US << MARKET, 5056, 1, 453800)","{""AMETHYSTS"": 5, ""STARFRUIT"": 10}",2953,5059,10003
453900,-5056,-102708,"(STARFRUIT, US << MARKET, 5056, 1, 453900)","{""AMETHYSTS"": 5, ""STARFRUIT"": 11}",2887,5055,9998
454100,35441,-67267,"(STARFRUIT, MARKET << US, 5063, 1, 454100)
(STARFRUIT, MARKET << US, 5063, 1, 454100)
(STARFRUIT, MARKET << US, 5063, 1, 454100)
(STARFRUIT, MARKET << US, 5063, 1, 454100)
(STARFRUIT, MARKET << US, 5063, 1, 454100)
(STARFRUIT, MARKET << US, 5063, 1, 454100)
(STARFRUIT, MARKET << US, 5063, 1, 454100)","{""AMETHYSTS"": 5, ""STARFRUIT"": 4}",2969,5059,10000
454500,-10002,-77269,"(AMETHYSTS, US << MARKET, 10002, 1, 454500)","{""AMETHYSTS"": 6, ""STARFRUIT"": 4}",2981,5058,10003
454800,-116,-77385,"(AMETHYSTS, MARKET << US, 9998, 1, 454800)
(STARFRUIT, US << MARKET, 5057, 1, 454800)
(STARFRUIT, US << MARKET, 5057, 1, 454800)","{""AMETHYSTS"": 5, ""STARFRUIT"": 6}",2980,5060,10001
455000,-20232,-97617,"(STARFRUIT, US << MARKET, 5058, 1, 455000)
(STARFRUIT, US << MARKET, 5058, 1, 455000)
(STARFRUIT, US << MARKET, 5058, 1, 455000)
(STARFRUIT, US << MARKET, 5058, 1, 455000)","{""AMETHYSTS"": 5, ""STARFRUIT"": 10}",2943,5057,9998
455200,4939,-92678,"(AMETHYSTS, MARKET << US, 9996, 1, 455200)
(STARFRUIT, US << MARKET, 5057, 1, 455200)","{""AMETHYSTS"": 4, ""STARFRUIT"": 11}",2971,5059,10000
455400,-20240,-112918,"(STARFRUIT, US << MARKET, 5060, 1, 455400)
(STARFRUIT, US << MARKET, 5060, 1, 455400)
(STARFRUIT, US << MARKET, 5060, 1, 455400)
(STARFRUIT, US << MARKET, 5060, 1, 455400)","{""AMETHYSTS"": 4, ""STARFRUIT"": 15}",2997,5061,10000
455500,5061,-107857,"(STARFRUIT, MARKET << US, 5061, 1, 455500)","{""AMETHYSTS"": 4, ""STARFRUIT"": 14}",2997,5061,10000
455600,-10002,-117859,"(AMETHYSTS, US << MARKET, 10002, 1, 455600)","{""AMETHYSTS"": 5, ""STARFRUIT"": 14}",2968,5058,10003
455700,9998,-107861,"(AMETHYSTS, MARKET << US, 9998, 1, 455700)","{""AMETHYSTS"": 4, ""STARFRUIT"": 14}",2967,5060,9997
455800,-19996,-127857,"(AMETHYSTS, US << MARKET, 9998, 1, 455800)
(AMETHYSTS, US << MARKET, 9998, 1, 455800)","{""AMETHYSTS"": 6, ""STARFRUIT"": 14}",2937,5058,9997
456500,-20228,-148085,"(STARFRUIT, US << MARKET, 5057, 1, 456500)
(STARFRUIT, US << MARKET, 5057, 1, 456500)
(STARFRUIT, US << MARKET, 5057, 1, 456500)
(STARFRUIT, US << MARKET, 5057, 1, 456500)","{""AMETHYSTS"": 6, ""STARFRUIT"": 18}",2977,5059,10000
456700,19996,-128089,"(AMETHYSTS, MARKET << US, 9998, 1, 456700)
(AMETHYSTS, MARKET << US, 9998, 1, 456700)","{""AMETHYSTS"": 4, ""STARFRUIT"": 18}",2961,5059,9997
457100,9998,-118091,"(AMETHYSTS, MARKET << US, 9998, 1, 457100)","{""AMETHYSTS"": 3, ""STARFRUIT"": 18}",2977,5060,9996
457900,-5059,-123150,"(STARFRUIT, US << MARKET, 5059, 1, 457900)","{""AMETHYSTS"": 3, ""STARFRUIT"": 19}",3028,5062,10000
458800,-5064,-128214,"(STARFRUIT, US << MARKET, 5064, 1, 458800)","{""AMETHYSTS"": 3, ""STARFRUIT"": 20}",3089,5065,10001
459200,50140,-78074,"(AMETHYSTS, MARKET << US, 10002, 1, 459200)
(AMETHYSTS, MARKET << US, 10002, 1, 459200)
(AMETHYSTS, MARKET << US, 10002, 1, 459200)
(AMETHYSTS, MARKET << US, 10002, 1, 459200)
(STARFRUIT, MARKET << US, 5066, 1, 459200)
(STARFRUIT, MARKET << US, 5066, 1, 459200)","{""AMETHYSTS"": -1, ""STARFRUIT"": 18}",3043,5062,9999
459600,-10002,-88076,"(AMETHYSTS, US << MARKET, 10002, 1, 459600)","{""AMETHYSTS"": 0, ""STARFRUIT"": 18}",3022,5061,10003
460000,-15069,-103145,"(AMETHYSTS, US << MARKET, 10004, 1, 460000)
(STARFRUIT, US << MARKET, 5065, 1, 460000)","{""AMETHYSTS"": 1, ""STARFRUIT"": 19}",3054,5063,10002
460100,5064,-98081,"(STARFRUIT, MARKET << US, 5064, 1, 460100)","{""AMETHYSTS"": 1, ""STARFRUIT"": 18}",3071,5064,10000
460500,5064,-93017,"(STARFRUIT, MARKET << US, 5064, 1, 460500)","{""AMETHYSTS"": 1, ""STARFRUIT"": 17}",3037,5062,10000
460700,-15177,-108194,"(STARFRUIT, US << MARKET, 5059, 1, 460700)
(STARFRUIT, US << MARKET, 5059, 1, 460700)
(STARFRUIT, US << MARKET, 5059, 1, 460700)","{""AMETHYSTS"": 1, ""STARFRUIT"": 20}",3026,5061,10000
461300,-14930,-123124,"(AMETHYSTS, US << MARKET, 9998, 1, 461300)
(AMETHYSTS, US << MARKET, 9998, 1, 461300)
(STARFRUIT, MARKET << US, 5066, 1, 461300)","{""AMETHYSTS"": 3, ""STARFRUIT"": 19}",3042,5062,9996
461500,54946,-68178,"(AMETHYSTS, MARKET << US, 10002, 1, 461500)
(AMETHYSTS, MARKET << US, 10002, 1, 461500)
(AMETHYSTS, MARKET << US, 10002, 1, 461500)
(AMETHYSTS, MARKET << US, 10002, 1, 461500)
(AMETHYSTS, MARKET << US, 10002, 1, 461500)
(AMETHYSTS, MARKET << US, 10002, 1, 461500)
(STARFRUIT, US << MARKET, 5066, 1, 461500)","{""AMETHYSTS"": -3, ""STARFRUIT"": 20}",3073,5063,10003
462000,-19996,-88174,"(AMETHYSTS, US << MARKET, 9998, 1, 462000)
(AMETHYSTS, US << MARKET, 9998, 1, 462000)","{""AMETHYSTS"": -1, ""STARFRUIT"": 20}",3124,5065,10002
462300,-19992,-108166,"(AMETHYSTS, US << MARKET, 9996, 1, 462300)
(AMETHYSTS, US << MARKET, 9996, 1, 462300)","{""AMETHYSTS"": 1, ""STARFRUIT"": 20}",3114,5064,10000
462700,20004,-88162,"(AMETHYSTS, MARKET << US, 10002, 1, 462700)
(AMETHYSTS, MARKET << US, 10002, 1, 462700)","{""AMETHYSTS"": -1, ""STARFRUIT"": 20}",3115,5064,10003
462900,-59988,-148150,"(AMETHYSTS, US << MARKET, 9998, 1, 462900)
(AMETHYSTS, US << MARKET, 9998, 1, 462900)
(AMETHYSTS, US << MARKET, 9998, 1, 462900)
(AMETHYSTS, US << MARKET, 9998, 1, 462900)
(AMETHYSTS, US << MARKET, 9998, 1, 462900)
(AMETHYSTS, US << MARKET, 9998, 1, 462900)","{""AMETHYSTS"": 5, ""STARFRUIT"": 20}",3135,5065,9997
463000,-44945,-193095,"(AMETHYSTS, US << MARKET, 10002, 1, 463000)
(AMETHYSTS, US << MARKET, 10002, 1, 463000)
(AMETHYSTS, US << MARKET, 10002, 1, 463000)
(AMETHYSTS, US << MARKET, 10002, 1, 463000)
(AMETHYSTS, US << MARKET, 10004, 1, 463000)
(STARFRUIT, MARKET << US, 5067, 1, 463000)","{""AMETHYSTS"": 10, ""STARFRUIT"": 19}",3151,5064,10003
463100,39992,-153103,"(AMETHYSTS, MARKET << US, 9998, 1, 463100)
(AMETHYSTS, MARKET << US, 9998, 1, 463100)
(AMETHYSTS, MARKET << US, 9998, 1, 463100)
(AMETHYSTS, MARKET << US, 9998, 1, 463100)","{""AMETHYSTS"": 6, ""STARFRUIT"": 19}",3070,5063,9996
463300,-5061,-158164,"(STARFRUIT, US << MARKET, 5061, 1, 463300)","{""AMETHYSTS"": 6, ""STARFRUIT"": 20}",3116,5064,10000
463800,-10002,-168166,"(AMETHYSTS, US << MARKET, 10002, 1, 463800)","{""AMETHYSTS"": 7, ""STARFRUIT"": 20}",3115,5063,10003
464000,-99980,-268146,"(AMETHYSTS, US << MARKET, 9998, 1, 464000)
(AMETHYSTS, US << MARKET, 9998, 1, 464000)
(AMETHYSTS, US << MARKET, 9998, 1, 464000)
(AMETHYSTS, US << MARKET, 9998, 1, 464000)
(AMETHYSTS, US << MARKET, 9998, 1, 464000)
(AMETHYSTS, US << MARKET, 9998, 1, 464000)
(AMETHYSTS, US << MARKET, 9998, 1, 464000)
(AMETHYSTS, US << MARKET, 9998, 1, 464000)
(AMETHYSTS, US << MARKET, 9998, 1, 464000)
(AMETHYSTS, US << MARKET, 9998, 1, 464000)","{""AMETHYSTS"": 17, ""STARFRUIT"": 20}",3063,5063,9997
464300,5061,-263085,"(STARFRUIT, MARKET << US, 5061, 1, 464300)","{""AMETHYSTS"": 17, ""STARFRUIT"": 19}",3093,5062,10000
464500,55611,-207474,"(AMETHYSTS, US << MARKET, 9998, 1, 464500)
(AMETHYSTS, US << MARKET, 9998, 1, 464500)
(AMETHYSTS, US << MARKET, 9998, 1, 464500)
(AMETHYSTS, MARKET << US, 10004, 1, 464500)
(AMETHYSTS, MARKET << US, 10004, 1, 464500)
(AMETHYSTS, MARKET << US, 10004, 1, 464500)
(AMETHYSTS, MARKET << US, 10004, 1, 464500)
(STARFRUIT, MARKET << US, 5067, 1, 464500)
(STARFRUIT, MARKET << US, 5067, 1, 464500)
(STARFRUIT, MARKET << US, 5065, 1, 464500)
(STARFRUIT, MARKET << US, 5065, 1, 464500)
(STARFRUIT, MARKET << US, 5065, 1, 464500)
(STARFRUIT, MARKET << US, 5065, 1, 464500)
(STARFRUIT, MARKET << US, 5065, 1, 464500)
(STARFRUIT, MARKET << US, 5065, 1, 464500)
(STARFRUIT, MARKET << US, 5065, 1, 464500)","{""AMETHYSTS"": 16, ""STARFRUIT"": 10}",3202,5066,10001
464700,-10002,-217476,"(AMETHYSTS, US << MARKET, 10002, 1, 464700)","{""AMETHYSTS"": 17, ""STARFRUIT"": 10}",3195,5062,10003
465000,29994,-187482,"(AMETHYSTS, MARKET << US, 9998, 1, 465000)
(AMETHYSTS, MARKET << US, 9998, 1, 465000)
(AMETHYSTS, MARKET << US, 9998, 1, 465000)","{""AMETHYSTS"": 14, ""STARFRUIT"": 10}",3096,5062,9997
465100,30396,-157086,"(STARFRUIT, MARKET << US, 5066, 1, 465100)
(STARFRUIT, MARKET << US, 5066, 1, 465100)
(STARFRUIT, MARKET << US, 5066, 1, 465100)
(STARFRUIT, MARKET << US, 5066, 1, 465100)
(STARFRUIT, MARKET << US, 5066, 1, 465100)
(STARFRUIT, MARKET << US, 5066, 1, 465100)","{""AMETHYSTS"": 14, ""STARFRUIT"": 4}",3176,5062,10001
465200,9998,-147088,"(AMETHYSTS, MARKET << US, 9998, 1, 465200)","{""AMETHYSTS"": 13, ""STARFRUIT"": 4}",3121,5062,9997
465600,-45042,-192130,"(AMETHYSTS, US << MARKET, 9996, 1, 465600)
(AMETHYSTS, US << MARKET, 9996, 1, 465600)
(AMETHYSTS, US << MARKET, 9996, 1, 465600)
(AMETHYSTS, US << MARKET, 9996, 1, 465600)
(STARFRUIT, US << MARKET, 5058, 1, 465600)
(STARFRUIT, US << MARKET, 5058, 1, 465600)
(STARFRUIT, MARKET << US, 5058, 1, 465600)","{""AMETHYSTS"": 17, ""STARFRUIT"": 5}",3175,5061,10000
465700,15189,-176941,"(STARFRUIT, US << MARKET, 5063, 1, 465700)
(STARFRUIT, US << MARKET, 5063, 1, 465700)
(STARFRUIT, MARKET << US, 5063, 1, 465700)
(STARFRUIT, MARKET << US, 5063, 1, 465700)
(STARFRUIT, MARKET << US, 5063, 1, 465700)
(STARFRUIT, MARKET << US, 5063, 1, 465700)
(STARFRUIT, MARKET << US, 5063, 1, 465700)","{""AMETHYSTS"": 17, ""STARFRUIT"": 2}",3187,5064,10000
465800,9998,-166943,"(AMETHYSTS, MARKET << US, 9998, 1, 465800)","{""AMETHYSTS"": 16, ""STARFRUIT"": 2}",3197,5062,10001
466000,-19996,-186939,"(AMETHYSTS, US << MARKET, 9998, 1, 466000)
(AMETHYSTS, US << MARKET, 9998, 1, 466000)","{""AMETHYSTS"": 18, ""STARFRUIT"": 2}",3223,5063,10002
466200,-242,-187181,"(AMETHYSTS, MARKET << US, 9995, 1, 466200)
(AMETHYSTS, MARKET << US, 9995, 1, 466200)
(STARFRUIT, US << MARKET, 5058, 1, 466200)
(STARFRUIT, US << MARKET, 5058, 1, 466200)
(STARFRUIT, US << MARKET, 5058, 1, 466200)
(STARFRUIT, US << MARKET, 5058, 1, 466200)","{""AMETHYSTS"": 16, ""STARFRUIT"": 6}",3185,5061,10000
466300,-20008,-207189,"(AMETHYSTS, US << MARKET, 10004, 1, 466300)
(AMETHYSTS, US << MARKET, 10004, 1, 466300)","{""AMETHYSTS"": 18, ""STARFRUIT"": 6}",3183,5062,10000
466400,20004,-187185,"(AMETHYSTS, MARKET << US, 10002, 1, 466400)
(AMETHYSTS, MARKET << US, 10002, 1, 466400)","{""AMETHYSTS"": 16, ""STARFRUIT"": 6}",3235,5062,10003
466600,-132,-187317,"(AMETHYSTS, MARKET << US, 9996, 1, 466600)
(STARFRUIT, US << MARKET, 5064, 1, 466600)
(STARFRUIT, US << MARKET, 5064, 1, 466600)","{""AMETHYSTS"": 15, ""STARFRUIT"": 8}",3203,5065,10000
466800,20004,-167313,"(AMETHYSTS, MARKET << US, 10002, 1, 466800)
(AMETHYSTS, MARKET << US, 10002, 1, 466800)","{""AMETHYSTS"": 13, ""STARFRUIT"": 8}",3214,5061,10003
466900,-34933,-202246,"(AMETHYSTS, US << MARKET, 9998, 1, 466900)
(AMETHYSTS, US << MARKET, 9998, 1, 466900)
(AMETHYSTS, US << MARKET, 9998, 1, 466900)
(AMETHYSTS, US << MARKET, 9998, 1, 466900)
(STARFRUIT, MARKET << US, 5059, 1, 466900)","{""AMETHYSTS"": 17, ""STARFRUIT"": 7}",3092,5058,9996
467000,5060,-197186,"(STARFRUIT, MARKET << US, 5060, 1, 467000)","{""AMETHYSTS"": 17, ""STARFRUIT"": 6}",3168,5059,10000
467200,-10002,-207188,"(AMETHYSTS, US << MARKET, 10002, 1, 467200)","{""AMETHYSTS"": 18, ""STARFRUIT"": 6}",3238,5062,10003
467800,-15186,-222374,"(STARFRUIT, US << MARKET, 5062, 1, 467800)
(STARFRUIT, US << MARKET, 5062, 1, 467800)
(STARFRUIT, US << MARKET, 5062, 1, 467800)","{""AMETHYSTS"": 18, ""STARFRUIT"": 9}",3211,5063,10001
467900,-5057,-227431,"(STARFRUIT, US << MARKET, 5057, 1, 467900)","{""AMETHYSTS"": 18, ""STARFRUIT"": 10}",3169,5060,10000
468600,-20252,-247683,"(STARFRUIT, US << MARKET, 5063, 1, 468600)
(STARFRUIT, US << MARKET, 5063, 1, 468600)
(STARFRUIT, US << MARKET, 5063, 1, 468600)
(STARFRUIT, US << MARKET, 5063, 1, 468600)","{""AMETHYSTS"": 18, ""STARFRUIT"": 14}",3143,5059,10000
468800,-10004,-257687,"(AMETHYSTS, US << MARKET, 10004, 1, 468800)","{""AMETHYSTS"": 19, ""STARFRUIT"": 14}",3186,5061,10001
469100,-5062,-262749,"(STARFRUIT, US << MARKET, 5062, 1, 469100)","{""AMETHYSTS"": 19, ""STARFRUIT"": 15}",3196,5063,10000
469900,14947,-247802,"(AMETHYSTS, MARKET << US, 10002, 1, 469900)
(AMETHYSTS, MARKET << US, 10002, 1, 469900)
(STARFRUIT, US << MARKET, 5057, 1, 469900)","{""AMETHYSTS"": 17, ""STARFRUIT"": 16}",3177,5058,10003
470000,35193,-212609,"(AMETHYSTS, MARKET << US, 10004, 1, 470000)
(AMETHYSTS, MARKET << US, 10004, 1, 470000)
(STARFRUIT, MARKET << US, 5063, 1, 470000)
(STARFRUIT, MARKET << US, 5061, 1, 470000)
(STARFRUIT, MARKET << US, 5061, 1, 470000)","{""AMETHYSTS"": 15, ""STARFRUIT"": 13}",3212,5062,10001
470600,5055,-207554,"(STARFRUIT, MARKET << US, 5055, 1, 470600)","{""AMETHYSTS"": 15, ""STARFRUIT"": 12}",3142,5058,10000
470900,5059,-202495,"(STARFRUIT, MARKET << US, 5059, 1, 470900)","{""AMETHYSTS"": 15, ""STARFRUIT"": 11}",3154,5059,10000
471200,45549,-156946,"(STARFRUIT, MARKET << US, 5061, 1, 471200)
(STARFRUIT, MARKET << US, 5061, 1, 471200)
(STARFRUIT, MARKET << US, 5061, 1, 471200)
(STARFRUIT, MARKET << US, 5061, 1, 471200)
(STARFRUIT, MARKET << US, 5061, 1, 471200)
(STARFRUIT, MARKET << US, 5061, 1, 471200)
(STARFRUIT, MARKET << US, 5061, 1, 471200)
(STARFRUIT, MARKET << US, 5061, 1, 471200)
(STARFRUIT, MARKET << US, 5061, 1, 471200)","{""AMETHYSTS"": 15, ""STARFRUIT"": 2}",3168,5057,10000
471500,60252,-96694,"(AMETHYSTS, MARKET << US, 10004, 1, 471500)
(AMETHYSTS, MARKET << US, 10004, 1, 471500)
(AMETHYSTS, MARKET << US, 10004, 1, 471500)
(AMETHYSTS, MARKET << US, 10004, 1, 471500)
(STARFRUIT, MARKET << US, 5059, 1, 471500)
(STARFRUIT, MARKET << US, 5059, 1, 471500)
(STARFRUIT, MARKET << US, 5059, 1, 471500)
(STARFRUIT, MARKET << US, 5059, 1, 471500)","{""AMETHYSTS"": 11, ""STARFRUIT"": -2}",3194,5056,10000
471600,10118,-86576,"(STARFRUIT, MARKET << US, 5059, 1, 471600)
(STARFRUIT, MARKET << US, 5059, 1, 471600)","{""AMETHYSTS"": 11, ""STARFRUIT"": -4}",3210,5059,10002
472300,-19998,-106574,"(AMETHYSTS, US << MARKET, 9998, 1, 472300)
(AMETHYSTS, US << MARKET, 9998, 1, 472300)
(STARFRUIT, US << MARKET, 5055, 1, 472300)
(STARFRUIT, US << MARKET, 5055, 1, 472300)
(STARFRUIT, MARKET << US, 5054, 1, 472300)
(STARFRUIT, MARKET << US, 5054, 1, 472300)","{""AMETHYSTS"": 13, ""STARFRUIT"": -4}",3223,5054,10001
472400,9998,-96576,"(AMETHYSTS, MARKET << US, 9998, 1, 472400)","{""AMETHYSTS"": 12, ""STARFRUIT"": -4}",3152,5056,9996
472500,10112,-86464,"(STARFRUIT, MARKET << US, 5056, 1, 472500)
(STARFRUIT, MARKET << US, 5056, 1, 472500)","{""AMETHYSTS"": 12, ""STARFRUIT"": -6}",3206,5055,10000
473000,-10112,-96576,"(STARFRUIT, US << MARKET, 5056, 1, 473000)
(STARFRUIT, US << MARKET, 5056, 1, 473000)","{""AMETHYSTS"": 12, ""STARFRUIT"": -4}",3192,5058,10000
473100,50128,-46448,"(AMETHYSTS, MARKET << US, 10004, 1, 473100)
(AMETHYSTS, MARKET << US, 10004, 1, 473100)
(AMETHYSTS, MARKET << US, 10004, 1, 473100)
(AMETHYSTS, MARKET << US, 10004, 1, 473100)
(STARFRUIT, MARKET << US, 5056, 1, 473100)
(STARFRUIT, MARKET << US, 5056, 1, 473100)","{""AMETHYSTS"": 8, ""STARFRUIT"": -6}",3206,5059,10001
473200,5057,-41391,"(STARFRUIT, MARKET << US, 5057, 1, 473200)","{""AMETHYSTS"": 8, ""STARFRUIT"": -7}",3217,5056,10000
473300,-40256,-81647,"(AMETHYSTS, US << MARKET, 10002, 1, 473300)
(AMETHYSTS, US << MARKET, 10002, 1, 473300)
(STARFRUIT, US << MARKET, 5063, 1, 473300)
(STARFRUIT, US << MARKET, 5063, 1, 473300)
(STARFRUIT, US << MARKET, 5063, 1, 473300)
(STARFRUIT, US << MARKET, 5063, 1, 473300)","{""AMETHYSTS"": 10, ""STARFRUIT"": -3}",3163,5060,9999
473500,19996,-61651,"(AMETHYSTS, MARKET << US, 9998, 1, 473500)
(AMETHYSTS, MARKET << US, 9998, 1, 473500)","{""AMETHYSTS"": 8, ""STARFRUIT"": -3}",3142,5061,9997
473600,50126,-11525,"(AMETHYSTS, MARKET << US, 10002, 1, 473600)
(AMETHYSTS, MARKET << US, 10002, 1, 473600)
(AMETHYSTS, MARKET << US, 10002, 1, 473600)
(AMETHYSTS, MARKET << US, 10002, 1, 473600)
(STARFRUIT, MARKET << US, 5059, 1, 473600)
(STARFRUIT, MARKET << US, 5059, 1, 473600)","{""AMETHYSTS"": 4, ""STARFRUIT"": -5}",3177,5058,9998
473800,80032,68507,"(AMETHYSTS, MARKET << US, 10004, 1, 473800)
(AMETHYSTS, MARKET << US, 10004, 1, 473800)
(AMETHYSTS, MARKET << US, 10004, 1, 473800)
(AMETHYSTS, MARKET << US, 10004, 1, 473800)
(AMETHYSTS, MARKET << US, 10004, 1, 473800)
(AMETHYSTS, MARKET << US, 10004, 1, 473800)
(AMETHYSTS, MARKET << US, 10004, 1, 473800)
(AMETHYSTS, MARKET << US, 10004, 1, 473800)","{""AMETHYSTS"": -4, ""STARFRUIT"": -5}",3198,5061,10001
473900,5058,73565,"(STARFRUIT, MARKET << US, 5058, 1, 473900)","{""AMETHYSTS"": -4, ""STARFRUIT"": -6}",3195,5061,10001
474600,-10002,63563,"(AMETHYSTS, US << MARKET, 10002, 1, 474600)","{""AMETHYSTS"": -3, ""STARFRUIT"": -6}",3197,5062,9998
475000,-10116,53447,"(STARFRUIT, US << MARKET, 5058, 1, 475000)
(STARFRUIT, US << MARKET, 5058, 1, 475000)","{""AMETHYSTS"": -3, ""STARFRUIT"": -4}",3207,5060,10000
475500,-10002,43445,"(AMETHYSTS, US << MARKET, 10002, 1, 475500)","{""AMETHYSTS"": -2, ""STARFRUIT"": -4}",3195,5061,10003
475700,-2,43443,"(STARFRUIT, US << MARKET, 5059, 1, 475700)
(STARFRUIT, US << MARKET, 5059, 1, 475700)
(STARFRUIT, MARKET << US, 5058, 1, 475700)
(STARFRUIT, MARKET << US, 5058, 1, 475700)","{""AMETHYSTS"": -2, ""STARFRUIT"": -4}",3211,5058,10000
476600,100040,143483,"(AMETHYSTS, US << MARKET, 10004, 1, 476600)
(AMETHYSTS, US << MARKET, 10004, 1, 476600)
(AMETHYSTS, MARKET << US, 10004, 1, 476600)
(AMETHYSTS, MARKET << US, 10004, 1, 476600)
(AMETHYSTS, MARKET << US, 10004, 1, 476600)
(AMETHYSTS, MARKET << US, 10004, 1, 476600)
(AMETHYSTS, MARKET << US, 10004, 1, 476600)
(AMETHYSTS, MARKET << US, 10004, 1, 476600)
(AMETHYSTS, MARKET << US, 10004, 1, 476600)
(AMETHYSTS, MARKET << US, 10004, 1, 476600)
(AMETHYSTS, MARKET << US, 10004, 1, 476600)
(AMETHYSTS, MARKET << US, 10004, 1, 476600)
(AMETHYSTS, MARKET << US, 10004, 1, 476600)
(AMETHYSTS, MARKET << US, 10004, 1, 476600)","{""AMETHYSTS"": -12, ""STARFRUIT"": -4}",3239,5061,10000
476700,5063,148546,"(STARFRUIT, MARKET << US, 5063, 1, 476700)","{""AMETHYSTS"": -12, ""STARFRUIT"": -5}",3251,5059,10000
477000,5062,153608,"(STARFRUIT, MARKET << US, 5062, 1, 477000)","{""AMETHYSTS"": -12, ""STARFRUIT"": -6}",3230,5063,10000
477100,5057,158665,"(STARFRUIT, MARKET << US, 5057, 1, 477100)","{""AMETHYSTS"": -12, ""STARFRUIT"": -7}",3221,5060,10002
477400,25074,183739,"(AMETHYSTS, MARKET << US, 10005, 1, 477400)
(AMETHYSTS, MARKET << US, 10005, 1, 477400)
(STARFRUIT, MARKET << US, 5064, 1, 477400)","{""AMETHYSTS"": -14, ""STARFRUIT"": -8}",3245,5060,10001
477600,-10114,173625,"(STARFRUIT, US << MARKET, 5057, 1, 477600)
(STARFRUIT, US << MARKET, 5057, 1, 477600)","{""AMETHYSTS"": -14, ""STARFRUIT"": -6}",3313,5059,9997
477700,-40504,133121,"(STARFRUIT, US << MARKET, 5063, 1, 477700)
(STARFRUIT, US << MARKET, 5063, 1, 477700)
(STARFRUIT, US << MARKET, 5063, 1, 477700)
(STARFRUIT, US << MARKET, 5063, 1, 477700)
(STARFRUIT, US << MARKET, 5063, 1, 477700)
(STARFRUIT, US << MARKET, 5063, 1, 477700)
(STARFRUIT, US << MARKET, 5063, 1, 477700)
(STARFRUIT, US << MARKET, 5063, 1, 477700)","{""AMETHYSTS"": -14, ""STARFRUIT"": 2}",3241,5060,10000
477800,10002,143123,"(AMETHYSTS, US << MARKET, 10002, 1, 477800)
(AMETHYSTS, MARKET << US, 10002, 1, 477800)
(AMETHYSTS, MARKET << US, 10002, 1, 477800)","{""AMETHYSTS"": -15, ""STARFRUIT"": 2}",3271,5059,9998
477900,-25305,117818,"(STARFRUIT, US << MARKET, 5061, 1, 477900)
(STARFRUIT, US << MARKET, 5061, 1, 477900)
(STARFRUIT, US << MARKET, 5061, 1, 477900)
(STARFRUIT, US << MARKET, 5061, 1, 477900)
(STARFRUIT, US << MARKET, 5061, 1, 477900)","{""AMETHYSTS"": -15, ""STARFRUIT"": 7}",3245,5061,10000
478000,9998,127816,"(AMETHYSTS, MARKET << US, 9998, 1, 478000)","{""AMETHYSTS"": -16, ""STARFRUIT"": 7}",3220,5060,10001
478100,40020,167836,"(AMETHYSTS, MARKET << US, 10005, 1, 478100)
(AMETHYSTS, MARKET << US, 10005, 1, 478100)
(AMETHYSTS, MARKET << US, 10005, 1, 478100)
(AMETHYSTS, MARKET << US, 10005, 1, 478100)","{""AMETHYSTS"": -20, ""STARFRUIT"": 7}",3236,5060,10001
478200,0,167836,,"{""AMETHYSTS"": -20, ""STARFRUIT"": 7}",3309,5059,9997
478800,15182,183018,"(STARFRUIT, MARKET << US, 5062, 1, 478800)
(STARFRUIT, MARKET << US, 5060, 1, 478800)
(STARFRUIT, MARKET << US, 5060, 1, 478800)","{""AMETHYSTS"": -20, ""STARFRUIT"": 4}",3290,5058,9998
479500,-15165,167853,"(STARFRUIT, US << MARKET, 5055, 1, 479500)
(STARFRUIT, US << MARKET, 5055, 1, 479500)
(STARFRUIT, US << MARKET, 5055, 1, 479500)","{""AMETHYSTS"": -20, ""STARFRUIT"": 7}",3292,5057,9998
479700,15174,183027,"(STARFRUIT, MARKET << US, 5058, 1, 479700)
(STARFRUIT, MARKET << US, 5058, 1, 479700)
(STARFRUIT, MARKET << US, 5058, 1, 479700)","{""AMETHYSTS"": -20, ""STARFRUIT"": 4}",3275,5057,9999
480000,5062,188089,"(STARFRUIT, MARKET << US, 5062, 1, 480000)","{""AMETHYSTS"": -20, ""STARFRUIT"": 3}",3263,5058,10000
480200,0,188089,,"{""AMETHYSTS"": -20, ""STARFRUIT"": 3}",3306,5059,9998
480700,-10108,177981,"(STARFRUIT, US << MARKET, 5054, 1, 480700)
(STARFRUIT, US << MARKET, 5054, 1, 480700)","{""AMETHYSTS"": -20, ""STARFRUIT"": 5}",3251,5058,10001
480800,-10110,167871,"(STARFRUIT, US << MARKET, 5055, 1, 480800)
(STARFRUIT, US << MARKET, 5055, 1, 480800)","{""AMETHYSTS"": -20, ""STARFRUIT"": 7}",3217,5058,10003
481300,-5058,162813,"(STARFRUIT, US << MARKET, 5058, 1, 481300)","{""AMETHYSTS"": -20, ""STARFRUIT"": 8}",3285,5054,9998
481600,-10002,152811,"(AMETHYSTS, US << MARKET, 10002, 1, 481600)","{""AMETHYSTS"": -19, ""STARFRUIT"": 8}",3210,5057,10003
481900,-115,152696,"(AMETHYSTS, MARKET << US, 10005, 1, 481900)
(STARFRUIT, US << MARKET, 5060, 1, 481900)
(STARFRUIT, US << MARKET, 5060, 1, 481900)","{""AMETHYSTS"": -20, ""STARFRUIT"": 10}",3236,5056,10001
482000,-5053,147643,"(STARFRUIT, US << MARKET, 5053, 1, 482000)","{""AMETHYSTS"": -20, ""STARFRUIT"": 11}",3199,5056,10003
482700,-4946,142697,"(AMETHYSTS, US << MARKET, 10004, 1, 482700)
(STARFRUIT, MARKET << US, 5058, 1, 482700)","{""AMETHYSTS"": -19, ""STARFRUIT"": 10}",3247,5055,10000
483000,-4835,137862,"(AMETHYSTS, US << MARKET, 10002, 1, 483000)
(AMETHYSTS, US << MARKET, 10002, 1, 483000)
(AMETHYSTS, US << MARKET, 10002, 1, 483000)
(AMETHYSTS, MARKET << US, 10002, 1, 483000)
(STARFRUIT, MARKET << US, 5057, 1, 483000)
(STARFRUIT, MARKET << US, 5056, 1, 483000)
(STARFRUIT, MARKET << US, 5056, 1, 483000)","{""AMETHYSTS"": -17, ""STARFRUIT"": 7}",3182,5053,10003
483300,35058,172920,"(AMETHYSTS, MARKET << US, 10002, 1, 483300)
(AMETHYSTS, MARKET << US, 10002, 1, 483300)
(AMETHYSTS, MARKET << US, 10002, 1, 483300)
(STARFRUIT, MARKET << US, 5052, 1, 483300)","{""AMETHYSTS"": -20, ""STARFRUIT"": 6}",3166,5051,10003
483400,-20108,152812,"(AMETHYSTS, US << MARKET, 10000, 1, 483400)
(STARFRUIT, US << MARKET, 5054, 1, 483400)
(STARFRUIT, US << MARKET, 5054, 1, 483400)","{""AMETHYSTS"": -19, ""STARFRUIT"": 8}",3222,5056,10002
483900,-4946,147866,"(AMETHYSTS, US << MARKET, 10004, 1, 483900)
(STARFRUIT, MARKET << US, 5058, 1, 483900)","{""AMETHYSTS"": -18, ""STARFRUIT"": 7}",3251,5055,10000
484000,5052,152918,"(STARFRUIT, MARKET << US, 5052, 1, 484000)","{""AMETHYSTS"": -18, ""STARFRUIT"": 6}",3224,5051,10000
484200,-19996,132922,"(AMETHYSTS, US << MARKET, 9998, 1, 484200)
(AMETHYSTS, US << MARKET, 9998, 1, 484200)","{""AMETHYSTS"": -16, ""STARFRUIT"": 6}",3310,5054,9996
484300,-19996,112926,"(AMETHYSTS, US << MARKET, 9998, 1, 484300)
(AMETHYSTS, US << MARKET, 9998, 1, 484300)","{""AMETHYSTS"": -14, ""STARFRUIT"": 6}",3248,5056,10001
484500,15048,127974,"(AMETHYSTS, MARKET << US, 9998, 1, 484500)
(STARFRUIT, MARKET << US, 5050, 1, 484500)","{""AMETHYSTS"": -15, ""STARFRUIT"": 5}",3289,5054,9997
484700,-10002,117972,"(AMETHYSTS, US << MARKET, 10002, 1, 484700)","{""AMETHYSTS"": -14, ""STARFRUIT"": 5}",3260,5052,9998
485200,50130,168102,"(AMETHYSTS, MARKET << US, 10004, 1, 485200)
(AMETHYSTS, MARKET << US, 10004, 1, 485200)
(AMETHYSTS, MARKET << US, 10004, 1, 485200)
(AMETHYSTS, MARKET << US, 10004, 1, 485200)
(STARFRUIT, MARKET << US, 5057, 1, 485200)
(STARFRUIT, MARKET << US, 5057, 1, 485200)","{""AMETHYSTS"": -18, ""STARFRUIT"": 3}",3264,5054,10000
485300,-35273,132829,"(AMETHYSTS, US << MARKET, 9998, 1, 485300)
(AMETHYSTS, US << MARKET, 9998, 1, 485300)
(AMETHYSTS, MARKET << US, 9998, 1, 485300)
(STARFRUIT, US << MARKET, 5055, 1, 485300)
(STARFRUIT, US << MARKET, 5055, 1, 485300)
(STARFRUIT, US << MARKET, 5055, 1, 485300)
(STARFRUIT, US << MARKET, 5055, 1, 485300)
(STARFRUIT, US << MARKET, 5055, 1, 485300)","{""AMETHYSTS"": -17, ""STARFRUIT"": 8}",3328,5056,9997
485600,-50010,82819,"(AMETHYSTS, US << MARKET, 10002, 1, 485600)
(AMETHYSTS, US << MARKET, 10002, 1, 485600)
(AMETHYSTS, US << MARKET, 10002, 1, 485600)
(AMETHYSTS, US << MARKET, 10002, 1, 485600)
(AMETHYSTS, US << MARKET, 10002, 1, 485600)","{""AMETHYSTS"": -12, ""STARFRUIT"": 8}",3223,5055,10003
485700,-5052,77767,"(STARFRUIT, US << MARKET, 5052, 1, 485700)","{""AMETHYSTS"": -12, ""STARFRUIT"": 9}",3226,5051,10000
486500,-19996,57771,"(AMETHYSTS, US << MARKET, 9998, 1, 486500)
(AMETHYSTS, US << MARKET, 9998, 1, 486500)","{""AMETHYSTS"": -10, ""STARFRUIT"": 9}",3265,5056,10001
486600,-30130,27641,"(AMETHYSTS, US << MARKET, 10005, 1, 486600)
(AMETHYSTS, US << MARKET, 10005, 1, 486600)
(STARFRUIT, US << MARKET, 5060, 1, 486600)
(STARFRUIT, US << MARKET, 5060, 1, 486600)","{""AMETHYSTS"": -8, ""STARFRUIT"": 11}",3290,5059,10000
487200,54954,82595,"(AMETHYSTS, MARKET << US, 10002, 1, 487200)
(AMETHYSTS, MARKET << US, 10002, 1, 487200)
(AMETHYSTS, MARKET << US, 10002, 1, 487200)
(AMETHYSTS, MARKET << US, 10002, 1, 487200)
(AMETHYSTS, MARKET << US, 10002, 1, 487200)
(AMETHYSTS, MARKET << US, 10002, 1, 487200)
(STARFRUIT, US << MARKET, 5058, 1, 487200)","{""AMETHYSTS"": -14, ""STARFRUIT"": 12}",3249,5058,10003
487400,4944,87539,"(AMETHYSTS, MARKET << US, 9995, 1, 487400)
(STARFRUIT, US << MARKET, 5051, 1, 487400)","{""AMETHYSTS"": -15, ""STARFRUIT"": 13}",3228,5053,10000
487600,-110044,-22505,"(AMETHYSTS, US << MARKET, 10004, 1, 487600)
(AMETHYSTS, US << MARKET, 10004, 1, 487600)
(AMETHYSTS, US << MARKET, 10004, 1, 487600)
(AMETHYSTS, US << MARKET, 10004, 1, 487600)
(AMETHYSTS, US << MARKET, 10004, 1, 487600)
(AMETHYSTS, US << MARKET, 10004, 1, 487600)
(AMETHYSTS, US << MARKET, 10004, 1, 487600)
(AMETHYSTS, US << MARKET, 10004, 1, 487600)
(AMETHYSTS, US << MARKET, 10004, 1, 487600)
(AMETHYSTS, US << MARKET, 10004, 1, 487600)
(AMETHYSTS, US << MARKET, 10004, 1, 487600)","{""AMETHYSTS"": -4, ""STARFRUIT"": 13}",3197,5054,10000
488200,-10002,-32507,"(AMETHYSTS, US << MARKET, 10002, 1, 488200)","{""AMETHYSTS"": -3, ""STARFRUIT"": 13}",3185,5053,9999
488500,20011,-12496,"(AMETHYSTS, MARKET << US, 10005, 1, 488500)
(AMETHYSTS, MARKET << US, 10005, 1, 488500)
(STARFRUIT, US << MARKET, 5054, 1, 488500)
(STARFRUIT, MARKET << US, 5055, 1, 488500)","{""AMETHYSTS"": -5, ""STARFRUIT"": 13}",3167,5051,10000
489300,-239880,-252376,"(AMETHYSTS, US << MARKET, 9995, 1, 489300)
(AMETHYSTS, US << MARKET, 9995, 1, 489300)
(AMETHYSTS, US << MARKET, 9995, 1, 489300)
(AMETHYSTS, US << MARKET, 9995, 1, 489300)
(AMETHYSTS, US << MARKET, 9995, 1, 489300)
(AMETHYSTS, US << MARKET, 9995, 1, 489300)
(AMETHYSTS, US << MARKET, 9995, 1, 489300)
(AMETHYSTS, US << MARKET, 9995, 1, 489300)
(AMETHYSTS, US << MARKET, 9995, 1, 489300)
(AMETHYSTS, US << MARKET, 9995, 1, 489300)
(AMETHYSTS, US << MARKET, 9995, 1, 489300)
(AMETHYSTS, US << MARKET, 9995, 1, 489300)
(AMETHYSTS, US << MARKET, 9995, 1, 489300)
(AMETHYSTS, US << MARKET, 9995, 1, 489300)
(AMETHYSTS, US << MARKET, 9995, 1, 489300)
(AMETHYSTS, US << MARKET, 9995, 1, 489300)
(AMETHYSTS, US << MARKET, 9995, 1, 489300)
(AMETHYSTS, US << MARKET, 9995, 1, 489300)
(AMETHYSTS, US << MARKET, 9995, 1, 489300)
(AMETHYSTS, US << MARKET, 9995, 1, 489300)
(AMETHYSTS, US << MARKET, 9995, 1, 489300)
(AMETHYSTS, US << MARKET, 9995, 1, 489300)
(AMETHYSTS, US << MARKET, 9995, 1, 489300)
(AMETHYSTS, US << MARKET, 9995, 1, 489300)","{""AMETHYSTS"": 19, ""STARFRUIT"": 13}",3326,5054,10000
489400,5056,-247320,"(STARFRUIT, MARKET << US, 5056, 1, 489400)","{""AMETHYSTS"": 19, ""STARFRUIT"": 12}",3326,5057,9998
489500,-4944,-252264,"(AMETHYSTS, US << MARKET, 9996, 1, 489500)
(STARFRUIT, MARKET << US, 5052, 1, 489500)","{""AMETHYSTS"": 20, ""STARFRUIT"": 11}",3341,5055,10000
489600,5051,-247213,"(STARFRUIT, MARKET << US, 5051, 1, 489600)","{""AMETHYSTS"": 20, ""STARFRUIT"": 10}",3327,5054,10000
491100,49990,-197223,"(AMETHYSTS, MARKET << US, 9998, 1, 491100)
(AMETHYSTS, MARKET << US, 9998, 1, 491100)
(AMETHYSTS, MARKET << US, 9998, 1, 491100)
(AMETHYSTS, MARKET << US, 9998, 1, 491100)
(AMETHYSTS, MARKET << US, 9998, 1, 491100)","{""AMETHYSTS"": 15, ""STARFRUIT"": 10}",3292,5056,9997
491600,80016,-117207,"(AMETHYSTS, MARKET << US, 10002, 1, 491600)
(AMETHYSTS, MARKET << US, 10002, 1, 491600)
(AMETHYSTS, MARKET << US, 10002, 1, 491600)
(AMETHYSTS, MARKET << US, 10002, 1, 491600)
(AMETHYSTS, MARKET << US, 10002, 1, 491600)
(AMETHYSTS, MARKET << US, 10002, 1, 491600)
(AMETHYSTS, MARKET << US, 10002, 1, 491600)
(AMETHYSTS, MARKET << US, 10002, 1, 491600)","{""AMETHYSTS"": 7, ""STARFRUIT"": 10}",3346,5056,9999
491800,-10002,-127209,"(AMETHYSTS, US << MARKET, 10002, 1, 491800)","{""AMETHYSTS"": 8, ""STARFRUIT"": 10}",3375,5056,10003
492200,-80040,-207249,"(AMETHYSTS, US << MARKET, 10005, 1, 492200)
(AMETHYSTS, US << MARKET, 10005, 1, 492200)
(AMETHYSTS, US << MARKET, 10005, 1, 492200)
(AMETHYSTS, US << MARKET, 10005, 1, 492200)
(AMETHYSTS, US << MARKET, 10005, 1, 492200)
(AMETHYSTS, US << MARKET, 10005, 1, 492200)
(AMETHYSTS, US << MARKET, 10005, 1, 492200)
(AMETHYSTS, US << MARKET, 10005, 1, 492200)","{""AMETHYSTS"": 16, ""STARFRUIT"": 10}",3311,5056,10000
492400,-5054,-212303,"(STARFRUIT, US << MARKET, 5054, 1, 492400)","{""AMETHYSTS"": 16, ""STARFRUIT"": 11}",3313,5056,10000
492700,5061,-207242,"(STARFRUIT, MARKET << US, 5061, 1, 492700)","{""AMETHYSTS"": 16, ""STARFRUIT"": 10}",3368,5061,10000
492800,-8,-207250,"(STARFRUIT, US << MARKET, 5062, 1, 492800)
(STARFRUIT, US << MARKET, 5062, 1, 492800)
(STARFRUIT, US << MARKET, 5062, 1, 492800)
(STARFRUIT, US << MARKET, 5062, 1, 492800)
(STARFRUIT, MARKET << US, 5060, 1, 492800)
(STARFRUIT, MARKET << US, 5060, 1, 492800)
(STARFRUIT, MARKET << US, 5060, 1, 492800)
(STARFRUIT, MARKET << US, 5060, 1, 492800)","{""AMETHYSTS"": 16, ""STARFRUIT"": 10}",3360,5061,10000
493000,20008,-187242,"(AMETHYSTS, MARKET << US, 10004, 1, 493000)
(AMETHYSTS, MARKET << US, 10004, 1, 493000)","{""AMETHYSTS"": 14, ""STARFRUIT"": 10}",3348,5059,10000
493200,19996,-167246,"(AMETHYSTS, US << MARKET, 9998, 1, 493200)
(AMETHYSTS, US << MARKET, 9998, 1, 493200)
(AMETHYSTS, MARKET << US, 9998, 1, 493200)
(AMETHYSTS, MARKET << US, 9998, 1, 493200)
(AMETHYSTS, MARKET << US, 9998, 1, 493200)
(AMETHYSTS, MARKET << US, 9998, 1, 493200)","{""AMETHYSTS"": 12, ""STARFRUIT"": 10}",3308,5059,9997
493300,5062,-162184,"(STARFRUIT, MARKET << US, 5062, 1, 493300)","{""AMETHYSTS"": 12, ""STARFRUIT"": 9}",3386,5062,10001
493500,9996,-152188,"(AMETHYSTS, MARKET << US, 9996, 1, 493500)","{""AMETHYSTS"": 11, ""STARFRUIT"": 9}",3350,5061,9999
493600,5058,-147130,"(STARFRUIT, MARKET << US, 5058, 1, 493600)","{""AMETHYSTS"": 11, ""STARFRUIT"": 8}",3350,5060,10000
493900,-10002,-157132,"(AMETHYSTS, US << MARKET, 10002, 1, 493900)","{""AMETHYSTS"": 12, ""STARFRUIT"": 8}",3352,5062,9999
494100,-10002,-167134,"(AMETHYSTS, US << MARKET, 10002, 1, 494100)","{""AMETHYSTS"": 13, ""STARFRUIT"": 8}",3385,5060,10003
494500,60012,-107122,"(AMETHYSTS, MARKET << US, 10002, 1, 494500)
(AMETHYSTS, MARKET << US, 10002, 1, 494500)
(AMETHYSTS, MARKET << US, 10002, 1, 494500)
(AMETHYSTS, MARKET << US, 10002, 1, 494500)
(AMETHYSTS, MARKET << US, 10002, 1, 494500)
(AMETHYSTS, MARKET << US, 10002, 1, 494500)","{""AMETHYSTS"": 7, ""STARFRUIT"": 8}",3379,5060,10003
494800,-15064,-122186,"(AMETHYSTS, US << MARKET, 10002, 1, 494800)
(STARFRUIT, US << MARKET, 5062, 1, 494800)","{""AMETHYSTS"": 8, ""STARFRUIT"": 9}",3396,5062,10003
495000,5057,-117129,"(STARFRUIT, MARKET << US, 5057, 1, 495000)","{""AMETHYSTS"": 8, ""STARFRUIT"": 8}",3351,5059,10001
495200,30342,-86787,"(STARFRUIT, MARKET << US, 5057, 1, 495200)
(STARFRUIT, MARKET << US, 5057, 1, 495200)
(STARFRUIT, MARKET << US, 5057, 1, 495200)
(STARFRUIT, MARKET << US, 5057, 1, 495200)
(STARFRUIT, MARKET << US, 5057, 1, 495200)
(STARFRUIT, MARKET << US, 5057, 1, 495200)","{""AMETHYSTS"": 8, ""STARFRUIT"": 2}",3341,5060,10001
496000,-10118,-96905,"(STARFRUIT, US << MARKET, 5059, 1, 496000)
(STARFRUIT, US << MARKET, 5059, 1, 496000)","{""AMETHYSTS"": 8, ""STARFRUIT"": 4}",3343,5062,10000
496300,5060,-91845,"(STARFRUIT, MARKET << US, 5060, 1, 496300)","{""AMETHYSTS"": 8, ""STARFRUIT"": 3}",3363,5064,10002
496600,-39992,-131837,"(AMETHYSTS, US << MARKET, 9998, 1, 496600)
(AMETHYSTS, US << MARKET, 9998, 1, 496600)
(AMETHYSTS, US << MARKET, 9998, 1, 496600)
(AMETHYSTS, US << MARKET, 9998, 1, 496600)","{""AMETHYSTS"": 12, ""STARFRUIT"": 3}",3316,5063,9997
497100,39992,-91845,"(AMETHYSTS, MARKET << US, 9998, 1, 497100)
(AMETHYSTS, MARKET << US, 9998, 1, 497100)
(AMETHYSTS, MARKET << US, 9998, 1, 497100)
(AMETHYSTS, MARKET << US, 9998, 1, 497100)","{""AMETHYSTS"": 8, ""STARFRUIT"": 3}",3320,5063,9997
497300,9998,-81847,"(AMETHYSTS, MARKET << US, 9998, 1, 497300)","{""AMETHYSTS"": 7, ""STARFRUIT"": 3}",3318,5062,9997
497400,10134,-71713,"(AMETHYSTS, US << MARKET, 10002, 1, 497400)
(AMETHYSTS, US << MARKET, 10004, 1, 497400)
(AMETHYSTS, MARKET << US, 10004, 1, 497400)
(AMETHYSTS, MARKET << US, 10004, 1, 497400)
(STARFRUIT, MARKET << US, 5066, 1, 497400)
(STARFRUIT, MARKET << US, 5066, 1, 497400)","{""AMETHYSTS"": 7, ""STARFRUIT"": 1}",3371,5063,10003
497700,-19996,-91709,"(AMETHYSTS, US << MARKET, 9998, 1, 497700)
(AMETHYSTS, US << MARKET, 9998, 1, 497700)","{""AMETHYSTS"": 9, ""STARFRUIT"": 1}",3381,5063,10003
497900,-100040,-191749,"(AMETHYSTS, US << MARKET, 10004, 1, 497900)
(AMETHYSTS, US << MARKET, 10004, 1, 497900)
(AMETHYSTS, US << MARKET, 10004, 1, 497900)
(AMETHYSTS, US << MARKET, 10004, 1, 497900)
(AMETHYSTS, US << MARKET, 10004, 1, 497900)
(AMETHYSTS, US << MARKET, 10004, 1, 497900)
(AMETHYSTS, US << MARKET, 10004, 1, 497900)
(AMETHYSTS, US << MARKET, 10004, 1, 497900)
(AMETHYSTS, US << MARKET, 10004, 1, 497900)
(AMETHYSTS, US << MARKET, 10004, 1, 497900)","{""AMETHYSTS"": 19, ""STARFRUIT"": 1}",3314,5063,10000
498000,-10130,-201879,"(STARFRUIT, US << MARKET, 5065, 1, 498000)
(STARFRUIT, US << MARKET, 5065, 1, 498000)","{""AMETHYSTS"": 19, ""STARFRUIT"": 3}",3307,5062,10000
498200,20244,-181635,"(STARFRUIT, MARKET << US, 5061, 1, 498200)
(STARFRUIT, MARKET << US, 5061, 1, 498200)
(STARFRUIT, MARKET << US, 5061, 1, 498200)
(STARFRUIT, MARKET << US, 5061, 1, 498200)","{""AMETHYSTS"": 19, ""STARFRUIT"": -1}",3305,5060,10000
498300,49990,-131645,"(AMETHYSTS, MARKET << US, 9998, 1, 498300)
(AMETHYSTS, MARKET << US, 9998, 1, 498300)
(AMETHYSTS, MARKET << US, 9998, 1, 498300)
(AMETHYSTS, MARKET << US, 9998, 1, 498300)
(AMETHYSTS, MARKET << US, 9998, 1, 498300)","{""AMETHYSTS"": 14, ""STARFRUIT"": -1}",3235,5064,9996
498400,-10002,-141647,"(AMETHYSTS, US << MARKET, 10002, 1, 498400)","{""AMETHYSTS"": 15, ""STARFRUIT"": -1}",3335,5063,10003
498500,-10130,-151777,"(STARFRUIT, US << MARKET, 5065, 1, 498500)
(STARFRUIT, US << MARKET, 5065, 1, 498500)","{""AMETHYSTS"": 15, ""STARFRUIT"": 1}",3288,5065,10000
499000,-10120,-161897,"(STARFRUIT, US << MARKET, 5060, 1, 499000)
(STARFRUIT, US << MARKET, 5060, 1, 499000)","{""AMETHYSTS"": 15, ""STARFRUIT"": 3}",3274,5062,9999
499400,-15186,-177083,"(STARFRUIT, US << MARKET, 5062, 1, 499400)
(STARFRUIT, US << MARKET, 5062, 1, 499400)
(STARFRUIT, US << MARKET, 5062, 1, 499400)","{""AMETHYSTS"": 15, ""STARFRUIT"": 6}",3283,5061,10000
499700,-19992,-197075,"(AMETHYSTS, US << MARKET, 9996, 1, 499700)
(AMETHYSTS, US << MARKET, 9996, 1, 499700)","{""AMETHYSTS"": 17, ""STARFRUIT"": 6}",3291,5061,10000
499900,-20120,-217195,"(AMETHYSTS, US << MARKET, 10002, 1, 499900)
(STARFRUIT, US << MARKET, 5059, 1, 499900)
(STARFRUIT, US << MARKET, 5059, 1, 499900)","{""AMETHYSTS"": 18, ""STARFRUIT"": 8}",3355,5062,10003
500000,5060,-212135,"(STARFRUIT, MARKET << US, 5060, 1, 500000)","{""AMETHYSTS"": 18, ""STARFRUIT"": 7}",3278,5059,10000
501200,50126,-162009,"(AMETHYSTS, MARKET << US, 10002, 1, 501200)
(AMETHYSTS, MARKET << US, 10002, 1, 501200)
(AMETHYSTS, MARKET << US, 10002, 1, 501200)
(AMETHYSTS, MARKET << US, 10002, 1, 501200)
(STARFRUIT, MARKET << US, 5059, 1, 501200)
(STARFRUIT, MARKET << US, 5059, 1, 501200)","{""AMETHYSTS"": 14, ""STARFRUIT"": 5}",3343,5062,10003
501800,40119,-121890,"(AMETHYSTS, MARKET << US, 9996, 1, 501800)
(AMETHYSTS, MARKET << US, 9996, 1, 501800)
(AMETHYSTS, MARKET << US, 9996, 1, 501800)
(STARFRUIT, MARKET << US, 5066, 1, 501800)
(STARFRUIT, MARKET << US, 5065, 1, 501800)","{""AMETHYSTS"": 11, ""STARFRUIT"": 3}",3299,5063,10000
501900,40008,-81882,"(AMETHYSTS, MARKET << US, 10002, 1, 501900)
(AMETHYSTS, MARKET << US, 10002, 1, 501900)
(AMETHYSTS, MARKET << US, 10002, 1, 501900)
(AMETHYSTS, MARKET << US, 10002, 1, 501900)","{""AMETHYSTS"": 7, ""STARFRUIT"": 3}",3322,5061,10003
502100,20004,-61878,"(AMETHYSTS, MARKET << US, 10002, 1, 502100)
(AMETHYSTS, MARKET << US, 10002, 1, 502100)","{""AMETHYSTS"": 5, ""STARFRUIT"": 3}",3320,5061,10003
502300,20260,-41618,"(STARFRUIT, MARKET << US, 5065, 1, 502300)
(STARFRUIT, MARKET << US, 5065, 1, 502300)
(STARFRUIT, MARKET << US, 5065, 1, 502300)
(STARFRUIT, MARKET << US, 5065, 1, 502300)","{""AMETHYSTS"": 5, ""STARFRUIT"": -1}",3323,5064,10001
502500,19764,-21854,"(AMETHYSTS, MARKET << US, 10002, 1, 502500)
(AMETHYSTS, MARKET << US, 10002, 1, 502500)
(AMETHYSTS, MARKET << US, 10002, 1, 502500)
(AMETHYSTS, MARKET << US, 10002, 1, 502500)
(STARFRUIT, US << MARKET, 5058, 1, 502500)
(STARFRUIT, US << MARKET, 5058, 1, 502500)
(STARFRUIT, US << MARKET, 5064, 1, 502500)
(STARFRUIT, US << MARKET, 5064, 1, 502500)","{""AMETHYSTS"": 1, ""STARFRUIT"": 3}",3328,5061,9999
502600,19992,-1862,"(AMETHYSTS, MARKET << US, 9996, 1, 502600)
(AMETHYSTS, MARKET << US, 9996, 1, 502600)","{""AMETHYSTS"": -1, ""STARFRUIT"": 3}",3318,5060,10000
503400,40016,38154,"(AMETHYSTS, MARKET << US, 10004, 1, 503400)
(AMETHYSTS, MARKET << US, 10004, 1, 503400)
(AMETHYSTS, MARKET << US, 10004, 1, 503400)
(AMETHYSTS, MARKET << US, 10004, 1, 503400)","{""AMETHYSTS"": -5, ""STARFRUIT"": 3}",3337,5061,10000
504300,-10116,28038,"(STARFRUIT, US << MARKET, 5058, 1, 504300)
(STARFRUIT, US << MARKET, 5058, 1, 504300)","{""AMETHYSTS"": -5, ""STARFRUIT"": 5}",3343,5061,10000
504500,25067,53105,"(AMETHYSTS, MARKET << US, 10002, 1, 504500)
(AMETHYSTS, MARKET << US, 10002, 1, 504500)
(STARFRUIT, MARKET << US, 5063, 1, 504500)","{""AMETHYSTS"": -7, ""STARFRUIT"": 4}",3351,5058,9998
504700,20004,73109,"(AMETHYSTS, MARKET << US, 10002, 1, 504700)
(AMETHYSTS, MARKET << US, 10002, 1, 504700)","{""AMETHYSTS"": -9, ""STARFRUIT"": 4}",3318,5059,10003
505200,-10002,63107,"(AMETHYSTS, US << MARKET, 10002, 1, 505200)","{""AMETHYSTS"": -8, ""STARFRUIT"": 4}",3359,5061,9999
505300,-10118,52989,"(STARFRUIT, US << MARKET, 5059, 1, 505300)
(STARFRUIT, US << MARKET, 5059, 1, 505300)","{""AMETHYSTS"": -8, ""STARFRUIT"": 6}",3363,5061,9999
505500,115108,168097,"(AMETHYSTS, MARKET << US, 10004, 1, 505500)
(AMETHYSTS, MARKET << US, 10004, 1, 505500)
(AMETHYSTS, MARKET << US, 10004, 1, 505500)
(AMETHYSTS, MARKET << US, 10004, 1, 505500)
(AMETHYSTS, MARKET << US, 10004, 1, 505500)
(AMETHYSTS, MARKET << US, 10004, 1, 505500)
(AMETHYSTS, MARKET << US, 10004, 1, 505500)
(AMETHYSTS, MARKET << US, 10004, 1, 505500)
(AMETHYSTS, MARKET << US, 10004, 1, 505500)
(AMETHYSTS, MARKET << US, 10004, 1, 505500)
(AMETHYSTS, MARKET << US, 10004, 1, 505500)
(STARFRUIT, MARKET << US, 5064, 1, 505500)","{""AMETHYSTS"": -19, ""STARFRUIT"": 5}",3398,5064,10001
505600,5059,173156,"(STARFRUIT, MARKET << US, 5059, 1, 505600)","{""AMETHYSTS"": -19, ""STARFRUIT"": 4}",3400,5061,10000
506000,-19996,153160,"(AMETHYSTS, US << MARKET, 9998, 1, 506000)
(AMETHYSTS, US << MARKET, 9998, 1, 506000)","{""AMETHYSTS"": -17, ""STARFRUIT"": 4}",3459,5062,9997
506100,30006,183166,"(AMETHYSTS, MARKET << US, 10002, 1, 506100)
(AMETHYSTS, MARKET << US, 10002, 1, 506100)
(AMETHYSTS, MARKET << US, 10002, 1, 506100)","{""AMETHYSTS"": -20, ""STARFRUIT"": 4}",3438,5063,9999
506300,-159920,23246,"(AMETHYSTS, US << MARKET, 9995, 1, 506300)
(AMETHYSTS, US << MARKET, 9995, 1, 506300)
(AMETHYSTS, US << MARKET, 9995, 1, 506300)
(AMETHYSTS, US << MARKET, 9995, 1, 506300)
(AMETHYSTS, US << MARKET, 9995, 1, 506300)
(AMETHYSTS, US << MARKET, 9995, 1, 506300)
(AMETHYSTS, US << MARKET, 9995, 1, 506300)
(AMETHYSTS, US << MARKET, 9995, 1, 506300)
(AMETHYSTS, US << MARKET, 9995, 1, 506300)
(AMETHYSTS, US << MARKET, 9995, 1, 506300)
(AMETHYSTS, US << MARKET, 9995, 1, 506300)
(AMETHYSTS, US << MARKET, 9995, 1, 506300)
(AMETHYSTS, US << MARKET, 9995, 1, 506300)
(AMETHYSTS, US << MARKET, 9995, 1, 506300)
(AMETHYSTS, US << MARKET, 9995, 1, 506300)
(AMETHYSTS, US << MARKET, 9995, 1, 506300)","{""AMETHYSTS"": -4, ""STARFRUIT"": 4}",3498,5063,10000
506500,-59970,-36724,"(AMETHYSTS, US << MARKET, 9995, 1, 506500)
(AMETHYSTS, US << MARKET, 9995, 1, 506500)
(AMETHYSTS, US << MARKET, 9995, 1, 506500)
(AMETHYSTS, US << MARKET, 9995, 1, 506500)
(AMETHYSTS, US << MARKET, 9995, 1, 506500)
(AMETHYSTS, US << MARKET, 9995, 1, 506500)","{""AMETHYSTS"": 2, ""STARFRUIT"": 4}",3524,5062,10000
506600,-20248,-56972,"(STARFRUIT, US << MARKET, 5062, 1, 506600)
(STARFRUIT, US << MARKET, 5062, 1, 506600)
(STARFRUIT, US << MARKET, 5062, 1, 506600)
(STARFRUIT, US << MARKET, 5062, 1, 506600)","{""AMETHYSTS"": 2, ""STARFRUIT"": 8}",3504,5060,9998
507600,4937,-52035,"(AMETHYSTS, MARKET << US, 9998, 1, 507600)
(STARFRUIT, US << MARKET, 5061, 1, 507600)","{""AMETHYSTS"": 1, ""STARFRUIT"": 9}",3520,5062,9997
507700,20004,-32031,"(AMETHYSTS, MARKET << US, 10002, 1, 507700)
(AMETHYSTS, MARKET << US, 10002, 1, 507700)","{""AMETHYSTS"": -1, ""STARFRUIT"": 9}",3538,5063,9998
508200,-5065,-37096,"(STARFRUIT, US << MARKET, 5065, 1, 508200)","{""AMETHYSTS"": -1, ""STARFRUIT"": 10}",3551,5065,10003
508400,9874,-27222,"(AMETHYSTS, MARKET << US, 10004, 1, 508400)
(AMETHYSTS, MARKET << US, 10004, 1, 508400)
(STARFRUIT, US << MARKET, 5067, 1, 508400)
(STARFRUIT, US << MARKET, 5067, 1, 508400)","{""AMETHYSTS"": -3, ""STARFRUIT"": 12}",3534,5063,10000
508600,-20264,-47486,"(STARFRUIT, US << MARKET, 5066, 1, 508600)
(STARFRUIT, US << MARKET, 5066, 1, 508600)
(STARFRUIT, US << MARKET, 5066, 1, 508600)
(STARFRUIT, US << MARKET, 5066, 1, 508600)","{""AMETHYSTS"": -3, ""STARFRUIT"": 16}",3538,5064,10000
508800,9998,-37488,"(AMETHYSTS, MARKET << US, 9998, 1, 508800)","{""AMETHYSTS"": -4, ""STARFRUIT"": 16}",3532,5063,9997
508900,5067,-32421,"(STARFRUIT, MARKET << US, 5067, 1, 508900)","{""AMETHYSTS"": -4, ""STARFRUIT"": 15}",3588,5067,9999
509300,-15195,-47616,"(STARFRUIT, US << MARKET, 5065, 1, 509300)
(STARFRUIT, US << MARKET, 5065, 1, 509300)
(STARFRUIT, US << MARKET, 5065, 1, 509300)","{""AMETHYSTS"": -4, ""STARFRUIT"": 18}",3522,5063,9999
509500,35452,-12164,"(STARFRUIT, MARKET << US, 5068, 1, 509500)
(STARFRUIT, MARKET << US, 5064, 1, 509500)
(STARFRUIT, MARKET << US, 5064, 1, 509500)
(STARFRUIT, MARKET << US, 5064, 1, 509500)
(STARFRUIT, MARKET << US, 5064, 1, 509500)
(STARFRUIT, MARKET << US, 5064, 1, 509500)
(STARFRUIT, MARKET << US, 5064, 1, 509500)","{""AMETHYSTS"": -4, ""STARFRUIT"": 11}",3537,5063,9998
509700,64945,52781,"(AMETHYSTS, US << MARKET, 10002, 1, 509700)
(AMETHYSTS, MARKET << US, 10002, 1, 509700)
(AMETHYSTS, MARKET << US, 10002, 1, 509700)
(AMETHYSTS, MARKET << US, 10002, 1, 509700)
(AMETHYSTS, MARKET << US, 10002, 1, 509700)
(AMETHYSTS, MARKET << US, 10002, 1, 509700)
(AMETHYSTS, MARKET << US, 10002, 1, 509700)
(AMETHYSTS, MARKET << US, 10002, 1, 509700)
(AMETHYSTS, MARKET << US, 10002, 1, 509700)
(STARFRUIT, US << MARKET, 5069, 1, 509700)","{""AMETHYSTS"": -11, ""STARFRUIT"": 12}",3576,5069,10003
509800,-29856,22925,"(AMETHYSTS, US << MARKET, 9996, 1, 509800)
(AMETHYSTS, US << MARKET, 9996, 1, 509800)
(AMETHYSTS, US << MARKET, 9996, 1, 509800)
(AMETHYSTS, US << MARKET, 9996, 1, 509800)
(STARFRUIT, MARKET << US, 5064, 1, 509800)
(STARFRUIT, MARKET << US, 5064, 1, 509800)","{""AMETHYSTS"": -7, ""STARFRUIT"": 10}",3606,5066,9997
509900,-9868,13057,"(AMETHYSTS, US << MARKET, 10004, 1, 509900)
(AMETHYSTS, US << MARKET, 10004, 1, 509900)
(STARFRUIT, MARKET << US, 5070, 1, 509900)
(STARFRUIT, MARKET << US, 5070, 1, 509900)","{""AMETHYSTS"": -5, ""STARFRUIT"": 8}",3585,5066,10000
510100,-9608,3449,"(AMETHYSTS, US << MARKET, 9998, 1, 510100)
(AMETHYSTS, US << MARKET, 9998, 1, 510100)
(AMETHYSTS, US << MARKET, 9998, 1, 510100)
(AMETHYSTS, US << MARKET, 9998, 1, 510100)
(STARFRUIT, MARKET << US, 5064, 1, 510100)
(STARFRUIT, MARKET << US, 5064, 1, 510100)
(STARFRUIT, MARKET << US, 5064, 1, 510100)
(STARFRUIT, MARKET << US, 5064, 1, 510100)
(STARFRUIT, MARKET << US, 5064, 1, 510100)
(STARFRUIT, MARKET << US, 5064, 1, 510100)","{""AMETHYSTS"": -1, ""STARFRUIT"": 2}",3582,5067,10001
510200,9998,13447,"(AMETHYSTS, MARKET << US, 9998, 1, 510200)","{""AMETHYSTS"": -2, ""STARFRUIT"": 2}",3589,5067,9996
510900,-20268,-6821,"(STARFRUIT, US << MARKET, 5067, 1, 510900)
(STARFRUIT, US << MARKET, 5067, 1, 510900)
(STARFRUIT, US << MARKET, 5067, 1, 510900)
(STARFRUIT, US << MARKET, 5067, 1, 510900)","{""AMETHYSTS"": -2, ""STARFRUIT"": 6}",3577,5066,9999
511100,20004,13183,"(AMETHYSTS, MARKET << US, 10002, 1, 511100)
(AMETHYSTS, MARKET << US, 10002, 1, 511100)","{""AMETHYSTS"": -4, ""STARFRUIT"": 6}",3589,5067,9999
511300,19992,33175,"(AMETHYSTS, MARKET << US, 9996, 1, 511300)
(AMETHYSTS, MARKET << US, 9996, 1, 511300)","{""AMETHYSTS"": -6, ""STARFRUIT"": 6}",3601,5068,9997
511400,-30122,3053,"(AMETHYSTS, US << MARKET, 9996, 1, 511400)
(AMETHYSTS, US << MARKET, 9996, 1, 511400)
(STARFRUIT, US << MARKET, 5065, 1, 511400)
(STARFRUIT, US << MARKET, 5065, 1, 511400)","{""AMETHYSTS"": -4, ""STARFRUIT"": 8}",3589,5067,10000
511500,20276,23329,"(STARFRUIT, MARKET << US, 5069, 1, 511500)
(STARFRUIT, MARKET << US, 5069, 1, 511500)
(STARFRUIT, MARKET << US, 5069, 1, 511500)
(STARFRUIT, MARKET << US, 5069, 1, 511500)","{""AMETHYSTS"": -4, ""STARFRUIT"": 4}",3609,5070,10000
511700,9998,33327,"(AMETHYSTS, MARKET << US, 9998, 1, 511700)","{""AMETHYSTS"": -5, ""STARFRUIT"": 4}",3614,5068,9997
511800,-9866,23461,"(AMETHYSTS, US << MARKET, 10005, 1, 511800)
(AMETHYSTS, US << MARKET, 10005, 1, 511800)
(STARFRUIT, MARKET << US, 5072, 1, 511800)
(STARFRUIT, MARKET << US, 5072, 1, 511800)","{""AMETHYSTS"": -3, ""STARFRUIT"": 2}",3594,5068,10001
512200,15063,38524,"(AMETHYSTS, MARKET << US, 9998, 1, 512200)
(STARFRUIT, MARKET << US, 5065, 1, 512200)","{""AMETHYSTS"": -4, ""STARFRUIT"": 1}",3587,5067,10001
512700,-10002,28522,"(AMETHYSTS, US << MARKET, 10002, 1, 512700)","{""AMETHYSTS"": -3, ""STARFRUIT"": 1}",3590,5068,10000
512900,160032,188554,"(AMETHYSTS, MARKET << US, 10002, 1, 512900)
(AMETHYSTS, MARKET << US, 10002, 1, 512900)
(AMETHYSTS, MARKET << US, 10002, 1, 512900)
(AMETHYSTS, MARKET << US, 10002, 1, 512900)
(AMETHYSTS, MARKET << US, 10002, 1, 512900)
(AMETHYSTS, MARKET << US, 10002, 1, 512900)
(AMETHYSTS, MARKET << US, 10002, 1, 512900)
(AMETHYSTS, MARKET << US, 10002, 1, 512900)
(AMETHYSTS, MARKET << US, 10002, 1, 512900)
(AMETHYSTS, MARKET << US, 10002, 1, 512900)
(AMETHYSTS, MARKET << US, 10002, 1, 512900)
(AMETHYSTS, MARKET << US, 10002, 1, 512900)
(AMETHYSTS, MARKET << US, 10002, 1, 512900)
(AMETHYSTS, MARKET << US, 10002, 1, 512900)
(AMETHYSTS, MARKET << US, 10002, 1, 512900)
(AMETHYSTS, MARKET << US, 10002, 1, 512900)","{""AMETHYSTS"": -19, ""STARFRUIT"": 1}",3564,5067,10003
513400,-25355,163199,"(STARFRUIT, US << MARKET, 5071, 1, 513400)
(STARFRUIT, US << MARKET, 5071, 1, 513400)
(STARFRUIT, US << MARKET, 5071, 1, 513400)
(STARFRUIT, US << MARKET, 5071, 1, 513400)
(STARFRUIT, US << MARKET, 5071, 1, 513400)","{""AMETHYSTS"": -19, ""STARFRUIT"": 6}",3619,5070,10000
514100,9998,173197,"(AMETHYSTS, MARKET << US, 9998, 1, 514100)","{""AMETHYSTS"": -20, ""STARFRUIT"": 6}",3579,5067,10001
514600,-100020,73177,"(AMETHYSTS, US << MARKET, 10002, 1, 514600)
(AMETHYSTS, US << MARKET, 10002, 1, 514600)
(AMETHYSTS, US << MARKET, 10002, 1, 514600)
(AMETHYSTS, US << MARKET, 10002, 1, 514600)
(AMETHYSTS, US << MARKET, 10002, 1, 514600)
(AMETHYSTS, US << MARKET, 10002, 1, 514600)
(AMETHYSTS, US << MARKET, 10002, 1, 514600)
(AMETHYSTS, US << MARKET, 10002, 1, 514600)
(AMETHYSTS, US << MARKET, 10002, 1, 514600)
(AMETHYSTS, US << MARKET, 10002, 1, 514600)","{""AMETHYSTS"": -10, ""STARFRUIT"": 6}",3543,5066,10003
515200,-133,73044,"(AMETHYSTS, MARKET << US, 9995, 1, 515200)
(STARFRUIT, US << MARKET, 5064, 1, 515200)
(STARFRUIT, US << MARKET, 5064, 1, 515200)","{""AMETHYSTS"": -11, ""STARFRUIT"": 8}",3602,5067,9998
515500,-20248,52796,"(STARFRUIT, US << MARKET, 5062, 1, 515500)
(STARFRUIT, US << MARKET, 5062, 1, 515500)
(STARFRUIT, US << MARKET, 5062, 1, 515500)
(STARFRUIT, US << MARKET, 5062, 1, 515500)","{""AMETHYSTS"": -11, ""STARFRUIT"": 12}",3576,5065,10000
515700,-19996,32800,"(AMETHYSTS, US << MARKET, 9998, 1, 515700)
(AMETHYSTS, US << MARKET, 9998, 1, 515700)","{""AMETHYSTS"": -9, ""STARFRUIT"": 12}",3616,5065,9996
515800,25059,57859,"(AMETHYSTS, MARKET << US, 9996, 1, 515800)
(AMETHYSTS, MARKET << US, 9996, 1, 515800)
(STARFRUIT, MARKET << US, 5067, 1, 515800)","{""AMETHYSTS"": -11, ""STARFRUIT"": 11}",3607,5068,10000
515900,69986,127845,"(AMETHYSTS, MARKET << US, 9998, 1, 515900)
(AMETHYSTS, MARKET << US, 9998, 1, 515900)
(AMETHYSTS, MARKET << US, 9998, 1, 515900)
(AMETHYSTS, MARKET << US, 9998, 1, 515900)
(AMETHYSTS, MARKET << US, 9998, 1, 515900)
(AMETHYSTS, MARKET << US, 9998, 1, 515900)
(AMETHYSTS, MARKET << US, 9998, 1, 515900)","{""AMETHYSTS"": -18, ""STARFRUIT"": 11}",3621,5064,9996
516100,-65055,62790,"(AMETHYSTS, US << MARKET, 9998, 1, 516100)
(AMETHYSTS, US << MARKET, 9998, 1, 516100)
(AMETHYSTS, US << MARKET, 9998, 1, 516100)
(AMETHYSTS, US << MARKET, 9998, 1, 516100)
(AMETHYSTS, US << MARKET, 9998, 1, 516100)
(AMETHYSTS, US << MARKET, 9998, 1, 516100)
(STARFRUIT, US << MARKET, 5067, 1, 516100)","{""AMETHYSTS"": -12, ""STARFRUIT"": 12}",3582,5064,9998
516200,-240,62550,"(AMETHYSTS, MARKET << US, 10002, 1, 516200)
(AMETHYSTS, MARKET << US, 10002, 1, 516200)
(STARFRUIT, US << MARKET, 5061, 1, 516200)
(STARFRUIT, US << MARKET, 5061, 1, 516200)
(STARFRUIT, US << MARKET, 5061, 1, 516200)
(STARFRUIT, US << MARKET, 5061, 1, 516200)","{""AMETHYSTS"": -14, ""STARFRUIT"": 16}",3618,5065,9998
516300,-25052,37498,"(AMETHYSTS, US << MARKET, 9995, 1, 516300)
(AMETHYSTS, US << MARKET, 9995, 1, 516300)
(STARFRUIT, US << MARKET, 5062, 1, 516300)","{""AMETHYSTS"": -12, ""STARFRUIT"": 17}",3627,5065,9998
516400,70158,107656,"(AMETHYSTS, MARKET << US, 10004, 1, 516400)
(AMETHYSTS, MARKET << US, 10004, 1, 516400)
(AMETHYSTS, MARKET << US, 10004, 1, 516400)
(AMETHYSTS, MARKET << US, 10004, 1, 516400)
(AMETHYSTS, MARKET << US, 10004, 1, 516400)
(AMETHYSTS, MARKET << US, 10002, 1, 516400)
(STARFRUIT, MARKET << US, 5068, 1, 516400)
(STARFRUIT, MARKET << US, 5068, 1, 516400)","{""AMETHYSTS"": -18, ""STARFRUIT"": 15}",3577,5065,10003
517300,-126,107530,"(AMETHYSTS, MARKET << US, 9996, 1, 517300)
(STARFRUIT, US << MARKET, 5061, 1, 517300)
(STARFRUIT, US << MARKET, 5061, 1, 517300)","{""AMETHYSTS"": -19, ""STARFRUIT"": 17}",3618,5064,10000
517900,-19996,87534,"(AMETHYSTS, US << MARKET, 9998, 1, 517900)
(AMETHYSTS, US << MARKET, 9998, 1, 517900)","{""AMETHYSTS"": -17, ""STARFRUIT"": 17}",3588,5063,10001
518500,20252,107786,"(STARFRUIT, MARKET << US, 5063, 1, 518500)
(STARFRUIT, MARKET << US, 5063, 1, 518500)
(STARFRUIT, MARKET << US, 5063, 1, 518500)
(STARFRUIT, MARKET << US, 5063, 1, 518500)","{""AMETHYSTS"": -17, ""STARFRUIT"": 13}",3584,5064,10002
518700,20004,127790,"(AMETHYSTS, MARKET << US, 10002, 1, 518700)
(AMETHYSTS, MARKET << US, 10002, 1, 518700)","{""AMETHYSTS"": -19, ""STARFRUIT"": 13}",3565,5064,10003
518800,-9869,117921,"(AMETHYSTS, US << MARKET, 10002, 1, 518800)
(AMETHYSTS, US << MARKET, 10004, 1, 518800)
(STARFRUIT, MARKET << US, 5069, 1, 518800)
(STARFRUIT, MARKET << US, 5068, 1, 518800)","{""AMETHYSTS"": -17, ""STARFRUIT"": 11}",3618,5068,10003
519400,25077,142998,"(AMETHYSTS, MARKET << US, 10004, 1, 519400)
(AMETHYSTS, MARKET << US, 10004, 1, 519400)
(STARFRUIT, MARKET << US, 5069, 1, 519400)","{""AMETHYSTS"": -19, ""STARFRUIT"": 10}",3591,5065,10003
519500,30378,173376,"(STARFRUIT, MARKET << US, 5063, 1, 519500)
(STARFRUIT, MARKET << US, 5063, 1, 519500)
(STARFRUIT, MARKET << US, 5063, 1, 519500)
(STARFRUIT, MARKET << US, 5063, 1, 519500)
(STARFRUIT, MARKET << US, 5063, 1, 519500)
(STARFRUIT, MARKET << US, 5063, 1, 519500)","{""AMETHYSTS"": -19, ""STARFRUIT"": 4}",3640,5066,10000
519700,-5203,168173,"(AMETHYSTS, MARKET << US, 10004, 1, 519700)
(STARFRUIT, US << MARKET, 5069, 1, 519700)
(STARFRUIT, US << MARKET, 5069, 1, 519700)
(STARFRUIT, US << MARKET, 5069, 1, 519700)","{""AMETHYSTS"": -20, ""STARFRUIT"": 7}",3615,5066,10001
520400,5063,173236,"(STARFRUIT, MARKET << US, 5063, 1, 520400)","{""AMETHYSTS"": -20, ""STARFRUIT"": 6}",3608,5062,10000
520600,5067,178303,"(STARFRUIT, US << MARKET, 5067, 1, 520600)
(STARFRUIT, US << MARKET, 5067, 1, 520600)
(STARFRUIT, US << MARKET, 5067, 1, 520600)
(STARFRUIT, US << MARKET, 5067, 1, 520600)
(STARFRUIT, MARKET << US, 5067, 1, 520600)
(STARFRUIT, MARKET << US, 5067, 1, 520600)
(STARFRUIT, MARKET << US, 5067, 1, 520600)
(STARFRUIT, MARKET << US, 5067, 1, 520600)
(STARFRUIT, MARKET << US, 5067, 1, 520600)","{""AMETHYSTS"": -20, ""STARFRUIT"": 5}",3623,5064,10000
521000,25320,203623,"(STARFRUIT, MARKET << US, 5064, 1, 521000)
(STARFRUIT, MARKET << US, 5064, 1, 521000)
(STARFRUIT, MARKET << US, 5064, 1, 521000)
(STARFRUIT, MARKET << US, 5064, 1, 521000)
(STARFRUIT, MARKET << US, 5064, 1, 521000)","{""AMETHYSTS"": -20, ""STARFRUIT"": 0}",3643,5063,9999
521300,10126,213749,"(STARFRUIT, MARKET << US, 5063, 1, 521300)
(STARFRUIT, MARKET << US, 5063, 1, 521300)","{""AMETHYSTS"": -20, ""STARFRUIT"": -2}",3557,5066,10003
521600,-90036,123713,"(AMETHYSTS, US << MARKET, 10004, 1, 521600)
(AMETHYSTS, US << MARKET, 10004, 1, 521600)
(AMETHYSTS, US << MARKET, 10004, 1, 521600)
(AMETHYSTS, US << MARKET, 10004, 1, 521600)
(AMETHYSTS, US << MARKET, 10004, 1, 521600)
(AMETHYSTS, US << MARKET, 10004, 1, 521600)
(AMETHYSTS, US << MARKET, 10004, 1, 521600)
(AMETHYSTS, US << MARKET, 10004, 1, 521600)
(AMETHYSTS, US << MARKET, 10004, 1, 521600)","{""AMETHYSTS"": -11, ""STARFRUIT"": -2}",3583,5065,10000
521700,29878,153591,"(AMETHYSTS, MARKET << US, 10004, 1, 521700)
(AMETHYSTS, MARKET << US, 10004, 1, 521700)
(AMETHYSTS, MARKET << US, 10004, 1, 521700)
(AMETHYSTS, MARKET << US, 10002, 1, 521700)
(STARFRUIT, US << MARKET, 5068, 1, 521700)
(STARFRUIT, US << MARKET, 5068, 1, 521700)","{""AMETHYSTS"": -15, ""STARFRUIT"": 0}",3546,5067,10003
521800,-20268,133323,"(STARFRUIT, US << MARKET, 5064, 1, 521800)
(STARFRUIT, US << MARKET, 5064, 1, 521800)
(STARFRUIT, US << MARKET, 5070, 1, 521800)
(STARFRUIT, US << MARKET, 5070, 1, 521800)","{""AMETHYSTS"": -15, ""STARFRUIT"": 4}",3587,5066,10000
522400,0,133323,"(STARFRUIT, US << MARKET, 5067, 1, 522400)
(STARFRUIT, US << MARKET, 5067, 1, 522400)
(STARFRUIT, US << MARKET, 5067, 1, 522400)
(STARFRUIT, US << MARKET, 5067, 1, 522400)
(STARFRUIT, MARKET << US, 5067, 1, 522400)
(STARFRUIT, MARKET << US, 5067, 1, 522400)
(STARFRUIT, MARKET << US, 5067, 1, 522400)
(STARFRUIT, MARKET << US, 5067, 1, 522400)","{""AMETHYSTS"": -15, ""STARFRUIT"": 4}",3568,5065,10001
522500,20002,153325,"(AMETHYSTS, MARKET << US, 10002, 1, 522500)
(AMETHYSTS, MARKET << US, 10002, 1, 522500)
(STARFRUIT, US << MARKET, 5068, 1, 522500)
(STARFRUIT, US << MARKET, 5068, 1, 522500)
(STARFRUIT, MARKET << US, 5067, 1, 522500)
(STARFRUIT, MARKET << US, 5067, 1, 522500)","{""AMETHYSTS"": -17, ""STARFRUIT"": 4}",3602,5065,9999
522800,20248,173573,"(STARFRUIT, MARKET << US, 5062, 1, 522800)
(STARFRUIT, MARKET << US, 5062, 1, 522800)
(STARFRUIT, MARKET << US, 5062, 1, 522800)
(STARFRUIT, MARKET << US, 5062, 1, 522800)","{""AMETHYSTS"": -17, ""STARFRUIT"": 0}",3556,5065,10001
523300,-59988,113585,"(AMETHYSTS, US << MARKET, 9998, 1, 523300)
(AMETHYSTS, US << MARKET, 9998, 1, 523300)
(AMETHYSTS, US << MARKET, 9998, 1, 523300)
(AMETHYSTS, US << MARKET, 9998, 1, 523300)
(AMETHYSTS, US << MARKET, 9998, 1, 523300)
(AMETHYSTS, US << MARKET, 9998, 1, 523300)","{""AMETHYSTS"": -11, ""STARFRUIT"": 0}",3574,5065,10001
523500,-10134,103451,"(STARFRUIT, US << MARKET, 5067, 1, 523500)
(STARFRUIT, US << MARKET, 5067, 1, 523500)","{""AMETHYSTS"": -11, ""STARFRUIT"": 2}",3577,5063,10000
523600,35060,138511,"(AMETHYSTS, MARKET << US, 9998, 1, 523600)
(AMETHYSTS, MARKET << US, 9998, 1, 523600)
(AMETHYSTS, MARKET << US, 9998, 1, 523600)
(STARFRUIT, MARKET << US, 5066, 1, 523600)","{""AMETHYSTS"": -14, ""STARFRUIT"": 1}",3634,5067,9996
524200,9998,148509,"(AMETHYSTS, MARKET << US, 9998, 1, 524200)","{""AMETHYSTS"": -15, ""STARFRUIT"": 1}",3559,5065,10001
524500,5062,153571,"(STARFRUIT, MARKET << US, 5062, 1, 524500)","{""AMETHYSTS"": -15, ""STARFRUIT"": 0}",3571,5065,10000
525000,-4939,148632,"(AMETHYSTS, US << MARKET, 10004, 1, 525000)
(STARFRUIT, MARKET << US, 5065, 1, 525000)","{""AMETHYSTS"": -14, ""STARFRUIT"": -1}",3570,5062,10000
525300,-4937,143695,"(AMETHYSTS, US << MARKET, 10002, 1, 525300)
(STARFRUIT, MARKET << US, 5065, 1, 525300)","{""AMETHYSTS"": -13, ""STARFRUIT"": -2}",3524,5066,10003
525400,-10002,133693,"(AMETHYSTS, US << MARKET, 10002, 1, 525400)","{""AMETHYSTS"": -12, ""STARFRUIT"": -2}",3593,5062,9998
525600,10126,143819,"(STARFRUIT, MARKET << US, 5063, 1, 525600)
(STARFRUIT, MARKET << US, 5063, 1, 525600)","{""AMETHYSTS"": -12, ""STARFRUIT"": -4}",3579,5060,10000
525700,-9872,133947,"(AMETHYSTS, US << MARKET, 9996, 1, 525700)
(AMETHYSTS, US << MARKET, 9996, 1, 525700)
(STARFRUIT, MARKET << US, 5060, 1, 525700)
(STARFRUIT, MARKET << US, 5060, 1, 525700)","{""AMETHYSTS"": -10, ""STARFRUIT"": -6}",3593,5059,10000
526200,-10114,123833,"(STARFRUIT, US << MARKET, 5057, 1, 526200)
(STARFRUIT, US << MARKET, 5057, 1, 526200)","{""AMETHYSTS"": -10, ""STARFRUIT"": -4}",3593,5060,10000
526600,5063,128896,"(STARFRUIT, MARKET << US, 5063, 1, 526600)","{""AMETHYSTS"": -10, ""STARFRUIT"": -5}",3596,5060,10000
527100,-39984,88912,"(AMETHYSTS, US << MARKET, 9996, 1, 527100)
(AMETHYSTS, US << MARKET, 9996, 1, 527100)
(AMETHYSTS, US << MARKET, 9996, 1, 527100)
(AMETHYSTS, US << MARKET, 9996, 1, 527100)","{""AMETHYSTS"": -6, ""STARFRUIT"": -5}",3617,5059,10000
527300,-10122,78790,"(STARFRUIT, US << MARKET, 5061, 1, 527300)
(STARFRUIT, US << MARKET, 5061, 1, 527300)","{""AMETHYSTS"": -6, ""STARFRUIT"": -3}",3613,5061,9999
527500,-25300,53490,"(STARFRUIT, US << MARKET, 5057, 1, 527500)
(STARFRUIT, US << MARKET, 5057, 1, 527500)
(STARFRUIT, US << MARKET, 5062, 1, 527500)
(STARFRUIT, US << MARKET, 5062, 1, 527500)
(STARFRUIT, US << MARKET, 5062, 1, 527500)","{""AMETHYSTS"": -6, ""STARFRUIT"": 2}",3616,5063,10000
527700,-40260,13230,"(AMETHYSTS, US << MARKET, 10004, 1, 527700)
(AMETHYSTS, US << MARKET, 10004, 1, 527700)
(STARFRUIT, US << MARKET, 5063, 1, 527700)
(STARFRUIT, US << MARKET, 5063, 1, 527700)
(STARFRUIT, US << MARKET, 5063, 1, 527700)
(STARFRUIT, US << MARKET, 5063, 1, 527700)","{""AMETHYSTS"": -4, ""STARFRUIT"": 6}",3584,5059,10000
527900,-19996,-6766,"(AMETHYSTS, US << MARKET, 9998, 1, 527900)
(AMETHYSTS, US << MARKET, 9998, 1, 527900)","{""AMETHYSTS"": -2, ""STARFRUIT"": 6}",3596,5059,9996
528200,-20228,-26994,"(STARFRUIT, US << MARKET, 5057, 1, 528200)
(STARFRUIT, US << MARKET, 5057, 1, 528200)
(STARFRUIT, US << MARKET, 5057, 1, 528200)
(STARFRUIT, US << MARKET, 5057, 1, 528200)","{""AMETHYSTS"": -2, ""STARFRUIT"": 10}",3604,5060,10001
528500,30336,3342,"(STARFRUIT, MARKET << US, 5056, 1, 528500)
(STARFRUIT, MARKET << US, 5056, 1, 528500)
(STARFRUIT, MARKET << US, 5056, 1, 528500)
(STARFRUIT, MARKET << US, 5056, 1, 528500)
(STARFRUIT, MARKET << US, 5056, 1, 528500)
(STARFRUIT, MARKET << US, 5056, 1, 528500)","{""AMETHYSTS"": -2, ""STARFRUIT"": 4}",3564,5056,10001
528600,-19996,-16654,"(AMETHYSTS, US << MARKET, 9998, 1, 528600)
(AMETHYSTS, US << MARKET, 9998, 1, 528600)","{""AMETHYSTS"": 0, ""STARFRUIT"": 4}",3586,5060,9997
528700,-14951,-31605,"(AMETHYSTS, US << MARKET, 10004, 1, 528700)
(AMETHYSTS, US << MARKET, 10004, 1, 528700)
(STARFRUIT, MARKET << US, 5057, 1, 528700)","{""AMETHYSTS"": 2, ""STARFRUIT"": 3}",3581,5060,10003
529200,-25052,-56657,"(AMETHYSTS, US << MARKET, 9998, 1, 529200)
(AMETHYSTS, US << MARKET, 9998, 1, 529200)
(STARFRUIT, US << MARKET, 5057, 1, 529200)
(STARFRUIT, US << MARKET, 5057, 1, 529200)
(STARFRUIT, MARKET << US, 5058, 1, 529200)","{""AMETHYSTS"": 4, ""STARFRUIT"": 4}",3591,5061,10001
529300,10116,-46541,"(STARFRUIT, MARKET << US, 5058, 1, 529300)
(STARFRUIT, MARKET << US, 5058, 1, 529300)","{""AMETHYSTS"": 4, ""STARFRUIT"": 2}",3573,5057,10000
529600,9882,-36659,"(AMETHYSTS, MARKET << US, 10004, 1, 529600)
(AMETHYSTS, MARKET << US, 10004, 1, 529600)
(STARFRUIT, US << MARKET, 5063, 1, 529600)
(STARFRUIT, US << MARKET, 5063, 1, 529600)","{""AMETHYSTS"": 2, ""STARFRUIT"": 4}",3581,5060,10000
529800,19760,-16899,"(AMETHYSTS, MARKET << US, 9998, 1, 529800)
(AMETHYSTS, MARKET << US, 9998, 1, 529800)
(AMETHYSTS, MARKET << US, 9998, 1, 529800)
(AMETHYSTS, MARKET << US, 9998, 1, 529800)
(STARFRUIT, US << MARKET, 5058, 1, 529800)
(STARFRUIT, US << MARKET, 5058, 1, 529800)
(STARFRUIT, US << MARKET, 5058, 1, 529800)
(STARFRUIT, US << MARKET, 5058, 1, 529800)","{""AMETHYSTS"": -2, ""STARFRUIT"": 8}",3563,5057,9997
530000,-189924,-206823,"(AMETHYSTS, US << MARKET, 9996, 1, 530000)
(AMETHYSTS, US << MARKET, 9996, 1, 530000)
(AMETHYSTS, US << MARKET, 9996, 1, 530000)
(AMETHYSTS, US << MARKET, 9996, 1, 530000)
(AMETHYSTS, US << MARKET, 9996, 1, 530000)
(AMETHYSTS, US << MARKET, 9996, 1, 530000)
(AMETHYSTS, US << MARKET, 9996, 1, 530000)
(AMETHYSTS, US << MARKET, 9996, 1, 530000)
(AMETHYSTS, US << MARKET, 9996, 1, 530000)
(AMETHYSTS, US << MARKET, 9996, 1, 530000)
(AMETHYSTS, US << MARKET, 9996, 1, 530000)
(AMETHYSTS, US << MARKET, 9996, 1, 530000)
(AMETHYSTS, US << MARKET, 9996, 1, 530000)
(AMETHYSTS, US << MARKET, 9996, 1, 530000)
(AMETHYSTS, US << MARKET, 9996, 1, 530000)
(AMETHYSTS, US << MARKET, 9996, 1, 530000)
(AMETHYSTS, US << MARKET, 9996, 1, 530000)
(AMETHYSTS, US << MARKET, 9996, 1, 530000)
(AMETHYSTS, US << MARKET, 9996, 1, 530000)
(AMETHYSTS, US << MARKET, 9996, 1, 530000)
(AMETHYSTS, MARKET << US, 9996, 1, 530000)","{""AMETHYSTS"": 17, ""STARFRUIT"": 8}",3649,5059,10000
530100,-5061,-211884,"(AMETHYSTS, US << MARKET, 9998, 1, 530100)
(AMETHYSTS, US << MARKET, 9998, 1, 530100)
(AMETHYSTS, US << MARKET, 9998, 1, 530100)
(AMETHYSTS, MARKET << US, 9998, 1, 530100)
(AMETHYSTS, MARKET << US, 9998, 1, 530100)
(AMETHYSTS, MARKET << US, 9998, 1, 530100)
(STARFRUIT, US << MARKET, 5061, 1, 530100)","{""AMETHYSTS"": 17, ""STARFRUIT"": 9}",3606,5062,9996
530400,-20004,-231888,"(AMETHYSTS, US << MARKET, 10002, 1, 530400)
(AMETHYSTS, US << MARKET, 10002, 1, 530400)","{""AMETHYSTS"": 19, ""STARFRUIT"": 9}",3700,5059,10003
530500,-10002,-241890,"(AMETHYSTS, US << MARKET, 10002, 1, 530500)","{""AMETHYSTS"": 20, ""STARFRUIT"": 9}",3710,5060,10003
530800,-124,-242014,"(AMETHYSTS, MARKET << US, 9998, 1, 530800)
(STARFRUIT, US << MARKET, 5061, 1, 530800)
(STARFRUIT, US << MARKET, 5061, 1, 530800)","{""AMETHYSTS"": 19, ""STARFRUIT"": 11}",3611,5062,9997
531800,69965,-172049,"(AMETHYSTS, MARKET << US, 9995, 1, 531800)
(AMETHYSTS, MARKET << US, 9995, 1, 531800)
(AMETHYSTS, MARKET << US, 9995, 1, 531800)
(AMETHYSTS, MARKET << US, 9995, 1, 531800)
(AMETHYSTS, MARKET << US, 9995, 1, 531800)
(AMETHYSTS, MARKET << US, 9995, 1, 531800)
(AMETHYSTS, MARKET << US, 9995, 1, 531800)","{""AMETHYSTS"": 12, ""STARFRUIT"": 11}",3622,5061,10000
531900,-5058,-177107,"(STARFRUIT, US << MARKET, 5058, 1, 531900)","{""AMETHYSTS"": 12, ""STARFRUIT"": 12}",3589,5061,9997
532100,-20264,-197371,"(STARFRUIT, US << MARKET, 5066, 1, 532100)
(STARFRUIT, US << MARKET, 5066, 1, 532100)
(STARFRUIT, US << MARKET, 5066, 1, 532100)
(STARFRUIT, US << MARKET, 5066, 1, 532100)","{""AMETHYSTS"": 12, ""STARFRUIT"": 16}",3597,5062,9998
532200,5065,-192306,"(STARFRUIT, MARKET << US, 5065, 1, 532200)","{""AMETHYSTS"": 12, ""STARFRUIT"": 15}",3624,5062,10000
532900,-20240,-212546,"(STARFRUIT, US << MARKET, 5060, 1, 532900)
(STARFRUIT, US << MARKET, 5060, 1, 532900)
(STARFRUIT, US << MARKET, 5060, 1, 532900)
(STARFRUIT, US << MARKET, 5060, 1, 532900)","{""AMETHYSTS"": 12, ""STARFRUIT"": 19}",3639,5063,9999
533600,-5063,-217609,"(STARFRUIT, US << MARKET, 5063, 1, 533600)","{""AMETHYSTS"": 12, ""STARFRUIT"": 20}",3651,5063,10000
533900,19992,-197617,"(AMETHYSTS, MARKET << US, 9996, 1, 533900)
(AMETHYSTS, MARKET << US, 9996, 1, 533900)","{""AMETHYSTS"": 10, ""STARFRUIT"": 20}",3643,5063,10000
534100,-10002,-207619,"(AMETHYSTS, US << MARKET, 10002, 1, 534100)","{""AMETHYSTS"": 11, ""STARFRUIT"": 20}",3654,5062,10003
534300,-10004,-217623,"(AMETHYSTS, US << MARKET, 10004, 1, 534300)","{""AMETHYSTS"": 12, ""STARFRUIT"": 20}",3677,5065,10000
534400,-60012,-277635,"(AMETHYSTS, US << MARKET, 10002, 1, 534400)
(AMETHYSTS, US << MARKET, 10002, 1, 534400)
(AMETHYSTS, US << MARKET, 10002, 1, 534400)
(AMETHYSTS, US << MARKET, 10002, 1, 534400)
(AMETHYSTS, US << MARKET, 10002, 1, 534400)
(AMETHYSTS, US << MARKET, 10002, 1, 534400)","{""AMETHYSTS"": 18, ""STARFRUIT"": 20}",3719,5065,10003
534500,19990,-257645,"(AMETHYSTS, MARKET << US, 9995, 1, 534500)
(AMETHYSTS, MARKET << US, 9995, 1, 534500)","{""AMETHYSTS"": 16, ""STARFRUIT"": 20}",3655,5065,10000
534700,0,-257645,,"{""AMETHYSTS"": 16, ""STARFRUIT"": 20}",3543,5061,9998
534900,-9882,-267527,"(AMETHYSTS, US << MARKET, 10005, 1, 534900)
(AMETHYSTS, US << MARKET, 10005, 1, 534900)
(STARFRUIT, MARKET << US, 5064, 1, 534900)
(STARFRUIT, MARKET << US, 5064, 1, 534900)","{""AMETHYSTS"": 18, ""STARFRUIT"": 18}",3553,5060,10000
535500,9998,-257529,"(AMETHYSTS, MARKET << US, 9998, 1, 535500)","{""AMETHYSTS"": 17, ""STARFRUIT"": 18}",3464,5058,9997
535600,14948,-242581,"(AMETHYSTS, MARKET << US, 10005, 1, 535600)
(AMETHYSTS, MARKET << US, 10005, 1, 535600)
(STARFRUIT, US << MARKET, 5062, 1, 535600)","{""AMETHYSTS"": 15, ""STARFRUIT"": 19}",3612,5062,10001
535900,-5057,-247638,"(STARFRUIT, US << MARKET, 5057, 1, 535900)","{""AMETHYSTS"": 15, ""STARFRUIT"": 20}",3482,5056,10000
536000,-20008,-267646,"(AMETHYSTS, US << MARKET, 10004, 1, 536000)
(AMETHYSTS, US << MARKET, 10004, 1, 536000)","{""AMETHYSTS"": 17, ""STARFRUIT"": 20}",3514,5058,10000
536100,0,-267646,,"{""AMETHYSTS"": 17, ""STARFRUIT"": 20}",3534,5059,10000
536500,25300,-242346,"(STARFRUIT, MARKET << US, 5060, 1, 536500)
(STARFRUIT, MARKET << US, 5060, 1, 536500)
(STARFRUIT, MARKET << US, 5060, 1, 536500)
(STARFRUIT, MARKET << US, 5060, 1, 536500)
(STARFRUIT, MARKET << US, 5060, 1, 536500)","{""AMETHYSTS"": 17, ""STARFRUIT"": 15}",3569,5061,10000
536600,-20004,-262350,"(AMETHYSTS, US << MARKET, 10002, 1, 536600)
(AMETHYSTS, US << MARKET, 10002, 1, 536600)","{""AMETHYSTS"": 19, ""STARFRUIT"": 15}",3592,5059,10003
536900,-9996,-272346,"(AMETHYSTS, US << MARKET, 9996, 1, 536900)","{""AMETHYSTS"": 20, ""STARFRUIT"": 15}",3524,5058,10000
537100,20004,-252342,"(AMETHYSTS, MARKET << US, 10002, 1, 537100)
(AMETHYSTS, MARKET << US, 10002, 1, 537100)","{""AMETHYSTS"": 18, ""STARFRUIT"": 15}",3552,5056,10003
537200,5054,-247288,"(STARFRUIT, MARKET << US, 5054, 1, 537200)","{""AMETHYSTS"": 18, ""STARFRUIT"": 14}",3410,5055,9996
537600,-4948,-252236,"(AMETHYSTS, US << MARKET, 10002, 1, 537600)
(STARFRUIT, MARKET << US, 5054, 1, 537600)","{""AMETHYSTS"": 19, ""STARFRUIT"": 13}",3486,5057,9999
538000,-15065,-267301,"(AMETHYSTS, US << MARKET, 10004, 1, 538000)
(STARFRUIT, US << MARKET, 5061, 1, 538000)","{""AMETHYSTS"": 20, ""STARFRUIT"": 14}",3565,5059,10002
538100,-20248,-287549,"(STARFRUIT, US << MARKET, 5062, 1, 538100)
(STARFRUIT, US << MARKET, 5062, 1, 538100)
(STARFRUIT, US << MARKET, 5062, 1, 538100)
(STARFRUIT, US << MARKET, 5062, 1, 538100)","{""AMETHYSTS"": 20, ""STARFRUIT"": 18}",3493,5059,9999
538800,49990,-237559,"(AMETHYSTS, MARKET << US, 9998, 1, 538800)
(AMETHYSTS, MARKET << US, 9998, 1, 538800)
(AMETHYSTS, MARKET << US, 9998, 1, 538800)
(AMETHYSTS, MARKET << US, 9998, 1, 538800)
(AMETHYSTS, MARKET << US, 9998, 1, 538800)","{""AMETHYSTS"": 15, ""STARFRUIT"": 18}",3458,5059,9997
539200,10118,-227441,"(STARFRUIT, MARKET << US, 5059, 1, 539200)
(STARFRUIT, MARKET << US, 5059, 1, 539200)","{""AMETHYSTS"": 15, ""STARFRUIT"": 16}",3487,5058,10000
539400,4935,-222506,"(AMETHYSTS, MARKET << US, 9998, 1, 539400)
(STARFRUIT, US << MARKET, 5063, 1, 539400)","{""AMETHYSTS"": 14, ""STARFRUIT"": 17}",3523,5063,9997
540000,5064,-217442,"(STARFRUIT, MARKET << US, 5064, 1, 540000)","{""AMETHYSTS"": 14, ""STARFRUIT"": 16}",3596,5064,10001
540200,-20232,-237674,"(STARFRUIT, US << MARKET, 5058, 1, 540200)
(STARFRUIT, US << MARKET, 5058, 1, 540200)
(STARFRUIT, US << MARKET, 5058, 1, 540200)
(STARFRUIT, US << MARKET, 5058, 1, 540200)","{""AMETHYSTS"": 14, ""STARFRUIT"": 20}",3490,5061,9996
540400,-19996,-257670,"(AMETHYSTS, US << MARKET, 9998, 1, 540400)
(AMETHYSTS, US << MARKET, 9998, 1, 540400)","{""AMETHYSTS"": 16, ""STARFRUIT"": 20}",3486,5061,9996
540600,39992,-217678,"(AMETHYSTS, MARKET << US, 9998, 1, 540600)
(AMETHYSTS, MARKET << US, 9998, 1, 540600)
(AMETHYSTS, MARKET << US, 9998, 1, 540600)
(AMETHYSTS, MARKET << US, 9998, 1, 540600)","{""AMETHYSTS"": 12, ""STARFRUIT"": 20}",3506,5061,9997
540700,-70035,-287713,"(AMETHYSTS, US << MARKET, 10005, 1, 540700)
(AMETHYSTS, US << MARKET, 10005, 1, 540700)
(AMETHYSTS, US << MARKET, 10005, 1, 540700)
(AMETHYSTS, US << MARKET, 10005, 1, 540700)
(AMETHYSTS, US << MARKET, 10005, 1, 540700)
(AMETHYSTS, US << MARKET, 10005, 1, 540700)
(AMETHYSTS, US << MARKET, 10005, 1, 540700)","{""AMETHYSTS"": 19, ""STARFRUIT"": 20}",3487,5060,10000
541200,-10002,-297715,"(AMETHYSTS, US << MARKET, 10002, 1, 541200)","{""AMETHYSTS"": 20, ""STARFRUIT"": 20}",3565,5061,10003
541300,0,-297715,,"{""AMETHYSTS"": 20, ""STARFRUIT"": 20}",3505,5061,10000
541500,0,-297715,,"{""AMETHYSTS"": 20, ""STARFRUIT"": 20}",3525,5062,10000
541700,30372,-267343,"(STARFRUIT, MARKET << US, 5062, 1, 541700)
(STARFRUIT, MARKET << US, 5062, 1, 541700)
(STARFRUIT, MARKET << US, 5062, 1, 541700)
(STARFRUIT, MARKET << US, 5062, 1, 541700)
(STARFRUIT, MARKET << US, 5062, 1, 541700)
(STARFRUIT, MARKET << US, 5062, 1, 541700)","{""AMETHYSTS"": 20, ""STARFRUIT"": 14}",3593,5064,10002
541800,-5059,-272402,"(STARFRUIT, US << MARKET, 5059, 1, 541800)","{""AMETHYSTS"": 20, ""STARFRUIT"": 15}",3513,5061,10000
542200,-5059,-277461,"(STARFRUIT, US << MARKET, 5059, 1, 542200)","{""AMETHYSTS"": 20, ""STARFRUIT"": 16}",3515,5061,10000
542400,0,-277461,,"{""AMETHYSTS"": 20, ""STARFRUIT"": 16}",3519,5060,10001
542600,0,-277461,,"{""AMETHYSTS"": 20, ""STARFRUIT"": 16}",3455,5061,9997
542700,0,-277461,,"{""AMETHYSTS"": 20, ""STARFRUIT"": 16}",3499,5060,10000
542800,14943,-262518,"(AMETHYSTS, MARKET << US, 10004, 1, 542800)
(AMETHYSTS, MARKET << US, 10004, 1, 542800)
(STARFRUIT, US << MARKET, 5065, 1, 542800)","{""AMETHYSTS"": 18, ""STARFRUIT"": 17}",3519,5061,10000
543300,20484,-242034,"(AMETHYSTS, US << MARKET, 9998, 1, 543300)
(AMETHYSTS, US << MARKET, 9998, 1, 543300)
(STARFRUIT, MARKET << US, 5060, 1, 543300)
(STARFRUIT, MARKET << US, 5060, 1, 543300)
(STARFRUIT, MARKET << US, 5060, 1, 543300)
(STARFRUIT, MARKET << US, 5060, 1, 543300)
(STARFRUIT, MARKET << US, 5060, 1, 543300)
(STARFRUIT, MARKET << US, 5060, 1, 543300)
(STARFRUIT, MARKET << US, 5060, 1, 543300)
(STARFRUIT, MARKET << US, 5060, 1, 543300)","{""AMETHYSTS"": 20, ""STARFRUIT"": 9}",3417,5059,9996
543700,-20240,-262274,"(STARFRUIT, US << MARKET, 5060, 1, 543700)
(STARFRUIT, US << MARKET, 5060, 1, 543700)
(STARFRUIT, US << MARKET, 5060, 1, 543700)
(STARFRUIT, US << MARKET, 5060, 1, 543700)","{""AMETHYSTS"": 20, ""STARFRUIT"": 13}",3493,5059,10000
543800,-20236,-282510,"(STARFRUIT, US << MARKET, 5059, 1, 543800)
(STARFRUIT, US << MARKET, 5059, 1, 543800)
(STARFRUIT, US << MARKET, 5059, 1, 543800)
(STARFRUIT, US << MARKET, 5059, 1, 543800)","{""AMETHYSTS"": 20, ""STARFRUIT"": 17}",3564,5062,10001
543900,-5064,-287574,"(STARFRUIT, US << MARKET, 5064, 1, 543900)","{""AMETHYSTS"": 20, ""STARFRUIT"": 18}",3524,5061,10000
544000,14940,-272634,"(AMETHYSTS, MARKET << US, 10002, 1, 544000)
(AMETHYSTS, MARKET << US, 10002, 1, 544000)
(STARFRUIT, US << MARKET, 5064, 1, 544000)","{""AMETHYSTS"": 18, ""STARFRUIT"": 19}",3636,5064,10003
544200,-15066,-287700,"(AMETHYSTS, US << MARKET, 10002, 1, 544200)
(STARFRUIT, US << MARKET, 5064, 1, 544200)","{""AMETHYSTS"": 19, ""STARFRUIT"": 20}",3501,5061,9999
544500,9998,-277702,"(AMETHYSTS, MARKET << US, 9998, 1, 544500)","{""AMETHYSTS"": 18, ""STARFRUIT"": 20}",3446,5061,9996
544800,0,-277702,,"{""AMETHYSTS"": 18, ""STARFRUIT"": 20}",3518,5061,10000
545000,0,-277702,,"{""AMETHYSTS"": 18, ""STARFRUIT"": 20}",3460,5059,9999
545200,0,-277702,,"{""AMETHYSTS"": 18, ""STARFRUIT"": 20}",3498,5060,10000
545500,-19996,-297698,"(AMETHYSTS, US << MARKET, 9998, 1, 545500)
(AMETHYSTS, US << MARKET, 9998, 1, 545500)","{""AMETHYSTS"": 20, ""STARFRUIT"": 20}",3482,5062,9997
545600,5065,-292633,"(STARFRUIT, MARKET << US, 5065, 1, 545600)","{""AMETHYSTS"": 20, ""STARFRUIT"": 19}",3526,5061,10000
545800,5060,-287573,"(STARFRUIT, MARKET << US, 5060, 1, 545800)","{""AMETHYSTS"": 20, ""STARFRUIT"": 18}",3619,5064,10002
545900,20008,-267565,"(AMETHYSTS, MARKET << US, 10004, 1, 545900)
(AMETHYSTS, MARKET << US, 10004, 1, 545900)","{""AMETHYSTS"": 18, ""STARFRUIT"": 18}",3587,5063,10001
546000,60012,-207553,"(AMETHYSTS, MARKET << US, 10002, 1, 546000)
(AMETHYSTS, MARKET << US, 10002, 1, 546000)
(AMETHYSTS, MARKET << US, 10002, 1, 546000)
(AMETHYSTS, MARKET << US, 10002, 1, 546000)
(AMETHYSTS, MARKET << US, 10002, 1, 546000)
(AMETHYSTS, MARKET << US, 10002, 1, 546000)","{""AMETHYSTS"": 12, ""STARFRUIT"": 18}",3599,5062,10003
546100,29876,-177677,"(AMETHYSTS, MARKET << US, 10002, 1, 546100)
(AMETHYSTS, MARKET << US, 10002, 1, 546100)
(AMETHYSTS, MARKET << US, 10002, 1, 546100)
(AMETHYSTS, MARKET << US, 10002, 1, 546100)
(STARFRUIT, US << MARKET, 5066, 1, 546100)
(STARFRUIT, US << MARKET, 5066, 1, 546100)","{""AMETHYSTS"": 8, ""STARFRUIT"": 20}",3547,5062,9998
546500,59970,-117707,"(AMETHYSTS, MARKET << US, 9995, 1, 546500)
(AMETHYSTS, MARKET << US, 9995, 1, 546500)
(AMETHYSTS, MARKET << US, 9995, 1, 546500)
(AMETHYSTS, MARKET << US, 9995, 1, 546500)
(AMETHYSTS, MARKET << US, 9995, 1, 546500)
(AMETHYSTS, MARKET << US, 9995, 1, 546500)","{""AMETHYSTS"": 2, ""STARFRUIT"": 20}",3553,5063,10000
546900,50140,-67567,"(AMETHYSTS, MARKET << US, 10002, 1, 546900)
(AMETHYSTS, MARKET << US, 10002, 1, 546900)
(AMETHYSTS, MARKET << US, 10002, 1, 546900)
(AMETHYSTS, MARKET << US, 10002, 1, 546900)
(STARFRUIT, MARKET << US, 5066, 1, 546900)
(STARFRUIT, MARKET << US, 5066, 1, 546900)","{""AMETHYSTS"": -2, ""STARFRUIT"": 18}",3569,5063,9999
547000,-14931,-82498,"(AMETHYSTS, US << MARKET, 9998, 1, 547000)
(AMETHYSTS, US << MARKET, 9998, 1, 547000)
(STARFRUIT, MARKET << US, 5065, 1, 547000)","{""AMETHYSTS"": 0, ""STARFRUIT"": 17}",3607,5065,9997
547300,-5060,-87558,"(STARFRUIT, US << MARKET, 5060, 1, 547300)","{""AMETHYSTS"": 0, ""STARFRUIT"": 18}",3504,5059,10000
547600,-25062,-112620,"(AMETHYSTS, US << MARKET, 9998, 1, 547600)
(AMETHYSTS, US << MARKET, 9998, 1, 547600)
(STARFRUIT, US << MARKET, 5066, 1, 547600)","{""AMETHYSTS"": 2, ""STARFRUIT"": 19}",3609,5065,9997
548300,-5061,-117681,"(STARFRUIT, US << MARKET, 5061, 1, 548300)","{""AMETHYSTS"": 2, ""STARFRUIT"": 20}",3597,5064,9999
548500,120008,2327,"(AMETHYSTS, MARKET << US, 10002, 1, 548500)
(AMETHYSTS, MARKET << US, 10002, 1, 548500)
(AMETHYSTS, MARKET << US, 10002, 1, 548500)
(AMETHYSTS, MARKET << US, 10002, 1, 548500)
(AMETHYSTS, MARKET << US, 10002, 1, 548500)
(AMETHYSTS, MARKET << US, 10002, 1, 548500)
(AMETHYSTS, MARKET << US, 10002, 1, 548500)
(AMETHYSTS, MARKET << US, 10002, 1, 548500)
(AMETHYSTS, MARKET << US, 9998, 1, 548500)
(AMETHYSTS, MARKET << US, 9998, 1, 548500)
(AMETHYSTS, MARKET << US, 9998, 1, 548500)
(AMETHYSTS, MARKET << US, 9998, 1, 548500)","{""AMETHYSTS"": -10, ""STARFRUIT"": 20}",3557,5063,10003
549100,20004,22331,"(AMETHYSTS, MARKET << US, 10002, 1, 549100)
(AMETHYSTS, MARKET << US, 10002, 1, 549100)","{""AMETHYSTS"": -12, ""STARFRUIT"": 20}",3535,5062,10003
549700,-10002,12329,"(AMETHYSTS, US << MARKET, 10002, 1, 549700)","{""AMETHYSTS"": -11, ""STARFRUIT"": 20}",3620,5064,9999
549800,29994,42323,"(AMETHYSTS, MARKET << US, 9998, 1, 549800)
(AMETHYSTS, MARKET << US, 9998, 1, 549800)
(AMETHYSTS, MARKET << US, 9998, 1, 549800)","{""AMETHYSTS"": -14, ""STARFRUIT"": 20}",3719,5067,9996
549900,0,42323,,"{""AMETHYSTS"": -14, ""STARFRUIT"": 20}",3603,5064,10000
550100,29988,72311,"(AMETHYSTS, US << MARKET, 9996, 1, 550100)
(AMETHYSTS, US << MARKET, 9996, 1, 550100)
(AMETHYSTS, MARKET << US, 9996, 1, 550100)
(AMETHYSTS, MARKET << US, 9996, 1, 550100)
(AMETHYSTS, MARKET << US, 9996, 1, 550100)
(AMETHYSTS, MARKET << US, 9996, 1, 550100)
(AMETHYSTS, MARKET << US, 9996, 1, 550100)","{""AMETHYSTS"": -17, ""STARFRUIT"": 20}",3611,5065,10000
550200,0,72311,,"{""AMETHYSTS"": -17, ""STARFRUIT"": 20}",3551,5062,10000
550300,-19996,52315,"(AMETHYSTS, US << MARKET, 9998, 1, 550300)
(AMETHYSTS, US << MARKET, 9998, 1, 550300)","{""AMETHYSTS"": -15, ""STARFRUIT"": 20}",3715,5067,9996
550700,0,52315,,"{""AMETHYSTS"": -15, ""STARFRUIT"": 20}",3595,5064,10000
551300,25330,77645,"(STARFRUIT, MARKET << US, 5066, 1, 551300)
(STARFRUIT, MARKET << US, 5066, 1, 551300)
(STARFRUIT, MARKET << US, 5066, 1, 551300)
(STARFRUIT, MARKET << US, 5066, 1, 551300)
(STARFRUIT, MARKET << US, 5066, 1, 551300)","{""AMETHYSTS"": -15, ""STARFRUIT"": 15}",3635,5064,9998
551800,-120060,-42415,"(AMETHYSTS, US << MARKET, 10005, 1, 551800)
(AMETHYSTS, US << MARKET, 10005, 1, 551800)
(AMETHYSTS, US << MARKET, 10005, 1, 551800)
(AMETHYSTS, US << MARKET, 10005, 1, 551800)
(AMETHYSTS, US << MARKET, 10005, 1, 551800)
(AMETHYSTS, US << MARKET, 10005, 1, 551800)
(AMETHYSTS, US << MARKET, 10005, 1, 551800)
(AMETHYSTS, US << MARKET, 10005, 1, 551800)
(AMETHYSTS, US << MARKET, 10005, 1, 551800)
(AMETHYSTS, US << MARKET, 10005, 1, 551800)
(AMETHYSTS, US << MARKET, 10005, 1, 551800)
(AMETHYSTS, US << MARKET, 10005, 1, 551800)","{""AMETHYSTS"": -3, ""STARFRUIT"": 15}",3575,5066,10000
552300,-20256,-62671,"(STARFRUIT, US << MARKET, 5064, 1, 552300)
(STARFRUIT, US << MARKET, 5064, 1, 552300)
(STARFRUIT, US << MARKET, 5064, 1, 552300)
(STARFRUIT, US << MARKET, 5064, 1, 552300)","{""AMETHYSTS"": -3, ""STARFRUIT"": 19}",3523,5063,10001
552400,14928,-47743,"(AMETHYSTS, MARKET << US, 9996, 1, 552400)
(AMETHYSTS, MARKET << US, 9996, 1, 552400)
(STARFRUIT, US << MARKET, 5064, 1, 552400)","{""AMETHYSTS"": -5, ""STARFRUIT"": 20}",3597,5067,10000
552600,5064,-42679,"(STARFRUIT, MARKET << US, 5064, 1, 552600)","{""AMETHYSTS"": -5, ""STARFRUIT"": 19}",3575,5066,10000
552800,-14927,-57606,"(AMETHYSTS, US << MARKET, 9998, 1, 552800)
(AMETHYSTS, US << MARKET, 9998, 1, 552800)
(STARFRUIT, MARKET << US, 5069, 1, 552800)","{""AMETHYSTS"": -3, ""STARFRUIT"": 18}",3648,5069,9996
553500,-5065,-62671,"(STARFRUIT, US << MARKET, 5065, 1, 553500)","{""AMETHYSTS"": -3, ""STARFRUIT"": 19}",3624,5068,9999
554100,-5065,-67736,"(STARFRUIT, US << MARKET, 5065, 1, 554100)","{""AMETHYSTS"": -3, ""STARFRUIT"": 20}",3601,5067,10001
554600,9998,-57738,"(AMETHYSTS, MARKET << US, 9998, 1, 554600)","{""AMETHYSTS"": -4, ""STARFRUIT"": 20}",3634,5068,9997
554700,0,-57738,,"{""AMETHYSTS"": -4, ""STARFRUIT"": 20}",3618,5068,10001
554800,9998,-47740,"(AMETHYSTS, MARKET << US, 9998, 1, 554800)","{""AMETHYSTS"": -5, ""STARFRUIT"": 20}",3635,5068,9997
555000,80016,32276,"(AMETHYSTS, MARKET << US, 10002, 1, 555000)
(AMETHYSTS, MARKET << US, 10002, 1, 555000)
(AMETHYSTS, MARKET << US, 10002, 1, 555000)
(AMETHYSTS, MARKET << US, 10002, 1, 555000)
(AMETHYSTS, MARKET << US, 10002, 1, 555000)
(AMETHYSTS, MARKET << US, 10002, 1, 555000)
(AMETHYSTS, MARKET << US, 10002, 1, 555000)
(AMETHYSTS, MARKET << US, 10002, 1, 555000)","{""AMETHYSTS"": -13, ""STARFRUIT"": 20}",3597,5068,10003
555200,20004,52280,"(AMETHYSTS, MARKET << US, 10002, 1, 555200)
(AMETHYSTS, MARKET << US, 10002, 1, 555200)","{""AMETHYSTS"": -15, ""STARFRUIT"": 20}",3575,5067,10003
555300,-10002,42278,"(AMETHYSTS, US << MARKET, 10002, 1, 555300)","{""AMETHYSTS"": -14, ""STARFRUIT"": 20}",3596,5068,10003
555400,-19996,22282,"(AMETHYSTS, US << MARKET, 9998, 1, 555400)
(AMETHYSTS, US << MARKET, 9998, 1, 555400)","{""AMETHYSTS"": -12, ""STARFRUIT"": 20}",3670,5067,9996
555600,-10002,12280,"(AMETHYSTS, US << MARKET, 10002, 1, 555600)","{""AMETHYSTS"": -11, ""STARFRUIT"": 20}",3607,5068,10003
555900,20004,32284,"(AMETHYSTS, MARKET << US, 10002, 1, 555900)
(AMETHYSTS, MARKET << US, 10002, 1, 555900)","{""AMETHYSTS"": -13, ""STARFRUIT"": 20}",3605,5068,10003
556100,-39984,-7700,"(AMETHYSTS, US << MARKET, 9996, 1, 556100)
(AMETHYSTS, US << MARKET, 9996, 1, 556100)
(AMETHYSTS, US << MARKET, 9996, 1, 556100)
(AMETHYSTS, US << MARKET, 9996, 1, 556100)","{""AMETHYSTS"": -9, ""STARFRUIT"": 20}",3669,5068,9999
556400,35490,27790,"(STARFRUIT, MARKET << US, 5070, 1, 556400)
(STARFRUIT, MARKET << US, 5070, 1, 556400)
(STARFRUIT, MARKET << US, 5070, 1, 556400)
(STARFRUIT, MARKET << US, 5070, 1, 556400)
(STARFRUIT, MARKET << US, 5070, 1, 556400)
(STARFRUIT, MARKET << US, 5070, 1, 556400)
(STARFRUIT, MARKET << US, 5070, 1, 556400)","{""AMETHYSTS"": -9, ""STARFRUIT"": 13}",3674,5068,10000
557100,-20256,7534,"(STARFRUIT, US << MARKET, 5064, 1, 557100)
(STARFRUIT, US << MARKET, 5064, 1, 557100)
(STARFRUIT, US << MARKET, 5064, 1, 557100)
(STARFRUIT, US << MARKET, 5064, 1, 557100)","{""AMETHYSTS"": -9, ""STARFRUIT"": 17}",3664,5067,10001
557300,-15195,-7661,"(STARFRUIT, US << MARKET, 5065, 1, 557300)
(STARFRUIT, US << MARKET, 5065, 1, 557300)
(STARFRUIT, US << MARKET, 5065, 1, 557300)","{""AMETHYSTS"": -9, ""STARFRUIT"": 20}",3672,5068,10003
557600,9996,2335,"(AMETHYSTS, MARKET << US, 9996, 1, 557600)","{""AMETHYSTS"": -10, ""STARFRUIT"": 20}",3655,5066,10000
557700,0,2335,,"{""AMETHYSTS"": -10, ""STARFRUIT"": 20}",3655,5066,10000
557900,-39992,-37657,"(AMETHYSTS, US << MARKET, 9998, 1, 557900)
(AMETHYSTS, US << MARKET, 9998, 1, 557900)
(AMETHYSTS, US << MARKET, 9998, 1, 557900)
(AMETHYSTS, US << MARKET, 9998, 1, 557900)","{""AMETHYSTS"": -6, ""STARFRUIT"": 20}",3681,5066,9997
558000,0,-37657,,"{""AMETHYSTS"": -6, ""STARFRUIT"": 20}",3717,5069,10001
558900,-99980,-137637,"(AMETHYSTS, US << MARKET, 9998, 1, 558900)
(AMETHYSTS, US << MARKET, 9998, 1, 558900)
(AMETHYSTS, US << MARKET, 9998, 1, 558900)
(AMETHYSTS, US << MARKET, 9998, 1, 558900)
(AMETHYSTS, US << MARKET, 9998, 1, 558900)
(AMETHYSTS, US << MARKET, 9998, 1, 558900)
(AMETHYSTS, US << MARKET, 9998, 1, 558900)
(AMETHYSTS, US << MARKET, 9998, 1, 558900)
(AMETHYSTS, US << MARKET, 9998, 1, 558900)
(AMETHYSTS, US << MARKET, 9998, 1, 558900)","{""AMETHYSTS"": 4, ""STARFRUIT"": 20}",3687,5067,9996
559100,-14929,-152566,"(AMETHYSTS, US << MARKET, 9996, 1, 559100)
(AMETHYSTS, US << MARKET, 9996, 1, 559100)
(STARFRUIT, MARKET << US, 5063, 1, 559100)","{""AMETHYSTS"": 6, ""STARFRUIT"": 19}",3669,5065,10000
559200,20004,-132562,"(AMETHYSTS, MARKET << US, 10002, 1, 559200)
(AMETHYSTS, MARKET << US, 10002, 1, 559200)","{""AMETHYSTS"": 4, ""STARFRUIT"": 19}",3688,5066,9999
559400,-10002,-142564,"(AMETHYSTS, US << MARKET, 10002, 1, 559400)","{""AMETHYSTS"": 5, ""STARFRUIT"": 19}",3724,5067,10003
559600,9998,-132566,"(AMETHYSTS, MARKET << US, 9998, 1, 559600)","{""AMETHYSTS"": 4, ""STARFRUIT"": 19}",3711,5067,10001
560200,-5065,-137631,"(STARFRUIT, US << MARKET, 5065, 1, 560200)","{""AMETHYSTS"": 4, ""STARFRUIT"": 20}",3741,5068,10003
560500,-10002,-147633,"(AMETHYSTS, US << MARKET, 10002, 1, 560500)","{""AMETHYSTS"": 5, ""STARFRUIT"": 20}",3742,5068,10003
560700,0,-147633,,"{""AMETHYSTS"": 5, ""STARFRUIT"": 20}",3732,5068,10001
560800,-14931,-162564,"(AMETHYSTS, US << MARKET, 9998, 1, 560800)
(AMETHYSTS, US << MARKET, 9998, 1, 560800)
(STARFRUIT, MARKET << US, 5065, 1, 560800)","{""AMETHYSTS"": 7, ""STARFRUIT"": 19}",3735,5068,10001
560900,9998,-152566,"(AMETHYSTS, MARKET << US, 9998, 1, 560900)","{""AMETHYSTS"": 6, ""STARFRUIT"": 19}",3732,5068,10001
561200,-5065,-157631,"(STARFRUIT, US << MARKET, 5065, 1, 561200)","{""AMETHYSTS"": 6, ""STARFRUIT"": 20}",3649,5064,10000
561300,30252,-127379,"(AMETHYSTS, MARKET << US, 9996, 1, 561300)
(STARFRUIT, MARKET << US, 5064, 1, 561300)
(STARFRUIT, MARKET << US, 5064, 1, 561300)
(STARFRUIT, MARKET << US, 5064, 1, 561300)
(STARFRUIT, MARKET << US, 5064, 1, 561300)","{""AMETHYSTS"": 5, ""STARFRUIT"": 16}",3677,5066,10000
562100,20004,-107375,"(AMETHYSTS, MARKET << US, 10002, 1, 562100)
(AMETHYSTS, MARKET << US, 10002, 1, 562100)","{""AMETHYSTS"": 3, ""STARFRUIT"": 16}",3690,5066,10003
562200,-80020,-187395,"(AMETHYSTS, US << MARKET, 10002, 1, 562200)
(AMETHYSTS, US << MARKET, 10002, 1, 562200)
(AMETHYSTS, US << MARKET, 10002, 1, 562200)
(AMETHYSTS, US << MARKET, 10002, 1, 562200)
(AMETHYSTS, US << MARKET, 10002, 1, 562200)
(AMETHYSTS, US << MARKET, 10002, 1, 562200)
(AMETHYSTS, US << MARKET, 10002, 1, 562200)
(AMETHYSTS, US << MARKET, 10002, 1, 562200)
(AMETHYSTS, US << MARKET, 10002, 1, 562200)
(AMETHYSTS, MARKET << US, 9998, 1, 562200)","{""AMETHYSTS"": 11, ""STARFRUIT"": 16}",3678,5065,10003
562300,-20252,-207647,"(STARFRUIT, US << MARKET, 5063, 1, 562300)
(STARFRUIT, US << MARKET, 5063, 1, 562300)
(STARFRUIT, US << MARKET, 5063, 1, 562300)
(STARFRUIT, US << MARKET, 5063, 1, 562300)","{""AMETHYSTS"": 11, ""STARFRUIT"": 20}",3664,5065,10001
562400,20272,-187375,"(STARFRUIT, MARKET << US, 5068, 1, 562400)
(STARFRUIT, MARKET << US, 5068, 1, 562400)
(STARFRUIT, MARKET << US, 5068, 1, 562400)
(STARFRUIT, MARKET << US, 5068, 1, 562400)","{""AMETHYSTS"": 11, ""STARFRUIT"": 16}",3643,5065,9998
562500,-20280,-207655,"(STARFRUIT, US << MARKET, 5070, 1, 562500)
(STARFRUIT, US << MARKET, 5070, 1, 562500)
(STARFRUIT, US << MARKET, 5070, 1, 562500)
(STARFRUIT, US << MARKET, 5070, 1, 562500)","{""AMETHYSTS"": 11, ""STARFRUIT"": 20}",3685,5067,10000
562600,-39984,-247639,"(AMETHYSTS, US << MARKET, 9996, 1, 562600)
(AMETHYSTS, US << MARKET, 9996, 1, 562600)
(AMETHYSTS, US << MARKET, 9996, 1, 562600)
(AMETHYSTS, US << MARKET, 9996, 1, 562600)","{""AMETHYSTS"": 15, ""STARFRUIT"": 20}",3681,5066,10000
563200,5068,-242571,"(STARFRUIT, MARKET << US, 5068, 1, 563200)","{""AMETHYSTS"": 15, ""STARFRUIT"": 19}",3755,5069,10001
563300,5069,-237502,"(STARFRUIT, MARKET << US, 5069, 1, 563300)","{""AMETHYSTS"": 15, ""STARFRUIT"": 18}",3683,5065,10001
563500,-19996,-257498,"(AMETHYSTS, US << MARKET, 9998, 1, 563500)
(AMETHYSTS, US << MARKET, 9998, 1, 563500)","{""AMETHYSTS"": 17, ""STARFRUIT"": 18}",3707,5066,10001
563700,19992,-237506,"(AMETHYSTS, MARKET << US, 9996, 1, 563700)
(AMETHYSTS, MARKET << US, 9996, 1, 563700)","{""AMETHYSTS"": 15, ""STARFRUIT"": 18}",3664,5065,10000
564200,40567,-196939,"(STARFRUIT, US << MARKET, 5063, 1, 564200)
(STARFRUIT, MARKET << US, 5070, 1, 564200)
(STARFRUIT, MARKET << US, 5070, 1, 564200)
(STARFRUIT, MARKET << US, 5070, 1, 564200)
(STARFRUIT, MARKET << US, 5070, 1, 564200)
(STARFRUIT, MARKET << US, 5070, 1, 564200)
(STARFRUIT, MARKET << US, 5070, 1, 564200)
(STARFRUIT, MARKET << US, 5070, 1, 564200)
(STARFRUIT, MARKET << US, 5070, 1, 564200)
(STARFRUIT, MARKET << US, 5070, 1, 564200)","{""AMETHYSTS"": 15, ""STARFRUIT"": 10}",3661,5066,9996
564600,-5069,-202008,"(STARFRUIT, US << MARKET, 5069, 1, 564600)","{""AMETHYSTS"": 15, ""STARFRUIT"": 11}",3751,5069,10000
564700,100350,-101658,"(AMETHYSTS, MARKET << US, 9996, 1, 564700)
(AMETHYSTS, MARKET << US, 9996, 1, 564700)
(AMETHYSTS, MARKET << US, 9996, 1, 564700)
(AMETHYSTS, MARKET << US, 9996, 1, 564700)
(AMETHYSTS, MARKET << US, 9996, 1, 564700)
(AMETHYSTS, MARKET << US, 9996, 1, 564700)
(AMETHYSTS, MARKET << US, 9996, 1, 564700)
(STARFRUIT, MARKET << US, 5063, 1, 564700)
(STARFRUIT, MARKET << US, 5063, 1, 564700)
(STARFRUIT, MARKET << US, 5063, 1, 564700)
(STARFRUIT, MARKET << US, 5063, 1, 564700)
(STARFRUIT, MARKET << US, 5063, 1, 564700)
(STARFRUIT, MARKET << US, 5063, 1, 564700)","{""AMETHYSTS"": 8, ""STARFRUIT"": 5}",3667,5065,10000
564800,-15192,-116850,"(STARFRUIT, US << MARKET, 5064, 1, 564800)
(STARFRUIT, US << MARKET, 5064, 1, 564800)
(STARFRUIT, US << MARKET, 5064, 1, 564800)","{""AMETHYSTS"": 8, ""STARFRUIT"": 8}",3686,5067,10000
564900,-4934,-121784,"(AMETHYSTS, US << MARKET, 10004, 1, 564900)
(STARFRUIT, MARKET << US, 5070, 1, 564900)","{""AMETHYSTS"": 9, ""STARFRUIT"": 7}",3678,5066,10000
565100,25079,-96705,"(AMETHYSTS, MARKET << US, 10005, 1, 565100)
(AMETHYSTS, MARKET << US, 10005, 1, 565100)
(STARFRUIT, MARKET << US, 5069, 1, 565100)","{""AMETHYSTS"": 7, ""STARFRUIT"": 6}",3685,5065,10000
565200,5063,-91642,"(STARFRUIT, MARKET << US, 5063, 1, 565200)","{""AMETHYSTS"": 7, ""STARFRUIT"": 5}",3683,5065,10000
566100,-10002,-101644,"(AMETHYSTS, US << MARKET, 10002, 1, 566100)","{""AMETHYSTS"": 8, ""STARFRUIT"": 5}",3676,5064,10000
566200,-19996,-121640,"(AMETHYSTS, US << MARKET, 9998, 1, 566200)
(AMETHYSTS, US << MARKET, 9998, 1, 566200)","{""AMETHYSTS"": 10, ""STARFRUIT"": 5}",3645,5063,9997
566400,-20240,-141880,"(STARFRUIT, US << MARKET, 5060, 1, 566400)
(STARFRUIT, US << MARKET, 5060, 1, 566400)
(STARFRUIT, US << MARKET, 5060, 1, 566400)
(STARFRUIT, US << MARKET, 5060, 1, 566400)","{""AMETHYSTS"": 10, ""STARFRUIT"": 9}",3647,5063,9996
566600,-20244,-162124,"(STARFRUIT, US << MARKET, 5061, 1, 566600)
(STARFRUIT, US << MARKET, 5061, 1, 566600)
(STARFRUIT, US << MARKET, 5061, 1, 566600)
(STARFRUIT, US << MARKET, 5061, 1, 566600)","{""AMETHYSTS"": 10, ""STARFRUIT"": 13}",3718,5064,10001
566900,-15064,-177188,"(AMETHYSTS, US << MARKET, 10002, 1, 566900)
(STARFRUIT, US << MARKET, 5062, 1, 566900)","{""AMETHYSTS"": 11, ""STARFRUIT"": 14}",3755,5065,10003
567200,15056,-162132,"(AMETHYSTS, MARKET << US, 9996, 1, 567200)
(STARFRUIT, MARKET << US, 5060, 1, 567200)","{""AMETHYSTS"": 10, ""STARFRUIT"": 13}",3687,5063,10000
567300,-5066,-167198,"(STARFRUIT, US << MARKET, 5066, 1, 567300)","{""AMETHYSTS"": 10, ""STARFRUIT"": 14}",3700,5062,10003
567500,-29860,-197058,"(AMETHYSTS, US << MARKET, 9996, 1, 567500)
(AMETHYSTS, US << MARKET, 9996, 1, 567500)
(AMETHYSTS, US << MARKET, 9996, 1, 567500)
(AMETHYSTS, US << MARKET, 9996, 1, 567500)
(STARFRUIT, MARKET << US, 5062, 1, 567500)
(STARFRUIT, MARKET << US, 5062, 1, 567500)","{""AMETHYSTS"": 14, ""STARFRUIT"": 12}",3722,5065,10000
567800,-5067,-202125,"(STARFRUIT, US << MARKET, 5067, 1, 567800)","{""AMETHYSTS"": 14, ""STARFRUIT"": 13}",3788,5067,10003
568600,9998,-192127,"(AMETHYSTS, MARKET << US, 9998, 1, 568600)","{""AMETHYSTS"": 13, ""STARFRUIT"": 13}",3666,5062,9999
569100,-20004,-212131,"(AMETHYSTS, US << MARKET, 10002, 1, 569100)
(AMETHYSTS, US << MARKET, 10002, 1, 569100)","{""AMETHYSTS"": 15, ""STARFRUIT"": 13}",3746,5064,10003
569200,-14931,-227062,"(AMETHYSTS, US << MARKET, 9996, 1, 569200)
(AMETHYSTS, US << MARKET, 9996, 1, 569200)
(STARFRUIT, MARKET << US, 5061, 1, 569200)","{""AMETHYSTS"": 17, ""STARFRUIT"": 12}",3706,5064,10000
569400,-40236,-267298,"(AMETHYSTS, US << MARKET, 9998, 1, 569400)
(AMETHYSTS, US << MARKET, 9998, 1, 569400)
(STARFRUIT, US << MARKET, 5060, 1, 569400)
(STARFRUIT, US << MARKET, 5060, 1, 569400)
(STARFRUIT, US << MARKET, 5060, 1, 569400)
(STARFRUIT, US << MARKET, 5060, 1, 569400)","{""AMETHYSTS"": 19, ""STARFRUIT"": 16}",3634,5063,9996
569500,65041,-202257,"(AMETHYSTS, MARKET << US, 9996, 1, 569500)
(AMETHYSTS, MARKET << US, 9996, 1, 569500)
(AMETHYSTS, MARKET << US, 9996, 1, 569500)
(AMETHYSTS, MARKET << US, 9996, 1, 569500)
(AMETHYSTS, MARKET << US, 9996, 1, 569500)
(AMETHYSTS, MARKET << US, 9996, 1, 569500)
(STARFRUIT, US << MARKET, 5065, 1, 569500)
(STARFRUIT, MARKET << US, 5065, 1, 569500)
(STARFRUIT, MARKET << US, 5065, 1, 569500)","{""AMETHYSTS"": 13, ""STARFRUIT"": 15}",3720,5066,9999
569600,-5061,-207318,"(STARFRUIT, US << MARKET, 5061, 1, 569600)","{""AMETHYSTS"": 13, ""STARFRUIT"": 16}",3642,5060,10000
569800,-5061,-212379,"(STARFRUIT, US << MARKET, 5061, 1, 569800)","{""AMETHYSTS"": 13, ""STARFRUIT"": 17}",3654,5060,10001
570600,40528,-171851,"(STARFRUIT, MARKET << US, 5066, 1, 570600)
(STARFRUIT, MARKET << US, 5066, 1, 570600)
(STARFRUIT, MARKET << US, 5066, 1, 570600)
(STARFRUIT, MARKET << US, 5066, 1, 570600)
(STARFRUIT, MARKET << US, 5066, 1, 570600)
(STARFRUIT, MARKET << US, 5066, 1, 570600)
(STARFRUIT, MARKET << US, 5066, 1, 570600)
(STARFRUIT, MARKET << US, 5066, 1, 570600)","{""AMETHYSTS"": 13, ""STARFRUIT"": 9}",3752,5067,10000
571200,30402,-141449,"(STARFRUIT, MARKET << US, 5067, 1, 571200)
(STARFRUIT, MARKET << US, 5067, 1, 571200)
(STARFRUIT, MARKET << US, 5067, 1, 571200)
(STARFRUIT, MARKET << US, 5067, 1, 571200)
(STARFRUIT, MARKET << US, 5067, 1, 571200)
(STARFRUIT, MARKET << US, 5067, 1, 571200)","{""AMETHYSTS"": 13, ""STARFRUIT"": 3}",3743,5064,10000
571500,-39992,-181441,"(AMETHYSTS, US << MARKET, 9998, 1, 571500)
(AMETHYSTS, US << MARKET, 9998, 1, 571500)
(AMETHYSTS, US << MARKET, 9998, 1, 571500)
(AMETHYSTS, US << MARKET, 9998, 1, 571500)","{""AMETHYSTS"": 17, ""STARFRUIT"": 3}",3694,5062,9997
571600,-10126,-191567,"(STARFRUIT, US << MARKET, 5063, 1, 571600)
(STARFRUIT, US << MARKET, 5063, 1, 571600)","{""AMETHYSTS"": 17, ""STARFRUIT"": 5}",3797,5066,10002
572900,-10262,-201829,"(AMETHYSTS, MARKET << US, 9998, 1, 572900)
(STARFRUIT, US << MARKET, 5065, 1, 572900)
(STARFRUIT, US << MARKET, 5065, 1, 572900)
(STARFRUIT, US << MARKET, 5065, 1, 572900)
(STARFRUIT, US << MARKET, 5065, 1, 572900)","{""AMETHYSTS"": 16, ""STARFRUIT"": 9}",3735,5068,9997
573300,-30006,-231835,"(AMETHYSTS, US << MARKET, 10002, 1, 573300)
(AMETHYSTS, US << MARKET, 10002, 1, 573300)
(AMETHYSTS, US << MARKET, 10002, 1, 573300)","{""AMETHYSTS"": 19, ""STARFRUIT"": 9}",3747,5071,9997
573400,20004,-211831,"(AMETHYSTS, MARKET << US, 10002, 1, 573400)
(AMETHYSTS, MARKET << US, 10002, 1, 573400)","{""AMETHYSTS"": 17, ""STARFRUIT"": 9}",3823,5067,10003
574600,-10002,-221833,"(AMETHYSTS, US << MARKET, 10002, 1, 574600)","{""AMETHYSTS"": 18, ""STARFRUIT"": 9}",3833,5068,10003
575300,14937,-206896,"(AMETHYSTS, MARKET << US, 10002, 1, 575300)
(AMETHYSTS, MARKET << US, 10002, 1, 575300)
(STARFRUIT, US << MARKET, 5067, 1, 575300)","{""AMETHYSTS"": 16, ""STARFRUIT"": 10}",3778,5069,9999
575800,5073,-201823,"(STARFRUIT, MARKET << US, 5073, 1, 575800)","{""AMETHYSTS"": 16, ""STARFRUIT"": 9}",3798,5069,10000
575900,9856,-191967,"(AMETHYSTS, MARKET << US, 9995, 1, 575900)
(AMETHYSTS, MARKET << US, 9995, 1, 575900)
(STARFRUIT, US << MARKET, 5067, 1, 575900)
(STARFRUIT, US << MARKET, 5067, 1, 575900)","{""AMETHYSTS"": 14, ""STARFRUIT"": 11}",3803,5070,10000
576000,4931,-187036,"(AMETHYSTS, MARKET << US, 9998, 1, 576000)
(STARFRUIT, US << MARKET, 5067, 1, 576000)","{""AMETHYSTS"": 13, ""STARFRUIT"": 12}",3817,5070,10001
576200,14933,-172103,"(AMETHYSTS, MARKET << US, 10002, 1, 576200)
(AMETHYSTS, MARKET << US, 10002, 1, 576200)
(STARFRUIT, US << MARKET, 5071, 1, 576200)","{""AMETHYSTS"": 11, ""STARFRUIT"": 13}",3866,5072,10003
576300,5066,-167037,"(STARFRUIT, MARKET << US, 5066, 1, 576300)","{""AMETHYSTS"": 11, ""STARFRUIT"": 12}",3791,5069,10000
576700,-10002,-177039,"(AMETHYSTS, US << MARKET, 10002, 1, 576700)","{""AMETHYSTS"": 12, ""STARFRUIT"": 12}",3837,5070,10003
576800,4930,-172109,"(AMETHYSTS, MARKET << US, 9996, 1, 576800)
(STARFRUIT, US << MARKET, 5066, 1, 576800)","{""AMETHYSTS"": 11, ""STARFRUIT"": 13}",3764,5068,9999
577400,5065,-167044,"(STARFRUIT, MARKET << US, 5065, 1, 577400)","{""AMETHYSTS"": 11, ""STARFRUIT"": 12}",3759,5066,10001
577700,100020,-67024,"(AMETHYSTS, MARKET << US, 10002, 1, 577700)
(AMETHYSTS, MARKET << US, 10002, 1, 577700)
(AMETHYSTS, MARKET << US, 10002, 1, 577700)
(AMETHYSTS, MARKET << US, 10002, 1, 577700)
(AMETHYSTS, MARKET << US, 10002, 1, 577700)
(AMETHYSTS, MARKET << US, 10002, 1, 577700)
(AMETHYSTS, MARKET << US, 10002, 1, 577700)
(AMETHYSTS, MARKET << US, 10002, 1, 577700)
(AMETHYSTS, MARKET << US, 10002, 1, 577700)
(AMETHYSTS, MARKET << US, 10002, 1, 577700)","{""AMETHYSTS"": 1, ""STARFRUIT"": 12}",3779,5067,9999
577800,20004,-47020,"(AMETHYSTS, MARKET << US, 10002, 1, 577800)
(AMETHYSTS, MARKET << US, 10002, 1, 577800)","{""AMETHYSTS"": -1, ""STARFRUIT"": 12}",3773,5066,9999
578200,-4933,-51953,"(AMETHYSTS, US << MARKET, 10004, 1, 578200)
(STARFRUIT, MARKET << US, 5071, 1, 578200)","{""AMETHYSTS"": 0, ""STARFRUIT"": 11}",3795,5068,10003
578300,5065,-46888,"(STARFRUIT, MARKET << US, 5065, 1, 578300)","{""AMETHYSTS"": 0, ""STARFRUIT"": 10}",3752,5064,10000
578400,40424,-6464,"(AMETHYSTS, MARKET << US, 9998, 1, 578400)
(STARFRUIT, MARKET << US, 5071, 1, 578400)
(STARFRUIT, MARKET << US, 5071, 1, 578400)
(STARFRUIT, MARKET << US, 5071, 1, 578400)
(STARFRUIT, MARKET << US, 5071, 1, 578400)
(STARFRUIT, MARKET << US, 5071, 1, 578400)
(STARFRUIT, MARKET << US, 5071, 1, 578400)","{""AMETHYSTS"": -1, ""STARFRUIT"": 4}",3808,5067,9996
578600,9998,3534,"(AMETHYSTS, MARKET << US, 9998, 1, 578600)","{""AMETHYSTS"": -2, ""STARFRUIT"": 4}",3806,5069,10002
578800,50156,53690,"(AMETHYSTS, MARKET << US, 10004, 1, 578800)
(AMETHYSTS, MARKET << US, 10004, 1, 578800)
(AMETHYSTS, MARKET << US, 10004, 1, 578800)
(AMETHYSTS, MARKET << US, 10004, 1, 578800)
(STARFRUIT, MARKET << US, 5070, 1, 578800)
(STARFRUIT, MARKET << US, 5070, 1, 578800)","{""AMETHYSTS"": -6, ""STARFRUIT"": 2}",3824,5067,10000
578900,-30120,23570,"(AMETHYSTS, US << MARKET, 9996, 1, 578900)
(AMETHYSTS, US << MARKET, 9996, 1, 578900)
(STARFRUIT, US << MARKET, 5064, 1, 578900)
(STARFRUIT, US << MARKET, 5064, 1, 578900)","{""AMETHYSTS"": -4, ""STARFRUIT"": 4}",3838,5067,10000
579000,-10138,13432,"(STARFRUIT, US << MARKET, 5069, 1, 579000)
(STARFRUIT, US << MARKET, 5069, 1, 579000)","{""AMETHYSTS"": -4, ""STARFRUIT"": 6}",3826,5065,9999
579100,15062,28494,"(AMETHYSTS, MARKET << US, 9998, 1, 579100)
(STARFRUIT, MARKET << US, 5064, 1, 579100)","{""AMETHYSTS"": -5, ""STARFRUIT"": 5}",3824,5067,10001
579300,5063,33557,"(STARFRUIT, MARKET << US, 5063, 1, 579300)","{""AMETHYSTS"": -5, ""STARFRUIT"": 4}",3821,5066,10000
579500,45089,78646,"(AMETHYSTS, MARKET << US, 10005, 1, 579500)
(AMETHYSTS, MARKET << US, 10005, 1, 579500)
(AMETHYSTS, MARKET << US, 10005, 1, 579500)
(AMETHYSTS, MARKET << US, 10004, 1, 579500)
(STARFRUIT, MARKET << US, 5070, 1, 579500)","{""AMETHYSTS"": -9, ""STARFRUIT"": 3}",3844,5066,10000
579600,35448,114094,"(STARFRUIT, MARKET << US, 5064, 1, 579600)
(STARFRUIT, MARKET << US, 5064, 1, 579600)
(STARFRUIT, MARKET << US, 5064, 1, 579600)
(STARFRUIT, MARKET << US, 5064, 1, 579600)
(STARFRUIT, MARKET << US, 5064, 1, 579600)
(STARFRUIT, MARKET << US, 5064, 1, 579600)
(STARFRUIT, MARKET << US, 5064, 1, 579600)","{""AMETHYSTS"": -9, ""STARFRUIT"": -4}",3862,5067,9996
579800,5069,119163,"(STARFRUIT, US << MARKET, 5069, 1, 579800)
(STARFRUIT, MARKET << US, 5069, 1, 579800)
(STARFRUIT, MARKET << US, 5069, 1, 579800)","{""AMETHYSTS"": -9, ""STARFRUIT"": -5}",3804,5070,10001
580000,-10140,109023,"(STARFRUIT, US << MARKET, 5070, 1, 580000)
(STARFRUIT, US << MARKET, 5070, 1, 580000)","{""AMETHYSTS"": -9, ""STARFRUIT"": -3}",3840,5067,9998
580500,-10132,98891,"(STARFRUIT, US << MARKET, 5066, 1, 580500)
(STARFRUIT, US << MARKET, 5066, 1, 580500)","{""AMETHYSTS"": -9, ""STARFRUIT"": -1}",3826,5065,10000
580800,-10140,88751,"(STARFRUIT, US << MARKET, 5070, 1, 580800)
(STARFRUIT, US << MARKET, 5070, 1, 580800)","{""AMETHYSTS"": -9, ""STARFRUIT"": 1}",3821,5070,10000
580900,-10004,78747,"(AMETHYSTS, US << MARKET, 10004, 1, 580900)
(AMETHYSTS, US << MARKET, 10004, 1, 580900)
(AMETHYSTS, US << MARKET, 10004, 1, 580900)
(AMETHYSTS, MARKET << US, 10004, 1, 580900)
(AMETHYSTS, MARKET << US, 10004, 1, 580900)","{""AMETHYSTS"": -8, ""STARFRUIT"": 1}",3815,5068,10000
581600,105111,183858,"(AMETHYSTS, US << MARKET, 10004, 1, 581600)
(AMETHYSTS, MARKET << US, 10004, 1, 581600)
(AMETHYSTS, MARKET << US, 10004, 1, 581600)
(AMETHYSTS, MARKET << US, 10004, 1, 581600)
(AMETHYSTS, MARKET << US, 10004, 1, 581600)
(AMETHYSTS, MARKET << US, 10004, 1, 581600)
(AMETHYSTS, MARKET << US, 10004, 1, 581600)
(AMETHYSTS, MARKET << US, 10004, 1, 581600)
(AMETHYSTS, MARKET << US, 10004, 1, 581600)
(AMETHYSTS, MARKET << US, 10004, 1, 581600)
(AMETHYSTS, MARKET << US, 10004, 1, 581600)
(AMETHYSTS, MARKET << US, 10004, 1, 581600)
(STARFRUIT, MARKET << US, 5071, 1, 581600)","{""AMETHYSTS"": -18, ""STARFRUIT"": 0}",3858,5071,10000
581800,-40008,143850,"(AMETHYSTS, US << MARKET, 10002, 1, 581800)
(AMETHYSTS, US << MARKET, 10002, 1, 581800)
(AMETHYSTS, US << MARKET, 10002, 1, 581800)
(AMETHYSTS, US << MARKET, 10002, 1, 581800)","{""AMETHYSTS"": -14, ""STARFRUIT"": 0}",3808,5069,10003
582000,-59988,83862,"(AMETHYSTS, US << MARKET, 9998, 1, 582000)
(AMETHYSTS, US << MARKET, 9998, 1, 582000)
(AMETHYSTS, US << MARKET, 9998, 1, 582000)
(AMETHYSTS, US << MARKET, 9998, 1, 582000)
(AMETHYSTS, US << MARKET, 9998, 1, 582000)
(AMETHYSTS, US << MARKET, 9998, 1, 582000)","{""AMETHYSTS"": -8, ""STARFRUIT"": 0}",3854,5065,10001
582400,5071,88933,"(STARFRUIT, MARKET << US, 5071, 1, 582400)","{""AMETHYSTS"": -8, ""STARFRUIT"": -1}",3865,5068,10000
582500,-10134,78799,"(STARFRUIT, US << MARKET, 5067, 1, 582500)
(STARFRUIT, US << MARKET, 5067, 1, 582500)","{""AMETHYSTS"": -8, ""STARFRUIT"": 1}",3845,5070,10003
582700,-10134,68665,"(STARFRUIT, US << MARKET, 5067, 1, 582700)
(STARFRUIT, US << MARKET, 5067, 1, 582700)","{""AMETHYSTS"": -8, ""STARFRUIT"": 3}",3855,5066,10001
583200,5068,73733,"(STARFRUIT, MARKET << US, 5068, 1, 583200)","{""AMETHYSTS"": -8, ""STARFRUIT"": 2}",3867,5067,10000
583400,-5331,68402,"(AMETHYSTS, MARKET << US, 10002, 1, 583400)
(AMETHYSTS, MARKET << US, 10002, 1, 583400)
(STARFRUIT, US << MARKET, 5067, 1, 583400)
(STARFRUIT, US << MARKET, 5067, 1, 583400)
(STARFRUIT, US << MARKET, 5067, 1, 583400)
(STARFRUIT, US << MARKET, 5067, 1, 583400)
(STARFRUIT, US << MARKET, 5067, 1, 583400)","{""AMETHYSTS"": -10, ""STARFRUIT"": 7}",3862,5070,10003
583600,5073,73475,"(STARFRUIT, US << MARKET, 5067, 1, 583600)
(STARFRUIT, MARKET << US, 5070, 1, 583600)
(STARFRUIT, MARKET << US, 5070, 1, 583600)","{""AMETHYSTS"": -10, ""STARFRUIT"": 6}",3903,5068,9998
583700,35333,108808,"(AMETHYSTS, MARKET << US, 9998, 1, 583700)
(STARFRUIT, MARKET << US, 5067, 1, 583700)
(STARFRUIT, MARKET << US, 5067, 1, 583700)
(STARFRUIT, MARKET << US, 5067, 1, 583700)
(STARFRUIT, MARKET << US, 5067, 1, 583700)
(STARFRUIT, MARKET << US, 5067, 1, 583700)","{""AMETHYSTS"": -11, ""STARFRUIT"": 1}",3922,5070,9996
583900,-10136,98672,"(STARFRUIT, US << MARKET, 5068, 1, 583900)
(STARFRUIT, US << MARKET, 5068, 1, 583900)","{""AMETHYSTS"": -11, ""STARFRUIT"": 3}",3882,5070,10000
584500,20004,118676,"(AMETHYSTS, MARKET << US, 10002, 1, 584500)
(AMETHYSTS, MARKET << US, 10002, 1, 584500)","{""AMETHYSTS"": -13, ""STARFRUIT"": 3}",3847,5070,10003
585100,5068,123744,"(STARFRUIT, MARKET << US, 5068, 1, 585100)","{""AMETHYSTS"": -13, ""STARFRUIT"": 2}",3886,5071,10000
585900,20288,144032,"(STARFRUIT, MARKET << US, 5072, 1, 585900)
(STARFRUIT, MARKET << US, 5072, 1, 585900)
(STARFRUIT, MARKET << US, 5072, 1, 585900)
(STARFRUIT, MARKET << US, 5072, 1, 585900)","{""AMETHYSTS"": -13, ""STARFRUIT"": -2}",3918,5070,9998
586500,40016,184048,"(AMETHYSTS, MARKET << US, 10004, 1, 586500)
(AMETHYSTS, MARKET << US, 10004, 1, 586500)
(AMETHYSTS, MARKET << US, 10004, 1, 586500)
(AMETHYSTS, MARKET << US, 10004, 1, 586500)","{""AMETHYSTS"": -17, ""STARFRUIT"": -2}",3904,5072,10000
586600,25061,209109,"(AMETHYSTS, MARKET << US, 9996, 1, 586600)
(AMETHYSTS, MARKET << US, 9996, 1, 586600)
(STARFRUIT, MARKET << US, 5069, 1, 586600)","{""AMETHYSTS"": -19, ""STARFRUIT"": -3}",3893,5072,10000
587500,10000,219109,"(AMETHYSTS, MARKET << US, 10000, 1, 587500)
(STARFRUIT, US << MARKET, 5071, 1, 587500)
(STARFRUIT, US << MARKET, 5071, 1, 587500)
(STARFRUIT, MARKET << US, 5071, 1, 587500)
(STARFRUIT, MARKET << US, 5071, 1, 587500)","{""AMETHYSTS"": -20, ""STARFRUIT"": -3}",3942,5069,9998
587600,5074,224183,"(STARFRUIT, MARKET << US, 5074, 1, 587600)","{""AMETHYSTS"": -20, ""STARFRUIT"": -4}",3879,5071,10001
587700,-10148,214035,"(STARFRUIT, US << MARKET, 5074, 1, 587700)
(STARFRUIT, US << MARKET, 5074, 1, 587700)","{""AMETHYSTS"": -20, ""STARFRUIT"": -2}",3887,5074,10000
588200,-10146,203889,"(STARFRUIT, US << MARKET, 5073, 1, 588200)
(STARFRUIT, US << MARKET, 5073, 1, 588200)","{""AMETHYSTS"": -20, ""STARFRUIT"": 0}",3829,5070,10003
588300,15210,219099,"(STARFRUIT, MARKET << US, 5070, 1, 588300)
(STARFRUIT, MARKET << US, 5070, 1, 588300)
(STARFRUIT, MARKET << US, 5070, 1, 588300)","{""AMETHYSTS"": -20, ""STARFRUIT"": -3}",3975,5068,9996
588700,-14924,204175,"(AMETHYSTS, US << MARKET, 9996, 1, 588700)
(AMETHYSTS, US << MARKET, 9996, 1, 588700)
(STARFRUIT, MARKET << US, 5068, 1, 588700)","{""AMETHYSTS"": -18, ""STARFRUIT"": -4}",3891,5071,10000
588800,10142,214317,"(STARFRUIT, MARKET << US, 5071, 1, 588800)
(STARFRUIT, MARKET << US, 5071, 1, 588800)","{""AMETHYSTS"": -18, ""STARFRUIT"": -6}",3921,5069,9999
589000,-10136,204181,"(STARFRUIT, US << MARKET, 5068, 1, 589000)
(STARFRUIT, US << MARKET, 5068, 1, 589000)","{""AMETHYSTS"": -18, ""STARFRUIT"": -4}",3893,5072,10000
589500,-14928,189253,"(AMETHYSTS, US << MARKET, 9998, 1, 589500)
(AMETHYSTS, US << MARKET, 9998, 1, 589500)
(STARFRUIT, MARKET << US, 5068, 1, 589500)","{""AMETHYSTS"": -16, ""STARFRUIT"": -5}",3882,5071,10001
589800,-20154,169099,"(AMETHYSTS, US << MARKET, 10004, 1, 589800)
(STARFRUIT, US << MARKET, 5075, 1, 589800)
(STARFRUIT, US << MARKET, 5075, 1, 589800)","{""AMETHYSTS"": -15, ""STARFRUIT"": -3}",3886,5071,10000
589900,-140,168959,"(AMETHYSTS, MARKET << US, 9996, 1, 589900)
(STARFRUIT, US << MARKET, 5068, 1, 589900)
(STARFRUIT, US << MARKET, 5068, 1, 589900)","{""AMETHYSTS"": -16, ""STARFRUIT"": -1}",3888,5071,10000
590000,9998,178957,"(AMETHYSTS, MARKET << US, 9998, 1, 590000)","{""AMETHYSTS"": -17, ""STARFRUIT"": -1}",3871,5069,10001
590100,-39984,138973,"(AMETHYSTS, US << MARKET, 9996, 1, 590100)
(AMETHYSTS, US << MARKET, 9996, 1, 590100)
(AMETHYSTS, US << MARKET, 9996, 1, 590100)
(AMETHYSTS, US << MARKET, 9996, 1, 590100)","{""AMETHYSTS"": -13, ""STARFRUIT"": -1}",3942,5070,9997
590200,-20152,118821,"(AMETHYSTS, US << MARKET, 10004, 1, 590200)
(STARFRUIT, US << MARKET, 5074, 1, 590200)
(STARFRUIT, US << MARKET, 5074, 1, 590200)","{""AMETHYSTS"": -12, ""STARFRUIT"": 1}",3891,5070,10000
590300,-30130,88691,"(AMETHYSTS, US << MARKET, 9998, 1, 590300)
(AMETHYSTS, US << MARKET, 9998, 1, 590300)
(STARFRUIT, US << MARKET, 5067, 1, 590300)
(STARFRUIT, US << MARKET, 5067, 1, 590300)","{""AMETHYSTS"": -10, ""STARFRUIT"": 3}",3871,5070,10003
590400,-19996,68695,"(AMETHYSTS, US << MARKET, 9998, 1, 590400)
(AMETHYSTS, US << MARKET, 9998, 1, 590400)","{""AMETHYSTS"": -8, ""STARFRUIT"": 3}",3897,5070,10001
590600,40016,108711,"(AMETHYSTS, MARKET << US, 10004, 1, 590600)
(AMETHYSTS, MARKET << US, 10004, 1, 590600)
(AMETHYSTS, MARKET << US, 10004, 1, 590600)
(AMETHYSTS, MARKET << US, 10004, 1, 590600)","{""AMETHYSTS"": -12, ""STARFRUIT"": 3}",3921,5070,10000
591100,-20010,88701,"(AMETHYSTS, US << MARKET, 10005, 1, 591100)
(AMETHYSTS, US << MARKET, 10005, 1, 591100)","{""AMETHYSTS"": -10, ""STARFRUIT"": 3}",3898,5069,10001
591300,-25335,63366,"(STARFRUIT, US << MARKET, 5067, 1, 591300)
(STARFRUIT, US << MARKET, 5067, 1, 591300)
(STARFRUIT, US << MARKET, 5067, 1, 591300)
(STARFRUIT, US << MARKET, 5067, 1, 591300)
(STARFRUIT, US << MARKET, 5067, 1, 591300)","{""AMETHYSTS"": -10, ""STARFRUIT"": 8}",3912,5067,9999
591400,-50118,13248,"(AMETHYSTS, US << MARKET, 9996, 1, 591400)
(AMETHYSTS, US << MARKET, 9996, 1, 591400)
(AMETHYSTS, US << MARKET, 9996, 1, 591400)
(AMETHYSTS, US << MARKET, 9996, 1, 591400)
(STARFRUIT, US << MARKET, 5067, 1, 591400)
(STARFRUIT, US << MARKET, 5067, 1, 591400)","{""AMETHYSTS"": -6, ""STARFRUIT"": 10}",3966,5070,9997
591500,-25064,-11816,"(AMETHYSTS, US << MARKET, 9998, 1, 591500)
(AMETHYSTS, US << MARKET, 9998, 1, 591500)
(STARFRUIT, US << MARKET, 5068, 1, 591500)","{""AMETHYSTS"": -4, ""STARFRUIT"": 11}",3966,5070,9997
591600,5073,-6743,"(STARFRUIT, MARKET << US, 5073, 1, 591600)","{""AMETHYSTS"": -4, ""STARFRUIT"": 10}",4005,5074,9998
591800,-10002,-16745,"(AMETHYSTS, US << MARKET, 10002, 1, 591800)","{""AMETHYSTS"": -3, ""STARFRUIT"": 10}",3968,5071,9999
592000,-5069,-21814,"(STARFRUIT, US << MARKET, 5069, 1, 592000)","{""AMETHYSTS"": -3, ""STARFRUIT"": 11}",3978,5072,10000
592200,-15232,-37046,"(STARFRUIT, US << MARKET, 5075, 1, 592200)
(STARFRUIT, US << MARKET, 5075, 1, 592200)
(STARFRUIT, US << MARKET, 5075, 1, 592200)
(STARFRUIT, US << MARKET, 5075, 1, 592200)
(STARFRUIT, MARKET << US, 5068, 1, 592200)","{""AMETHYSTS"": -3, ""STARFRUIT"": 14}",3948,5071,10000
592800,-10002,-47048,"(AMETHYSTS, US << MARKET, 10002, 1, 592800)","{""AMETHYSTS"": -2, ""STARFRUIT"": 14}",3952,5071,9997
592900,60012,12964,"(AMETHYSTS, MARKET << US, 10002, 1, 592900)
(AMETHYSTS, MARKET << US, 10002, 1, 592900)
(AMETHYSTS, MARKET << US, 10002, 1, 592900)
(AMETHYSTS, MARKET << US, 10002, 1, 592900)
(AMETHYSTS, MARKET << US, 10002, 1, 592900)
(AMETHYSTS, MARKET << US, 10002, 1, 592900)","{""AMETHYSTS"": -8, ""STARFRUIT"": 14}",3934,5071,10003
593200,5068,18032,"(STARFRUIT, MARKET << US, 5068, 1, 593200)","{""AMETHYSTS"": -8, ""STARFRUIT"": 13}",3955,5071,10000
593600,9998,28030,"(AMETHYSTS, MARKET << US, 9998, 1, 593600)","{""AMETHYSTS"": -9, ""STARFRUIT"": 13}",3918,5069,10001
594200,-5067,22963,"(STARFRUIT, US << MARKET, 5067, 1, 594200)","{""AMETHYSTS"": -9, ""STARFRUIT"": 14}",3952,5070,9999
594300,9998,32961,"(AMETHYSTS, MARKET << US, 9998, 1, 594300)","{""AMETHYSTS"": -10, ""STARFRUIT"": 14}",3981,5070,9996
594400,5067,38028,"(STARFRUIT, MARKET << US, 5067, 1, 594400)","{""AMETHYSTS"": -10, ""STARFRUIT"": 13}",3938,5070,10000
594500,20004,58032,"(AMETHYSTS, MARKET << US, 10002, 1, 594500)
(AMETHYSTS, MARKET << US, 10002, 1, 594500)","{""AMETHYSTS"": -12, ""STARFRUIT"": 13}",3906,5070,10003
595200,-15071,42961,"(AMETHYSTS, US << MARKET, 10002, 1, 595200)
(STARFRUIT, US << MARKET, 5069, 1, 595200)","{""AMETHYSTS"": -11, ""STARFRUIT"": 14}",3936,5072,10003
595300,-50025,-7064,"(AMETHYSTS, US << MARKET, 10005, 1, 595300)
(AMETHYSTS, US << MARKET, 10005, 1, 595300)
(AMETHYSTS, US << MARKET, 10005, 1, 595300)
(AMETHYSTS, US << MARKET, 10005, 1, 595300)
(AMETHYSTS, US << MARKET, 10005, 1, 595300)","{""AMETHYSTS"": -6, ""STARFRUIT"": 14}",3972,5074,10000
596000,20008,12944,"(AMETHYSTS, MARKET << US, 10004, 1, 596000)
(AMETHYSTS, MARKET << US, 10004, 1, 596000)","{""AMETHYSTS"": -8, ""STARFRUIT"": 14}",3914,5071,10003
596300,-139972,-127028,"(AMETHYSTS, US << MARKET, 9998, 1, 596300)
(AMETHYSTS, US << MARKET, 9998, 1, 596300)
(AMETHYSTS, US << MARKET, 9998, 1, 596300)
(AMETHYSTS, US << MARKET, 9998, 1, 596300)
(AMETHYSTS, US << MARKET, 9998, 1, 596300)
(AMETHYSTS, US << MARKET, 9998, 1, 596300)
(AMETHYSTS, US << MARKET, 9998, 1, 596300)
(AMETHYSTS, US << MARKET, 9998, 1, 596300)
(AMETHYSTS, US << MARKET, 9998, 1, 596300)
(AMETHYSTS, US << MARKET, 9998, 1, 596300)
(AMETHYSTS, US << MARKET, 9998, 1, 596300)
(AMETHYSTS, US << MARKET, 9998, 1, 596300)
(AMETHYSTS, US << MARKET, 9998, 1, 596300)
(AMETHYSTS, US << MARKET, 9998, 1, 596300)","{""AMETHYSTS"": 6, ""STARFRUIT"": 14}",3976,5073,9997
596400,-10142,-137170,"(STARFRUIT, US << MARKET, 5071, 1, 596400)
(STARFRUIT, US << MARKET, 5071, 1, 596400)","{""AMETHYSTS"": 6, ""STARFRUIT"": 16}",3916,5069,9997
597300,29994,-107176,"(AMETHYSTS, MARKET << US, 9998, 1, 597300)
(AMETHYSTS, MARKET << US, 9998, 1, 597300)
(AMETHYSTS, MARKET << US, 9998, 1, 597300)","{""AMETHYSTS"": 3, ""STARFRUIT"": 16}",3932,5070,9996
597400,-159920,-267096,"(AMETHYSTS, US << MARKET, 9995, 1, 597400)
(AMETHYSTS, US << MARKET, 9995, 1, 597400)
(AMETHYSTS, US << MARKET, 9995, 1, 597400)
(AMETHYSTS, US << MARKET, 9995, 1, 597400)
(AMETHYSTS, US << MARKET, 9995, 1, 597400)
(AMETHYSTS, US << MARKET, 9995, 1, 597400)
(AMETHYSTS, US << MARKET, 9995, 1, 597400)
(AMETHYSTS, US << MARKET, 9995, 1, 597400)
(AMETHYSTS, US << MARKET, 9995, 1, 597400)
(AMETHYSTS, US << MARKET, 9995, 1, 597400)
(AMETHYSTS, US << MARKET, 9995, 1, 597400)
(AMETHYSTS, US << MARKET, 9995, 1, 597400)
(AMETHYSTS, US << MARKET, 9995, 1, 597400)
(AMETHYSTS, US << MARKET, 9995, 1, 597400)
(AMETHYSTS, US << MARKET, 9995, 1, 597400)
(AMETHYSTS, US << MARKET, 9995, 1, 597400)","{""AMETHYSTS"": 19, ""STARFRUIT"": 16}",4018,5072,9998
597500,5217,-261879,"(AMETHYSTS, US << MARKET, 10004, 1, 597500)
(STARFRUIT, MARKET << US, 5076, 1, 597500)
(STARFRUIT, MARKET << US, 5076, 1, 597500)
(STARFRUIT, MARKET << US, 5069, 1, 597500)","{""AMETHYSTS"": 20, ""STARFRUIT"": 13}",4070,5073,10000
598000,5074,-256805,"(STARFRUIT, MARKET << US, 5074, 1, 598000)","{""AMETHYSTS"": 20, ""STARFRUIT"": 12}",4055,5075,9998
598800,-5073,-261878,"(STARFRUIT, US << MARKET, 5073, 1, 598800)","{""AMETHYSTS"": 20, ""STARFRUIT"": 13}",4084,5074,10000
599000,14937,-246941,"(AMETHYSTS, MARKET << US, 10002, 1, 599000)
(AMETHYSTS, MARKET << US, 10002, 1, 599000)
(STARFRUIT, US << MARKET, 5067, 1, 599000)","{""AMETHYSTS"": 18, ""STARFRUIT"": 14}",4093,5070,10003
599200,140,-246801,"(AMETHYSTS, US << MARKET, 10002, 1, 599200)
(STARFRUIT, MARKET << US, 5071, 1, 599200)
(STARFRUIT, MARKET << US, 5071, 1, 599200)","{""AMETHYSTS"": 19, ""STARFRUIT"": 12}",3996,5068,9999
599300,40152,-206649,"(AMETHYSTS, US << MARKET, 10002, 1, 599300)
(AMETHYSTS, MARKET << US, 10002, 1, 599300)
(AMETHYSTS, MARKET << US, 10002, 1, 599300)
(AMETHYSTS, MARKET << US, 10002, 1, 599300)
(AMETHYSTS, MARKET << US, 10002, 1, 599300)
(STARFRUIT, MARKET << US, 5073, 1, 599300)
(STARFRUIT, MARKET << US, 5073, 1, 599300)","{""AMETHYSTS"": 16, ""STARFRUIT"": 10}",4099,5070,10003
599500,-25067,-231716,"(AMETHYSTS, US << MARKET, 9998, 1, 599500)
(AMETHYSTS, US << MARKET, 9998, 1, 599500)
(STARFRUIT, US << MARKET, 5071, 1, 599500)","{""AMETHYSTS"": 18, ""STARFRUIT"": 11}",4076,5072,10000
599900,-10002,-241718,"(AMETHYSTS, US << MARKET, 10002, 1, 599900)","{""AMETHYSTS"": 19, ""STARFRUIT"": 11}",4109,5070,10003
600100,5073,-236645,"(STARFRUIT, MARKET << US, 5073, 1, 600100)","{""AMETHYSTS"": 19, ""STARFRUIT"": 10}",4085,5073,10000
600400,14934,-221711,"(AMETHYSTS, MARKET << US, 10004, 1, 600400)
(AMETHYSTS, MARKET << US, 10004, 1, 600400)
(STARFRUIT, US << MARKET, 5074, 1, 600400)","{""AMETHYSTS"": 17, ""STARFRUIT"": 11}",4121,5071,10003
600600,5073,-216638,"(STARFRUIT, MARKET << US, 5073, 1, 600600)","{""AMETHYSTS"": 17, ""STARFRUIT"": 10}",4109,5073,10001
600700,5073,-211565,"(STARFRUIT, MARKET << US, 5073, 1, 600700)","{""AMETHYSTS"": 17, ""STARFRUIT"": 9}",4092,5073,10000
600800,0,-211565,"(STARFRUIT, US << MARKET, 5068, 1, 600800)
(STARFRUIT, MARKET << US, 5068, 1, 600800)","{""AMETHYSTS"": 17, ""STARFRUIT"": 9}",4038,5067,10000
601300,30160,-181405,"(AMETHYSTS, MARKET << US, 10005, 1, 601300)
(AMETHYSTS, MARKET << US, 10005, 1, 601300)
(STARFRUIT, MARKET << US, 5075, 1, 601300)
(STARFRUIT, MARKET << US, 5075, 1, 601300)","{""AMETHYSTS"": 15, ""STARFRUIT"": 7}",4137,5071,10003
601500,-10002,-191407,"(AMETHYSTS, US << MARKET, 10002, 1, 601500)","{""AMETHYSTS"": 16, ""STARFRUIT"": 7}",4037,5068,9998
602100,10282,-181125,"(AMETHYSTS, US << MARKET, 10000, 1, 602100)
(STARFRUIT, MARKET << US, 5072, 1, 602100)
(STARFRUIT, MARKET << US, 5070, 1, 602100)
(STARFRUIT, MARKET << US, 5070, 1, 602100)
(STARFRUIT, MARKET << US, 5070, 1, 602100)","{""AMETHYSTS"": 17, ""STARFRUIT"": 3}",4131,5074,10002
602800,-30152,-211277,"(AMETHYSTS, US << MARKET, 10002, 1, 602800)
(AMETHYSTS, US << MARKET, 10002, 1, 602800)
(STARFRUIT, US << MARKET, 5074, 1, 602800)
(STARFRUIT, US << MARKET, 5074, 1, 602800)","{""AMETHYSTS"": 19, ""STARFRUIT"": 5}",4155,5075,10003
603700,5071,-206206,"(STARFRUIT, US << MARKET, 5071, 1, 603700)
(STARFRUIT, US << MARKET, 5071, 1, 603700)
(STARFRUIT, US << MARKET, 5071, 1, 603700)
(STARFRUIT, US << MARKET, 5071, 1, 603700)
(STARFRUIT, MARKET << US, 5071, 1, 603700)
(STARFRUIT, MARKET << US, 5071, 1, 603700)
(STARFRUIT, MARKET << US, 5071, 1, 603700)
(STARFRUIT, MARKET << US, 5071, 1, 603700)
(STARFRUIT, MARKET << US, 5071, 1, 603700)","{""AMETHYSTS"": 19, ""STARFRUIT"": 4}",4120,5072,10002
603900,0,-206206,"(STARFRUIT, US << MARKET, 5068, 1, 603900)
(STARFRUIT, US << MARKET, 5068, 1, 603900)
(STARFRUIT, US << MARKET, 5068, 1, 603900)
(STARFRUIT, US << MARKET, 5068, 1, 603900)
(STARFRUIT, MARKET << US, 5068, 1, 603900)
(STARFRUIT, MARKET << US, 5068, 1, 603900)
(STARFRUIT, MARKET << US, 5068, 1, 603900)
(STARFRUIT, MARKET << US, 5068, 1, 603900)","{""AMETHYSTS"": 19, ""STARFRUIT"": 4}",4078,5071,10000
604000,-10136,-216342,"(STARFRUIT, US << MARKET, 5068, 1, 604000)
(STARFRUIT, US << MARKET, 5068, 1, 604000)","{""AMETHYSTS"": 19, ""STARFRUIT"": 6}",4078,5070,10000
604200,-10004,-226346,"(AMETHYSTS, US << MARKET, 10004, 1, 604200)","{""AMETHYSTS"": 20, ""STARFRUIT"": 6}",4100,5071,10001
605000,15067,-211279,"(AMETHYSTS, MARKET << US, 9998, 1, 605000)
(STARFRUIT, MARKET << US, 5069, 1, 605000)","{""AMETHYSTS"": 19, ""STARFRUIT"": 5}",4004,5068,9997
605300,-10148,-221427,"(STARFRUIT, US << MARKET, 5074, 1, 605300)
(STARFRUIT, US << MARKET, 5074, 1, 605300)","{""AMETHYSTS"": 19, ""STARFRUIT"": 7}",4053,5074,9998
605900,-5071,-226498,"(STARFRUIT, US << MARKET, 5071, 1, 605900)","{""AMETHYSTS"": 19, ""STARFRUIT"": 8}",4143,5073,10003
606700,80016,-146482,"(AMETHYSTS, MARKET << US, 10002, 1, 606700)
(AMETHYSTS, MARKET << US, 10002, 1, 606700)
(AMETHYSTS, MARKET << US, 10002, 1, 606700)
(AMETHYSTS, MARKET << US, 10002, 1, 606700)
(AMETHYSTS, MARKET << US, 10002, 1, 606700)
(AMETHYSTS, MARKET << US, 10002, 1, 606700)
(AMETHYSTS, MARKET << US, 10002, 1, 606700)
(AMETHYSTS, MARKET << US, 10002, 1, 606700)","{""AMETHYSTS"": 11, ""STARFRUIT"": 8}",4080,5073,9998
606800,-5070,-151552,"(STARFRUIT, US << MARKET, 5070, 1, 606800)","{""AMETHYSTS"": 11, ""STARFRUIT"": 9}",4094,5073,9999
607300,-20296,-171848,"(STARFRUIT, US << MARKET, 5074, 1, 607300)
(STARFRUIT, US << MARKET, 5074, 1, 607300)
(STARFRUIT, US << MARKET, 5074, 1, 607300)
(STARFRUIT, US << MARKET, 5074, 1, 607300)","{""AMETHYSTS"": 11, ""STARFRUIT"": 13}",4121,5072,10003
607800,-5071,-176919,"(STARFRUIT, US << MARKET, 5071, 1, 607800)","{""AMETHYSTS"": 11, ""STARFRUIT"": 14}",4114,5073,10001
607900,19996,-156923,"(AMETHYSTS, MARKET << US, 9998, 1, 607900)
(AMETHYSTS, MARKET << US, 9998, 1, 607900)","{""AMETHYSTS"": 9, ""STARFRUIT"": 14}",4063,5073,9996
608700,5071,-151852,"(STARFRUIT, MARKET << US, 5071, 1, 608700)","{""AMETHYSTS"": 9, ""STARFRUIT"": 13}",4040,5070,9998
608800,-10003,-161855,"(AMETHYSTS, US << MARKET, 10005, 1, 608800)
(STARFRUIT, US << MARKET, 5076, 1, 608800)
(STARFRUIT, MARKET << US, 5078, 1, 608800)","{""AMETHYSTS"": 10, ""STARFRUIT"": 13}",4146,5077,10000
609100,-20134,-181989,"(AMETHYSTS, US << MARKET, 9996, 1, 609100)
(AMETHYSTS, US << MARKET, 9996, 1, 609100)
(AMETHYSTS, MARKET << US, 9996, 1, 609100)
(STARFRUIT, US << MARKET, 5069, 1, 609100)
(STARFRUIT, US << MARKET, 5069, 1, 609100)","{""AMETHYSTS"": 11, ""STARFRUIT"": 15}",4076,5071,10000
609200,9998,-171991,"(AMETHYSTS, MARKET << US, 9998, 1, 609200)","{""AMETHYSTS"": 10, ""STARFRUIT"": 15}",4074,5073,9997
609300,-9850,-181841,"(AMETHYSTS, US << MARKET, 10002, 1, 609300)
(AMETHYSTS, US << MARKET, 10002, 1, 609300)
(STARFRUIT, MARKET << US, 5077, 1, 609300)
(STARFRUIT, MARKET << US, 5077, 1, 609300)","{""AMETHYSTS"": 12, ""STARFRUIT"": 13}",4096,5073,9999
609900,35532,-146309,"(STARFRUIT, MARKET << US, 5076, 1, 609900)
(STARFRUIT, MARKET << US, 5076, 1, 609900)
(STARFRUIT, MARKET << US, 5076, 1, 609900)
(STARFRUIT, MARKET << US, 5076, 1, 609900)
(STARFRUIT, MARKET << US, 5076, 1, 609900)
(STARFRUIT, MARKET << US, 5076, 1, 609900)
(STARFRUIT, MARKET << US, 5076, 1, 609900)","{""AMETHYSTS"": 12, ""STARFRUIT"": 6}",4129,5073,10000
610000,5070,-141239,"(STARFRUIT, MARKET << US, 5070, 1, 610000)","{""AMETHYSTS"": 12, ""STARFRUIT"": 5}",4121,5072,10000
610600,-20304,-161543,"(STARFRUIT, US << MARKET, 5076, 1, 610600)
(STARFRUIT, US << MARKET, 5076, 1, 610600)
(STARFRUIT, US << MARKET, 5076, 1, 610600)
(STARFRUIT, US << MARKET, 5076, 1, 610600)","{""AMETHYSTS"": 12, ""STARFRUIT"": 9}",4105,5072,10000
610700,-5069,-166612,"(STARFRUIT, US << MARKET, 5069, 1, 610700)","{""AMETHYSTS"": 12, ""STARFRUIT"": 10}",4120,5072,10001
611400,29994,-136618,"(AMETHYSTS, MARKET << US, 9998, 1, 611400)
(AMETHYSTS, MARKET << US, 9998, 1, 611400)
(AMETHYSTS, MARKET << US, 9998, 1, 611400)","{""AMETHYSTS"": 9, ""STARFRUIT"": 10}",4085,5073,9997
613300,9998,-126620,"(AMETHYSTS, MARKET << US, 9998, 1, 613300)","{""AMETHYSTS"": 8, ""STARFRUIT"": 10}",4078,5073,9996
613800,-5070,-131690,"(STARFRUIT, US << MARKET, 5070, 1, 613800)","{""AMETHYSTS"": 8, ""STARFRUIT"": 11}",4102,5072,10000
613900,5075,-126615,"(STARFRUIT, MARKET << US, 5075, 1, 613900)","{""AMETHYSTS"": 8, ""STARFRUIT"": 10}",4135,5075,10000
614000,45356,-81259,"(AMETHYSTS, MARKET << US, 9998, 1, 614000)
(AMETHYSTS, MARKET << US, 9998, 1, 614000)
(STARFRUIT, MARKET << US, 5072, 1, 614000)
(STARFRUIT, MARKET << US, 5072, 1, 614000)
(STARFRUIT, MARKET << US, 5072, 1, 614000)
(STARFRUIT, MARKET << US, 5072, 1, 614000)
(STARFRUIT, MARKET << US, 5072, 1, 614000)","{""AMETHYSTS"": 6, ""STARFRUIT"": 5}",4078,5071,9997
614200,-10002,-91261,"(AMETHYSTS, US << MARKET, 10002, 1, 614200)","{""AMETHYSTS"": 7, ""STARFRUIT"": 5}",4107,5075,9999
614300,-10138,-101399,"(STARFRUIT, US << MARKET, 5069, 1, 614300)
(STARFRUIT, US << MARKET, 5069, 1, 614300)","{""AMETHYSTS"": 7, ""STARFRUIT"": 7}",4105,5073,9999
614600,5069,-96330,"(STARFRUIT, MARKET << US, 5069, 1, 614600)","{""AMETHYSTS"": 7, ""STARFRUIT"": 6}",4123,5072,10003
614800,-5073,-101403,"(STARFRUIT, US << MARKET, 5073, 1, 614800)
(STARFRUIT, US << MARKET, 5073, 1, 614800)
(STARFRUIT, MARKET << US, 5073, 1, 614800)","{""AMETHYSTS"": 7, ""STARFRUIT"": 7}",4122,5074,10001
615200,-20288,-121691,"(STARFRUIT, US << MARKET, 5072, 1, 615200)
(STARFRUIT, US << MARKET, 5072, 1, 615200)
(STARFRUIT, US << MARKET, 5072, 1, 615200)
(STARFRUIT, US << MARKET, 5072, 1, 615200)","{""AMETHYSTS"": 7, ""STARFRUIT"": 11}",4119,5073,10001
615800,15212,-106479,"(STARFRUIT, US << MARKET, 5072, 1, 615800)
(STARFRUIT, MARKET << US, 5071, 1, 615800)
(STARFRUIT, MARKET << US, 5071, 1, 615800)
(STARFRUIT, MARKET << US, 5071, 1, 615800)
(STARFRUIT, MARKET << US, 5071, 1, 615800)","{""AMETHYSTS"": 7, ""STARFRUIT"": 8}",4097,5072,10000
616100,-5066,-111545,"(STARFRUIT, US << MARKET, 5066, 1, 616100)","{""AMETHYSTS"": 7, ""STARFRUIT"": 9}",4048,5069,9996
616300,5071,-106474,"(STARFRUIT, MARKET << US, 5071, 1, 616300)","{""AMETHYSTS"": 7, ""STARFRUIT"": 8}",4070,5068,10000
616500,-5064,-111538,"(STARFRUIT, US << MARKET, 5064, 1, 616500)","{""AMETHYSTS"": 7, ""STARFRUIT"": 9}",4065,5067,10000
616800,-19996,-131534,"(AMETHYSTS, US << MARKET, 9998, 1, 616800)
(AMETHYSTS, US << MARKET, 9998, 1, 616800)","{""AMETHYSTS"": 9, ""STARFRUIT"": 9}",4024,5066,9996
617100,-19996,-151530,"(AMETHYSTS, US << MARKET, 9998, 1, 617100)
(AMETHYSTS, US << MARKET, 9998, 1, 617100)","{""AMETHYSTS"": 11, ""STARFRUIT"": 9}",4040,5067,9997
617500,5064,-146466,"(STARFRUIT, MARKET << US, 5064, 1, 617500)","{""AMETHYSTS"": 11, ""STARFRUIT"": 8}",4073,5066,10001
618000,5061,-141405,"(STARFRUIT, MARKET << US, 5061, 1, 618000)","{""AMETHYSTS"": 11, ""STARFRUIT"": 7}",4021,5064,9998
618300,-10132,-151537,"(STARFRUIT, US << MARKET, 5066, 1, 618300)
(STARFRUIT, US << MARKET, 5066, 1, 618300)","{""AMETHYSTS"": 11, ""STARFRUIT"": 9}",4055,5067,9999
618700,-5064,-156601,"(STARFRUIT, US << MARKET, 5064, 1, 618700)","{""AMETHYSTS"": 11, ""STARFRUIT"": 10}",4101,5068,10002
619100,-5064,-161665,"(STARFRUIT, US << MARKET, 5064, 1, 619100)","{""AMETHYSTS"": 11, ""STARFRUIT"": 11}",4072,5067,10000
619200,20004,-141661,"(AMETHYSTS, MARKET << US, 10002, 1, 619200)
(AMETHYSTS, MARKET << US, 10002, 1, 619200)","{""AMETHYSTS"": 9, ""STARFRUIT"": 11}",4067,5067,9999
619400,-5065,-146726,"(STARFRUIT, US << MARKET, 5065, 1, 619400)","{""AMETHYSTS"": 9, ""STARFRUIT"": 12}",4090,5068,10000
619600,19996,-126730,"(AMETHYSTS, MARKET << US, 9998, 1, 619600)
(AMETHYSTS, MARKET << US, 9998, 1, 619600)","{""AMETHYSTS"": 7, ""STARFRUIT"": 12}",4077,5069,9997
620100,-5070,-131800,"(STARFRUIT, US << MARKET, 5070, 1, 620100)","{""AMETHYSTS"": 7, ""STARFRUIT"": 13}",4144,5071,10003
620300,-15068,-146868,"(AMETHYSTS, US << MARKET, 10002, 1, 620300)
(STARFRUIT, US << MARKET, 5066, 1, 620300)","{""AMETHYSTS"": 8, ""STARFRUIT"": 14}",4066,5065,10003
620400,-9864,-156732,"(AMETHYSTS, US << MARKET, 10004, 1, 620400)
(AMETHYSTS, US << MARKET, 10004, 1, 620400)
(STARFRUIT, MARKET << US, 5072, 1, 620400)
(STARFRUIT, MARKET << US, 5072, 1, 620400)","{""AMETHYSTS"": 10, ""STARFRUIT"": 12}",4084,5068,10000
620800,-5065,-161797,"(STARFRUIT, US << MARKET, 5065, 1, 620800)","{""AMETHYSTS"": 10, ""STARFRUIT"": 13}",4035,5064,10000
621600,-5064,-166861,"(STARFRUIT, US << MARKET, 5064, 1, 621600)","{""AMETHYSTS"": 10, ""STARFRUIT"": 14}",4067,5067,9999
621800,9998,-156863,"(AMETHYSTS, MARKET << US, 9998, 1, 621800)","{""AMETHYSTS"": 9, ""STARFRUIT"": 14}",4048,5067,9997
622100,-109978,-266841,"(AMETHYSTS, US << MARKET, 9998, 1, 622100)
(AMETHYSTS, US << MARKET, 9998, 1, 622100)
(AMETHYSTS, US << MARKET, 9998, 1, 622100)
(AMETHYSTS, US << MARKET, 9998, 1, 622100)
(AMETHYSTS, US << MARKET, 9998, 1, 622100)
(AMETHYSTS, US << MARKET, 9998, 1, 622100)
(AMETHYSTS, US << MARKET, 9998, 1, 622100)
(AMETHYSTS, US << MARKET, 9998, 1, 622100)
(AMETHYSTS, US << MARKET, 9998, 1, 622100)
(AMETHYSTS, US << MARKET, 9998, 1, 622100)
(AMETHYSTS, US << MARKET, 9998, 1, 622100)","{""AMETHYSTS"": 20, ""STARFRUIT"": 14}",4031,5068,9996
622300,5065,-261776,"(STARFRUIT, MARKET << US, 5065, 1, 622300)","{""AMETHYSTS"": 20, ""STARFRUIT"": 13}",4108,5068,10000
622800,35455,-226321,"(STARFRUIT, MARKET << US, 5065, 1, 622800)
(STARFRUIT, MARKET << US, 5065, 1, 622800)
(STARFRUIT, MARKET << US, 5065, 1, 622800)
(STARFRUIT, MARKET << US, 5065, 1, 622800)
(STARFRUIT, MARKET << US, 5065, 1, 622800)
(STARFRUIT, MARKET << US, 5065, 1, 622800)
(STARFRUIT, MARKET << US, 5065, 1, 622800)","{""AMETHYSTS"": 20, ""STARFRUIT"": 6}",4101,5067,10001
623400,20004,-206317,"(AMETHYSTS, MARKET << US, 10002, 1, 623400)
(AMETHYSTS, MARKET << US, 10002, 1, 623400)","{""AMETHYSTS"": 18, ""STARFRUIT"": 6}",4139,5067,10003
623500,25360,-180957,"(STARFRUIT, MARKET << US, 5072, 1, 623500)
(STARFRUIT, MARKET << US, 5072, 1, 623500)
(STARFRUIT, MARKET << US, 5072, 1, 623500)
(STARFRUIT, MARKET << US, 5072, 1, 623500)
(STARFRUIT, MARKET << US, 5072, 1, 623500)","{""AMETHYSTS"": 18, ""STARFRUIT"": 1}",4129,5068,10001
623600,5065,-175892,"(STARFRUIT, MARKET << US, 5065, 1, 623600)","{""AMETHYSTS"": 18, ""STARFRUIT"": 0}",4108,5068,10000
623800,-10144,-186036,"(STARFRUIT, US << MARKET, 5072, 1, 623800)
(STARFRUIT, US << MARKET, 5072, 1, 623800)","{""AMETHYSTS"": 18, ""STARFRUIT"": 2}",4108,5072,10000
623900,-25355,-211391,"(STARFRUIT, US << MARKET, 5071, 1, 623900)
(STARFRUIT, US << MARKET, 5071, 1, 623900)
(STARFRUIT, US << MARKET, 5071, 1, 623900)
(STARFRUIT, US << MARKET, 5071, 1, 623900)
(STARFRUIT, US << MARKET, 5071, 1, 623900)","{""AMETHYSTS"": 18, ""STARFRUIT"": 7}",4106,5071,10000
624100,-10002,-221393,"(AMETHYSTS, US << MARKET, 10002, 1, 624100)","{""AMETHYSTS"": 19, ""STARFRUIT"": 7}",4123,5071,10001
624300,-20280,-241673,"(STARFRUIT, US << MARKET, 5070, 1, 624300)
(STARFRUIT, US << MARKET, 5070, 1, 624300)
(STARFRUIT, US << MARKET, 5070, 1, 624300)
(STARFRUIT, US << MARKET, 5070, 1, 624300)","{""AMETHYSTS"": 19, ""STARFRUIT"": 11}",4064,5067,10000
624400,14936,-226737,"(AMETHYSTS, MARKET << US, 10004, 1, 624400)
(AMETHYSTS, MARKET << US, 10004, 1, 624400)
(STARFRUIT, US << MARKET, 5072, 1, 624400)","{""AMETHYSTS"": 17, ""STARFRUIT"": 12}",4079,5068,10000
625000,-5066,-231803,"(STARFRUIT, US << MARKET, 5066, 1, 625000)","{""AMETHYSTS"": 17, ""STARFRUIT"": 13}",4094,5069,10000
625600,5072,-226731,"(STARFRUIT, MARKET << US, 5072, 1, 625600)","{""AMETHYSTS"": 17, ""STARFRUIT"": 12}",4150,5072,10001
625900,-20008,-246739,"(AMETHYSTS, US << MARKET, 10004, 1, 625900)
(AMETHYSTS, US << MARKET, 10004, 1, 625900)","{""AMETHYSTS"": 19, ""STARFRUIT"": 12}",4089,5069,10000
626200,-9998,-256737,"(AMETHYSTS, US << MARKET, 9998, 1, 626200)","{""AMETHYSTS"": 20, ""STARFRUIT"": 12}",4035,5071,9996
626400,-5068,-261805,"(STARFRUIT, US << MARKET, 5068, 1, 626400)","{""AMETHYSTS"": 20, ""STARFRUIT"": 13}",4066,5067,10000
626700,35378,-226427,"(AMETHYSTS, MARKET << US, 9998, 1, 626700)
(STARFRUIT, US << MARKET, 5076, 1, 626700)
(STARFRUIT, US << MARKET, 5076, 1, 626700)
(STARFRUIT, MARKET << US, 5076, 1, 626700)
(STARFRUIT, MARKET << US, 5076, 1, 626700)
(STARFRUIT, MARKET << US, 5076, 1, 626700)
(STARFRUIT, MARKET << US, 5076, 1, 626700)
(STARFRUIT, MARKET << US, 5076, 1, 626700)
(STARFRUIT, MARKET << US, 5076, 1, 626700)
(STARFRUIT, MARKET << US, 5076, 1, 626700)","{""AMETHYSTS"": 19, ""STARFRUIT"": 8}",4100,5073,9997
627200,-10002,-236429,"(AMETHYSTS, US << MARKET, 10002, 1, 627200)","{""AMETHYSTS"": 20, ""STARFRUIT"": 8}",4135,5073,9999
627300,14931,-221498,"(AMETHYSTS, MARKET << US, 10004, 1, 627300)
(AMETHYSTS, MARKET << US, 10004, 1, 627300)
(STARFRUIT, US << MARKET, 5077, 1, 627300)","{""AMETHYSTS"": 18, ""STARFRUIT"": 9}",4168,5074,10000
627500,5076,-216422,"(STARFRUIT, MARKET << US, 5076, 1, 627500)","{""AMETHYSTS"": 18, ""STARFRUIT"": 8}",4154,5072,10000
627600,-10002,-226424,"(AMETHYSTS, US << MARKET, 10002, 1, 627600)","{""AMETHYSTS"": 19, ""STARFRUIT"": 8}",4133,5072,9999
627700,14929,-211495,"(AMETHYSTS, MARKET << US, 10002, 1, 627700)
(AMETHYSTS, MARKET << US, 10002, 1, 627700)
(STARFRUIT, US << MARKET, 5075, 1, 627700)","{""AMETHYSTS"": 17, ""STARFRUIT"": 9}",4240,5076,10003
627800,5069,-206426,"(STARFRUIT, MARKET << US, 5069, 1, 627800)","{""AMETHYSTS"": 17, ""STARFRUIT"": 8}",4201,5072,10003
628200,-29994,-236420,"(AMETHYSTS, US << MARKET, 9998, 1, 628200)
(AMETHYSTS, US << MARKET, 9998, 1, 628200)
(AMETHYSTS, US << MARKET, 9998, 1, 628200)","{""AMETHYSTS"": 20, ""STARFRUIT"": 8}",4104,5073,9997
628400,40008,-196412,"(AMETHYSTS, MARKET << US, 10002, 1, 628400)
(AMETHYSTS, MARKET << US, 10002, 1, 628400)
(AMETHYSTS, MARKET << US, 10002, 1, 628400)
(AMETHYSTS, MARKET << US, 10002, 1, 628400)","{""AMETHYSTS"": 16, ""STARFRUIT"": 8}",4140,5071,9999
629000,-5070,-201482,"(STARFRUIT, US << MARKET, 5070, 1, 629000)","{""AMETHYSTS"": 16, ""STARFRUIT"": 9}",4182,5072,10001
629100,10290,-191192,"(AMETHYSTS, US << MARKET, 10002, 1, 629100)
(STARFRUIT, MARKET << US, 5073, 1, 629100)
(STARFRUIT, MARKET << US, 5073, 1, 629100)
(STARFRUIT, MARKET << US, 5073, 1, 629100)
(STARFRUIT, MARKET << US, 5073, 1, 629100)","{""AMETHYSTS"": 17, ""STARFRUIT"": 5}",4117,5072,9997
629300,64803,-126389,"(AMETHYSTS, MARKET << US, 10002, 1, 629300)
(AMETHYSTS, MARKET << US, 10002, 1, 629300)
(AMETHYSTS, MARKET << US, 10002, 1, 629300)
(AMETHYSTS, MARKET << US, 10002, 1, 629300)
(AMETHYSTS, MARKET << US, 10002, 1, 629300)
(AMETHYSTS, MARKET << US, 10002, 1, 629300)
(AMETHYSTS, MARKET << US, 10002, 1, 629300)
(AMETHYSTS, MARKET << US, 10002, 1, 629300)
(STARFRUIT, US << MARKET, 5071, 1, 629300)
(STARFRUIT, US << MARKET, 5071, 1, 629300)
(STARFRUIT, US << MARKET, 5071, 1, 629300)
(STARFRUIT, US << MARKET, 5071, 1, 629300)
(STARFRUIT, MARKET << US, 5071, 1, 629300)","{""AMETHYSTS"": 9, ""STARFRUIT"": 8}",4230,5074,10003
629400,-14918,-141307,"(AMETHYSTS, US << MARKET, 9995, 1, 629400)
(AMETHYSTS, US << MARKET, 9995, 1, 629400)
(STARFRUIT, MARKET << US, 5072, 1, 629400)","{""AMETHYSTS"": 11, ""STARFRUIT"": 7}",4218,5075,10000
629500,9998,-131309,"(AMETHYSTS, MARKET << US, 9998, 1, 629500)","{""AMETHYSTS"": 10, ""STARFRUIT"": 7}",4232,5073,10003
629600,44919,-86390,"(AMETHYSTS, MARKET << US, 9998, 1, 629600)
(AMETHYSTS, MARKET << US, 9998, 1, 629600)
(AMETHYSTS, MARKET << US, 9998, 1, 629600)
(AMETHYSTS, MARKET << US, 9998, 1, 629600)
(AMETHYSTS, MARKET << US, 9998, 1, 629600)
(STARFRUIT, US << MARKET, 5071, 1, 629600)","{""AMETHYSTS"": 5, ""STARFRUIT"": 8}",4182,5074,9996
629800,5070,-81320,"(STARFRUIT, MARKET << US, 5070, 1, 629800)","{""AMETHYSTS"": 5, ""STARFRUIT"": 7}",4181,5073,9998
629900,-5071,-86391,"(STARFRUIT, US << MARKET, 5071, 1, 629900)","{""AMETHYSTS"": 5, ""STARFRUIT"": 8}",4206,5074,10001
630100,30426,-55965,"(STARFRUIT, MARKET << US, 5071, 1, 630100)
(STARFRUIT, MARKET << US, 5071, 1, 630100)
(STARFRUIT, MARKET << US, 5071, 1, 630100)
(STARFRUIT, MARKET << US, 5071, 1, 630100)
(STARFRUIT, MARKET << US, 5071, 1, 630100)
(STARFRUIT, MARKET << US, 5071, 1, 630100)","{""AMETHYSTS"": 5, ""STARFRUIT"": 2}",4188,5074,10001
630300,20004,-35961,"(AMETHYSTS, MARKET << US, 10002, 1, 630300)
(AMETHYSTS, MARKET << US, 10002, 1, 630300)","{""AMETHYSTS"": 3, ""STARFRUIT"": 2}",4184,5074,9999
630400,9998,-25963,"(AMETHYSTS, MARKET << US, 9998, 1, 630400)","{""AMETHYSTS"": 2, ""STARFRUIT"": 2}",4181,5075,9997
630500,-20154,-46117,"(AMETHYSTS, US << MARKET, 10002, 1, 630500)
(STARFRUIT, US << MARKET, 5076, 1, 630500)
(STARFRUIT, US << MARKET, 5076, 1, 630500)","{""AMETHYSTS"": 3, ""STARFRUIT"": 4}",4172,5073,9999
630900,-20296,-66413,"(STARFRUIT, US << MARKET, 5074, 1, 630900)
(STARFRUIT, US << MARKET, 5074, 1, 630900)
(STARFRUIT, US << MARKET, 5074, 1, 630900)
(STARFRUIT, US << MARKET, 5074, 1, 630900)","{""AMETHYSTS"": 3, ""STARFRUIT"": 8}",4171,5073,10000
631300,-10148,-76561,"(STARFRUIT, US << MARKET, 5074, 1, 631300)
(STARFRUIT, US << MARKET, 5074, 1, 631300)","{""AMETHYSTS"": 3, ""STARFRUIT"": 10}",4166,5073,9999
631400,25087,-51474,"(AMETHYSTS, MARKET << US, 10004, 1, 631400)
(AMETHYSTS, MARKET << US, 10004, 1, 631400)
(STARFRUIT, MARKET << US, 5079, 1, 631400)","{""AMETHYSTS"": 1, ""STARFRUIT"": 9}",4202,5075,10001
631500,5072,-46402,"(STARFRUIT, MARKET << US, 5072, 1, 631500)","{""AMETHYSTS"": 1, ""STARFRUIT"": 8}",4198,5075,10000
631600,5076,-41326,"(STARFRUIT, MARKET << US, 5076, 1, 631600)","{""AMETHYSTS"": 1, ""STARFRUIT"": 7}",4214,5077,10001
631700,60117,18791,"(AMETHYSTS, MARKET << US, 9995, 1, 631700)
(AMETHYSTS, MARKET << US, 9995, 1, 631700)
(AMETHYSTS, MARKET << US, 9995, 1, 631700)
(AMETHYSTS, MARKET << US, 9995, 1, 631700)
(AMETHYSTS, MARKET << US, 9995, 1, 631700)
(STARFRUIT, MARKET << US, 5071, 1, 631700)
(STARFRUIT, MARKET << US, 5071, 1, 631700)","{""AMETHYSTS"": -4, ""STARFRUIT"": 5}",4156,5073,10000
632400,-10318,8473,"(AMETHYSTS, MARKET << US, 9998, 1, 632400)
(STARFRUIT, US << MARKET, 5079, 1, 632400)
(STARFRUIT, US << MARKET, 5079, 1, 632400)
(STARFRUIT, US << MARKET, 5079, 1, 632400)
(STARFRUIT, US << MARKET, 5079, 1, 632400)","{""AMETHYSTS"": -5, ""STARFRUIT"": 9}",4172,5076,9997
632700,-19996,-11523,"(AMETHYSTS, US << MARKET, 9998, 1, 632700)
(AMETHYSTS, US << MARKET, 9998, 1, 632700)","{""AMETHYSTS"": -3, ""STARFRUIT"": 9}",4149,5075,10001
632900,-30136,-41659,"(AMETHYSTS, US << MARKET, 9996, 1, 632900)
(AMETHYSTS, US << MARKET, 9996, 1, 632900)
(STARFRUIT, US << MARKET, 5072, 1, 632900)
(STARFRUIT, US << MARKET, 5072, 1, 632900)","{""AMETHYSTS"": -1, ""STARFRUIT"": 11}",4167,5075,9999
633100,10148,-31511,"(STARFRUIT, MARKET << US, 5074, 1, 633100)
(STARFRUIT, MARKET << US, 5074, 1, 633100)","{""AMETHYSTS"": -1, ""STARFRUIT"": 9}",4147,5073,9999
633400,5079,-26432,"(STARFRUIT, MARKET << US, 5079, 1, 633400)","{""AMETHYSTS"": -1, ""STARFRUIT"": 8}",4208,5080,10000
633500,-54896,-81328,"(AMETHYSTS, US << MARKET, 9995, 1, 633500)
(AMETHYSTS, US << MARKET, 9995, 1, 633500)
(AMETHYSTS, US << MARKET, 9995, 1, 633500)
(AMETHYSTS, US << MARKET, 9995, 1, 633500)
(AMETHYSTS, US << MARKET, 9995, 1, 633500)
(AMETHYSTS, US << MARKET, 9995, 1, 633500)
(STARFRUIT, MARKET << US, 5074, 1, 633500)","{""AMETHYSTS"": 5, ""STARFRUIT"": 7}",4211,5077,10000
633700,-5079,-86407,"(STARFRUIT, US << MARKET, 5079, 1, 633700)","{""AMETHYSTS"": 5, ""STARFRUIT"": 8}",4215,5079,9998
633800,5078,-81329,"(STARFRUIT, MARKET << US, 5078, 1, 633800)","{""AMETHYSTS"": 5, ""STARFRUIT"": 7}",4222,5078,10001
633900,-20312,-101641,"(STARFRUIT, US << MARKET, 5078, 1, 633900)
(STARFRUIT, US << MARKET, 5078, 1, 633900)
(STARFRUIT, US << MARKET, 5078, 1, 633900)
(STARFRUIT, US << MARKET, 5078, 1, 633900)","{""AMETHYSTS"": 5, ""STARFRUIT"": 11}",4228,5079,10000
634100,5073,-96568,"(STARFRUIT, MARKET << US, 5073, 1, 634100)","{""AMETHYSTS"": 5, ""STARFRUIT"": 10}",4152,5072,10000
634200,-20316,-116884,"(STARFRUIT, US << MARKET, 5079, 1, 634200)
(STARFRUIT, US << MARKET, 5079, 1, 634200)
(STARFRUIT, US << MARKET, 5079, 1, 634200)
(STARFRUIT, US << MARKET, 5079, 1, 634200)","{""AMETHYSTS"": 5, ""STARFRUIT"": 14}",4180,5076,10000
634400,25083,-91801,"(AMETHYSTS, MARKET << US, 10002, 1, 634400)
(AMETHYSTS, MARKET << US, 10002, 1, 634400)
(STARFRUIT, MARKET << US, 5079, 1, 634400)","{""AMETHYSTS"": 3, ""STARFRUIT"": 13}",4168,5075,9998
634900,-15228,-107029,"(STARFRUIT, US << MARKET, 5076, 1, 634900)
(STARFRUIT, US << MARKET, 5076, 1, 634900)
(STARFRUIT, US << MARKET, 5076, 1, 634900)","{""AMETHYSTS"": 3, ""STARFRUIT"": 16}",4152,5074,9999
635000,15274,-91755,"(AMETHYSTS, US << MARKET, 9995, 1, 635000)
(AMETHYSTS, US << MARKET, 9995, 1, 635000)
(AMETHYSTS, US << MARKET, 9995, 1, 635000)
(AMETHYSTS, US << MARKET, 9995, 1, 635000)
(AMETHYSTS, MARKET << US, 10005, 1, 635000)
(AMETHYSTS, MARKET << US, 10005, 1, 635000)
(AMETHYSTS, MARKET << US, 10005, 1, 635000)
(AMETHYSTS, MARKET << US, 10005, 1, 635000)
(STARFRUIT, MARKET << US, 5080, 1, 635000)
(STARFRUIT, MARKET << US, 5080, 1, 635000)
(STARFRUIT, MARKET << US, 5074, 1, 635000)","{""AMETHYSTS"": 3, ""STARFRUIT"": 13}",4246,5077,10000
635600,-89964,-181719,"(AMETHYSTS, US << MARKET, 9996, 1, 635600)
(AMETHYSTS, US << MARKET, 9996, 1, 635600)
(AMETHYSTS, US << MARKET, 9996, 1, 635600)
(AMETHYSTS, US << MARKET, 9996, 1, 635600)
(AMETHYSTS, US << MARKET, 9996, 1, 635600)
(AMETHYSTS, US << MARKET, 9996, 1, 635600)
(AMETHYSTS, US << MARKET, 9996, 1, 635600)
(AMETHYSTS, US << MARKET, 9996, 1, 635600)
(AMETHYSTS, US << MARKET, 9996, 1, 635600)
(AMETHYSTS, US << MARKET, 9996, 1, 635600)
(AMETHYSTS, MARKET << US, 9996, 1, 635600)","{""AMETHYSTS"": 12, ""STARFRUIT"": 13}",4295,5078,10000
635700,85096,-96623,"(AMETHYSTS, MARKET << US, 10002, 1, 635700)
(AMETHYSTS, MARKET << US, 10002, 1, 635700)
(AMETHYSTS, MARKET << US, 10002, 1, 635700)
(AMETHYSTS, MARKET << US, 10002, 1, 635700)
(AMETHYSTS, MARKET << US, 10002, 1, 635700)
(AMETHYSTS, MARKET << US, 10002, 1, 635700)
(AMETHYSTS, MARKET << US, 10002, 1, 635700)
(AMETHYSTS, MARKET << US, 10002, 1, 635700)
(STARFRUIT, MARKET << US, 5080, 1, 635700)","{""AMETHYSTS"": 4, ""STARFRUIT"": 12}",4349,5080,10003
636000,5079,-91544,"(STARFRUIT, US << MARKET, 5079, 1, 636000)
(STARFRUIT, US << MARKET, 5079, 1, 636000)
(STARFRUIT, US << MARKET, 5079, 1, 636000)
(STARFRUIT, US << MARKET, 5079, 1, 636000)
(STARFRUIT, MARKET << US, 5079, 1, 636000)
(STARFRUIT, MARKET << US, 5079, 1, 636000)
(STARFRUIT, MARKET << US, 5079, 1, 636000)
(STARFRUIT, MARKET << US, 5079, 1, 636000)
(STARFRUIT, MARKET << US, 5079, 1, 636000)","{""AMETHYSTS"": 4, ""STARFRUIT"": 11}",4292,5076,10000
636300,5080,-86464,"(STARFRUIT, MARKET << US, 5080, 1, 636300)","{""AMETHYSTS"": 4, ""STARFRUIT"": 10}",4328,5080,9998
636500,-5075,-91539,"(STARFRUIT, US << MARKET, 5075, 1, 636500)","{""AMETHYSTS"": 4, ""STARFRUIT"": 11}",4308,5077,10000
636700,14929,-76610,"(AMETHYSTS, MARKET << US, 10005, 1, 636700)
(AMETHYSTS, MARKET << US, 10005, 1, 636700)
(STARFRUIT, US << MARKET, 5081, 1, 636700)","{""AMETHYSTS"": 2, ""STARFRUIT"": 12}",4314,5077,10000
637200,10004,-66606,"(AMETHYSTS, US << MARKET, 10004, 1, 637200)
(AMETHYSTS, MARKET << US, 10004, 1, 637200)
(AMETHYSTS, MARKET << US, 10004, 1, 637200)","{""AMETHYSTS"": 1, ""STARFRUIT"": 12}",4318,5077,10000
637500,9998,-56608,"(AMETHYSTS, MARKET << US, 9998, 1, 637500)","{""AMETHYSTS"": 0, ""STARFRUIT"": 12}",4316,5077,9997
637600,-80040,-136648,"(AMETHYSTS, US << MARKET, 10005, 1, 637600)
(AMETHYSTS, US << MARKET, 10005, 1, 637600)
(AMETHYSTS, US << MARKET, 10005, 1, 637600)
(AMETHYSTS, US << MARKET, 10005, 1, 637600)
(AMETHYSTS, US << MARKET, 10005, 1, 637600)
(AMETHYSTS, US << MARKET, 10005, 1, 637600)
(AMETHYSTS, US << MARKET, 10005, 1, 637600)
(AMETHYSTS, US << MARKET, 10005, 1, 637600)","{""AMETHYSTS"": 8, ""STARFRUIT"": 12}",4272,5076,10001
638400,20280,-116368,"(STARFRUIT, MARKET << US, 5070, 1, 638400)
(STARFRUIT, MARKET << US, 5070, 1, 638400)
(STARFRUIT, MARKET << US, 5070, 1, 638400)
(STARFRUIT, MARKET << US, 5070, 1, 638400)","{""AMETHYSTS"": 8, ""STARFRUIT"": 8}",4216,5073,10000
638600,-14934,-131302,"(AMETHYSTS, US << MARKET, 10002, 1, 638600)
(AMETHYSTS, US << MARKET, 10002, 1, 638600)
(AMETHYSTS, US << MARKET, 10002, 1, 638600)
(AMETHYSTS, US << MARKET, 10002, 1, 638600)
(AMETHYSTS, MARKET << US, 10002, 1, 638600)
(AMETHYSTS, MARKET << US, 10002, 1, 638600)
(STARFRUIT, MARKET << US, 5070, 1, 638600)","{""AMETHYSTS"": 10, ""STARFRUIT"": 7}",4232,5072,10003
638700,-29838,-161140,"(AMETHYSTS, US << MARKET, 9998, 1, 638700)
(AMETHYSTS, US << MARKET, 9998, 1, 638700)
(AMETHYSTS, US << MARKET, 9998, 1, 638700)
(AMETHYSTS, US << MARKET, 9998, 1, 638700)
(STARFRUIT, MARKET << US, 5077, 1, 638700)
(STARFRUIT, MARKET << US, 5077, 1, 638700)","{""AMETHYSTS"": 14, ""STARFRUIT"": 5}",4183,5073,9997
638800,-10002,-171142,"(AMETHYSTS, US << MARKET, 10002, 1, 638800)","{""AMETHYSTS"": 15, ""STARFRUIT"": 5}",4268,5073,10003
639100,10148,-160994,"(STARFRUIT, US << MARKET, 5074, 1, 639100)
(STARFRUIT, US << MARKET, 5074, 1, 639100)
(STARFRUIT, MARKET << US, 5074, 1, 639100)
(STARFRUIT, MARKET << US, 5074, 1, 639100)
(STARFRUIT, MARKET << US, 5074, 1, 639100)
(STARFRUIT, MARKET << US, 5074, 1, 639100)","{""AMETHYSTS"": 15, ""STARFRUIT"": 3}",4231,5075,10000
639600,-20004,-180998,"(AMETHYSTS, US << MARKET, 10002, 1, 639600)
(AMETHYSTS, US << MARKET, 10002, 1, 639600)","{""AMETHYSTS"": 17, ""STARFRUIT"": 3}",4179,5076,9997
639800,30130,-150868,"(AMETHYSTS, MARKET << US, 9995, 1, 639800)
(AMETHYSTS, MARKET << US, 9995, 1, 639800)
(STARFRUIT, MARKET << US, 5070, 1, 639800)
(STARFRUIT, MARKET << US, 5070, 1, 639800)","{""AMETHYSTS"": 15, ""STARFRUIT"": 1}",4205,5073,10000
640600,-60128,-210996,"(AMETHYSTS, US << MARKET, 9996, 1, 640600)
(AMETHYSTS, US << MARKET, 9996, 1, 640600)
(AMETHYSTS, US << MARKET, 9998, 1, 640600)
(AMETHYSTS, US << MARKET, 9998, 1, 640600)
(AMETHYSTS, US << MARKET, 9998, 1, 640600)
(STARFRUIT, US << MARKET, 5071, 1, 640600)
(STARFRUIT, US << MARKET, 5071, 1, 640600)","{""AMETHYSTS"": 20, ""STARFRUIT"": 3}",4166,5074,9997
641000,-10142,-221138,"(STARFRUIT, US << MARKET, 5071, 1, 641000)
(STARFRUIT, US << MARKET, 5071, 1, 641000)","{""AMETHYSTS"": 20, ""STARFRUIT"": 5}",4232,5074,10000
641500,-10140,-231278,"(STARFRUIT, US << MARKET, 5070, 1, 641500)
(STARFRUIT, US << MARKET, 5070, 1, 641500)","{""AMETHYSTS"": 20, ""STARFRUIT"": 7}",4233,5073,10000
642300,-5071,-236349,"(STARFRUIT, US << MARKET, 5071, 1, 642300)","{""AMETHYSTS"": 20, ""STARFRUIT"": 8}",4211,5070,10000
642400,5070,-231279,"(STARFRUIT, MARKET << US, 5070, 1, 642400)","{""AMETHYSTS"": 20, ""STARFRUIT"": 7}",4232,5073,10000
642600,-5070,-236349,"(STARFRUIT, US << MARKET, 5070, 1, 642600)","{""AMETHYSTS"": 20, ""STARFRUIT"": 8}",4235,5073,10000
642700,4926,-231423,"(AMETHYSTS, MARKET << US, 9995, 1, 642700)
(STARFRUIT, US << MARKET, 5069, 1, 642700)","{""AMETHYSTS"": 19, ""STARFRUIT"": 9}",4225,5072,10000
643100,25360,-206063,"(STARFRUIT, MARKET << US, 5072, 1, 643100)
(STARFRUIT, MARKET << US, 5072, 1, 643100)
(STARFRUIT, MARKET << US, 5072, 1, 643100)
(STARFRUIT, MARKET << US, 5072, 1, 643100)
(STARFRUIT, MARKET << US, 5072, 1, 643100)","{""AMETHYSTS"": 19, ""STARFRUIT"": 4}",4160,5070,9997
643400,-10140,-216203,"(STARFRUIT, US << MARKET, 5070, 1, 643400)
(STARFRUIT, US << MARKET, 5070, 1, 643400)","{""AMETHYSTS"": 19, ""STARFRUIT"": 6}",4235,5073,10000
643600,40008,-176195,"(AMETHYSTS, MARKET << US, 10002, 1, 643600)
(AMETHYSTS, MARKET << US, 10002, 1, 643600)
(AMETHYSTS, MARKET << US, 10002, 1, 643600)
(AMETHYSTS, MARKET << US, 10002, 1, 643600)","{""AMETHYSTS"": 15, ""STARFRUIT"": 6}",4282,5072,10003
644100,-10002,-186197,"(AMETHYSTS, US << MARKET, 10002, 1, 644100)","{""AMETHYSTS"": 16, ""STARFRUIT"": 6}",4283,5072,10003
644300,-20272,-206469,"(STARFRUIT, US << MARKET, 5068, 1, 644300)
(STARFRUIT, US << MARKET, 5068, 1, 644300)
(STARFRUIT, US << MARKET, 5068, 1, 644300)
(STARFRUIT, US << MARKET, 5068, 1, 644300)","{""AMETHYSTS"": 16, ""STARFRUIT"": 10}",4241,5071,10000
644400,-20276,-226745,"(STARFRUIT, US << MARKET, 5069, 1, 644400)
(STARFRUIT, US << MARKET, 5069, 1, 644400)
(STARFRUIT, US << MARKET, 5069, 1, 644400)
(STARFRUIT, US << MARKET, 5069, 1, 644400)","{""AMETHYSTS"": 16, ""STARFRUIT"": 14}",4223,5068,10001
644500,4923,-221822,"(AMETHYSTS, MARKET << US, 9996, 1, 644500)
(STARFRUIT, US << MARKET, 5073, 1, 644500)","{""AMETHYSTS"": 15, ""STARFRUIT"": 15}",4273,5074,9999
644600,-20272,-242094,"(STARFRUIT, US << MARKET, 5068, 1, 644600)
(STARFRUIT, US << MARKET, 5068, 1, 644600)
(STARFRUIT, US << MARKET, 5068, 1, 644600)
(STARFRUIT, US << MARKET, 5068, 1, 644600)","{""AMETHYSTS"": 15, ""STARFRUIT"": 19}",4255,5071,10000
644700,-49990,-292084,"(AMETHYSTS, US << MARKET, 9998, 1, 644700)
(AMETHYSTS, US << MARKET, 9998, 1, 644700)
(AMETHYSTS, US << MARKET, 9998, 1, 644700)
(AMETHYSTS, US << MARKET, 9998, 1, 644700)
(AMETHYSTS, US << MARKET, 9998, 1, 644700)","{""AMETHYSTS"": 20, ""STARFRUIT"": 19}",4186,5070,9997
645500,-3,-292087,"(STARFRUIT, US << MARKET, 5070, 1, 645500)
(STARFRUIT, MARKET << US, 5067, 1, 645500)","{""AMETHYSTS"": 20, ""STARFRUIT"": 19}",4125,5068,9996
645800,14936,-277151,"(AMETHYSTS, MARKET << US, 10004, 1, 645800)
(AMETHYSTS, MARKET << US, 10004, 1, 645800)
(STARFRUIT, US << MARKET, 5072, 1, 645800)","{""AMETHYSTS"": 18, ""STARFRUIT"": 20}",4247,5069,10001
645900,115094,-162057,"(AMETHYSTS, US << MARKET, 10002, 1, 645900)
(AMETHYSTS, MARKET << US, 10002, 1, 645900)
(AMETHYSTS, MARKET << US, 10002, 1, 645900)
(AMETHYSTS, MARKET << US, 10002, 1, 645900)
(AMETHYSTS, MARKET << US, 10002, 1, 645900)
(AMETHYSTS, MARKET << US, 10002, 1, 645900)
(AMETHYSTS, MARKET << US, 10002, 1, 645900)
(AMETHYSTS, MARKET << US, 10002, 1, 645900)
(AMETHYSTS, MARKET << US, 10002, 1, 645900)
(AMETHYSTS, MARKET << US, 10002, 1, 645900)
(AMETHYSTS, MARKET << US, 10002, 1, 645900)
(AMETHYSTS, MARKET << US, 10002, 1, 645900)
(AMETHYSTS, MARKET << US, 10002, 1, 645900)
(STARFRUIT, MARKET << US, 5072, 1, 645900)","{""AMETHYSTS"": 7, ""STARFRUIT"": 19}",4351,5073,10003
646000,100050,-62007,"(AMETHYSTS, MARKET << US, 10005, 1, 646000)
(AMETHYSTS, MARKET << US, 10005, 1, 646000)
(AMETHYSTS, MARKET << US, 10005, 1, 646000)
(AMETHYSTS, MARKET << US, 10005, 1, 646000)
(AMETHYSTS, MARKET << US, 10005, 1, 646000)
(AMETHYSTS, MARKET << US, 10005, 1, 646000)
(AMETHYSTS, MARKET << US, 10005, 1, 646000)
(AMETHYSTS, MARKET << US, 10005, 1, 646000)
(AMETHYSTS, MARKET << US, 10005, 1, 646000)
(AMETHYSTS, MARKET << US, 10005, 1, 646000)","{""AMETHYSTS"": -3, ""STARFRUIT"": 19}",4323,5070,10000
646100,40008,-21999,"(AMETHYSTS, MARKET << US, 10002, 1, 646100)
(AMETHYSTS, MARKET << US, 10002, 1, 646100)
(AMETHYSTS, MARKET << US, 10002, 1, 646100)
(AMETHYSTS, MARKET << US, 10002, 1, 646100)","{""AMETHYSTS"": -7, ""STARFRUIT"": 19}",4310,5070,10003
646500,-5064,-27063,"(STARFRUIT, US << MARKET, 5064, 1, 646500)","{""AMETHYSTS"": -7, ""STARFRUIT"": 20}",4297,5068,10000
647000,40568,13505,"(STARFRUIT, MARKET << US, 5071, 1, 647000)
(STARFRUIT, MARKET << US, 5071, 1, 647000)
(STARFRUIT, MARKET << US, 5071, 1, 647000)
(STARFRUIT, MARKET << US, 5071, 1, 647000)
(STARFRUIT, MARKET << US, 5071, 1, 647000)
(STARFRUIT, MARKET << US, 5071, 1, 647000)
(STARFRUIT, MARKET << US, 5071, 1, 647000)
(STARFRUIT, MARKET << US, 5071, 1, 647000)","{""AMETHYSTS"": -7, ""STARFRUIT"": 12}",4326,5069,10001
647100,35490,48995,"(STARFRUIT, MARKET << US, 5070, 1, 647100)
(STARFRUIT, MARKET << US, 5070, 1, 647100)
(STARFRUIT, MARKET << US, 5070, 1, 647100)
(STARFRUIT, MARKET << US, 5070, 1, 647100)
(STARFRUIT, MARKET << US, 5070, 1, 647100)
(STARFRUIT, MARKET << US, 5070, 1, 647100)
(STARFRUIT, MARKET << US, 5070, 1, 647100)","{""AMETHYSTS"": -7, ""STARFRUIT"": 5}",4330,5067,10000
647800,5070,54065,"(STARFRUIT, MARKET << US, 5070, 1, 647800)","{""AMETHYSTS"": -7, ""STARFRUIT"": 4}",4352,5070,9999
647900,30414,84479,"(STARFRUIT, MARKET << US, 5069, 1, 647900)
(STARFRUIT, MARKET << US, 5069, 1, 647900)
(STARFRUIT, MARKET << US, 5069, 1, 647900)
(STARFRUIT, MARKET << US, 5069, 1, 647900)
(STARFRUIT, MARKET << US, 5069, 1, 647900)
(STARFRUIT, MARKET << US, 5069, 1, 647900)","{""AMETHYSTS"": -7, ""STARFRUIT"": -2}",4339,5070,10000
648100,-19996,64483,"(AMETHYSTS, US << MARKET, 9998, 1, 648100)
(AMETHYSTS, US << MARKET, 9998, 1, 648100)","{""AMETHYSTS"": -5, ""STARFRUIT"": -2}",4340,5069,10001
648300,-10130,54353,"(STARFRUIT, US << MARKET, 5065, 1, 648300)
(STARFRUIT, US << MARKET, 5065, 1, 648300)","{""AMETHYSTS"": -5, ""STARFRUIT"": 0}",4353,5068,10000
648600,-136,54217,"(AMETHYSTS, MARKET << US, 10000, 1, 648600)
(STARFRUIT, US << MARKET, 5068, 1, 648600)
(STARFRUIT, US << MARKET, 5068, 1, 648600)","{""AMETHYSTS"": -6, ""STARFRUIT"": 2}",4343,5069,10002
648800,-30128,24089,"(AMETHYSTS, US << MARKET, 9998, 1, 648800)
(AMETHYSTS, US << MARKET, 9998, 1, 648800)
(STARFRUIT, US << MARKET, 5066, 1, 648800)
(STARFRUIT, US << MARKET, 5066, 1, 648800)","{""AMETHYSTS"": -4, ""STARFRUIT"": 4}",4345,5065,10001
648900,5071,29160,"(STARFRUIT, MARKET << US, 5071, 1, 648900)","{""AMETHYSTS"": -4, ""STARFRUIT"": 3}",4373,5071,10000
649100,-10142,19018,"(STARFRUIT, US << MARKET, 5071, 1, 649100)
(STARFRUIT, US << MARKET, 5071, 1, 649100)","{""AMETHYSTS"": -4, ""STARFRUIT"": 5}",4373,5071,10000
649200,105344,124362,"(AMETHYSTS, MARKET << US, 9998, 1, 649200)
(AMETHYSTS, MARKET << US, 9998, 1, 649200)
(AMETHYSTS, MARKET << US, 9998, 1, 649200)
(AMETHYSTS, MARKET << US, 9998, 1, 649200)
(AMETHYSTS, MARKET << US, 9998, 1, 649200)
(AMETHYSTS, MARKET << US, 9998, 1, 649200)
(AMETHYSTS, MARKET << US, 9998, 1, 649200)
(AMETHYSTS, MARKET << US, 9998, 1, 649200)
(STARFRUIT, MARKET << US, 5072, 1, 649200)
(STARFRUIT, MARKET << US, 5072, 1, 649200)
(STARFRUIT, MARKET << US, 5072, 1, 649200)
(STARFRUIT, MARKET << US, 5072, 1, 649200)
(STARFRUIT, MARKET << US, 5072, 1, 649200)","{""AMETHYSTS"": -12, ""STARFRUIT"": 0}",4350,5068,10001
649300,-25056,99306,"(AMETHYSTS, US << MARKET, 9996, 1, 649300)
(AMETHYSTS, US << MARKET, 9996, 1, 649300)
(STARFRUIT, US << MARKET, 5065, 1, 649300)
(STARFRUIT, US << MARKET, 5065, 1, 649300)
(STARFRUIT, MARKET << US, 5066, 1, 649300)","{""AMETHYSTS"": -10, ""STARFRUIT"": 1}",4371,5065,10000
649500,9998,109304,"(AMETHYSTS, MARKET << US, 9998, 1, 649500)","{""AMETHYSTS"": -11, ""STARFRUIT"": 1}",4405,5068,9997
649600,35205,144509,"(AMETHYSTS, MARKET << US, 10002, 1, 649600)
(AMETHYSTS, MARKET << US, 10002, 1, 649600)
(STARFRUIT, MARKET << US, 5067, 1, 649600)
(STARFRUIT, MARKET << US, 5067, 1, 649600)
(STARFRUIT, MARKET << US, 5067, 1, 649600)","{""AMETHYSTS"": -13, ""STARFRUIT"": -2}",4418,5065,9997
649900,5066,149575,"(STARFRUIT, MARKET << US, 5066, 1, 649900)","{""AMETHYSTS"": -13, ""STARFRUIT"": -3}",4380,5065,10000
650500,-20142,129433,"(AMETHYSTS, US << MARKET, 9998, 1, 650500)
(AMETHYSTS, US << MARKET, 9998, 1, 650500)
(AMETHYSTS, MARKET << US, 9998, 1, 650500)
(STARFRUIT, US << MARKET, 5072, 1, 650500)
(STARFRUIT, US << MARKET, 5072, 1, 650500)","{""AMETHYSTS"": -12, ""STARFRUIT"": -1}",4412,5069,9996
650800,19992,149425,"(AMETHYSTS, MARKET << US, 9996, 1, 650800)
(AMETHYSTS, MARKET << US, 9996, 1, 650800)","{""AMETHYSTS"": -14, ""STARFRUIT"": -1}",4369,5070,9999
651000,20004,169429,"(AMETHYSTS, MARKET << US, 10002, 1, 651000)
(AMETHYSTS, MARKET << US, 10002, 1, 651000)","{""AMETHYSTS"": -16, ""STARFRUIT"": -1}",4311,5070,10003
651100,-99980,69449,"(AMETHYSTS, US << MARKET, 9998, 1, 651100)
(AMETHYSTS, US << MARKET, 9998, 1, 651100)
(AMETHYSTS, US << MARKET, 9998, 1, 651100)
(AMETHYSTS, US << MARKET, 9998, 1, 651100)
(AMETHYSTS, US << MARKET, 9998, 1, 651100)
(AMETHYSTS, US << MARKET, 9998, 1, 651100)
(AMETHYSTS, US << MARKET, 9998, 1, 651100)
(AMETHYSTS, US << MARKET, 9998, 1, 651100)
(AMETHYSTS, US << MARKET, 9998, 1, 651100)
(AMETHYSTS, US << MARKET, 9998, 1, 651100)","{""AMETHYSTS"": -6, ""STARFRUIT"": -1}",4404,5069,9996
651500,15204,84653,"(STARFRUIT, MARKET << US, 5068, 1, 651500)
(STARFRUIT, MARKET << US, 5068, 1, 651500)
(STARFRUIT, MARKET << US, 5068, 1, 651500)","{""AMETHYSTS"": -6, ""STARFRUIT"": -4}",4387,5071,9997
651600,-10136,74517,"(STARFRUIT, US << MARKET, 5068, 1, 651600)
(STARFRUIT, US << MARKET, 5068, 1, 651600)","{""AMETHYSTS"": -6, ""STARFRUIT"": -2}",4375,5071,10000
651900,-20292,54225,"(STARFRUIT, US << MARKET, 5073, 1, 651900)
(STARFRUIT, US << MARKET, 5073, 1, 651900)
(STARFRUIT, US << MARKET, 5073, 1, 651900)
(STARFRUIT, US << MARKET, 5073, 1, 651900)","{""AMETHYSTS"": -6, ""STARFRUIT"": 2}",4365,5070,10000
652100,-10004,44221,"(AMETHYSTS, US << MARKET, 10004, 1, 652100)","{""AMETHYSTS"": -5, ""STARFRUIT"": 2}",4359,5069,10000
652200,49990,94211,"(AMETHYSTS, MARKET << US, 9998, 1, 652200)
(AMETHYSTS, MARKET << US, 9998, 1, 652200)
(AMETHYSTS, MARKET << US, 9998, 1, 652200)
(AMETHYSTS, MARKET << US, 9998, 1, 652200)
(AMETHYSTS, MARKET << US, 9998, 1, 652200)","{""AMETHYSTS"": -10, ""STARFRUIT"": 2}",4381,5070,9997
652700,-136,94075,"(AMETHYSTS, MARKET << US, 9998, 1, 652700)
(STARFRUIT, US << MARKET, 5067, 1, 652700)
(STARFRUIT, US << MARKET, 5067, 1, 652700)","{""AMETHYSTS"": -11, ""STARFRUIT"": 4}",4395,5069,9996
652900,-50010,44065,"(AMETHYSTS, US << MARKET, 10002, 1, 652900)
(AMETHYSTS, US << MARKET, 10002, 1, 652900)
(AMETHYSTS, US << MARKET, 10002, 1, 652900)
(AMETHYSTS, US << MARKET, 10002, 1, 652900)
(AMETHYSTS, US << MARKET, 10002, 1, 652900)","{""AMETHYSTS"": -6, ""STARFRUIT"": 4}",4323,5069,10003
653000,20273,64338,"(STARFRUIT, MARKET << US, 5072, 1, 653000)
(STARFRUIT, MARKET << US, 5067, 1, 653000)
(STARFRUIT, MARKET << US, 5067, 1, 653000)
(STARFRUIT, MARKET << US, 5067, 1, 653000)","{""AMETHYSTS"": -6, ""STARFRUIT"": 0}",4338,5069,10000
653200,-19996,44342,"(AMETHYSTS, US << MARKET, 9998, 1, 653200)
(AMETHYSTS, US << MARKET, 9998, 1, 653200)","{""AMETHYSTS"": -4, ""STARFRUIT"": 0}",4354,5070,9997
653600,-20008,24334,"(AMETHYSTS, US << MARKET, 10004, 1, 653600)
(AMETHYSTS, US << MARKET, 10004, 1, 653600)","{""AMETHYSTS"": -2, ""STARFRUIT"": 0}",4334,5072,10000
654000,40016,64350,"(AMETHYSTS, MARKET << US, 10004, 1, 654000)
(AMETHYSTS, MARKET << US, 10004, 1, 654000)
(AMETHYSTS, MARKET << US, 10004, 1, 654000)
(AMETHYSTS, MARKET << US, 10004, 1, 654000)","{""AMETHYSTS"": -6, ""STARFRUIT"": 0}",4350,5066,10000
654100,5065,69415,"(STARFRUIT, MARKET << US, 5065, 1, 654100)","{""AMETHYSTS"": -6, ""STARFRUIT"": -1}",4347,5068,10000
654200,-19876,49539,"(AMETHYSTS, US << MARKET, 10002, 1, 654200)
(AMETHYSTS, US << MARKET, 10002, 1, 654200)
(AMETHYSTS, US << MARKET, 10002, 1, 654200)
(STARFRUIT, MARKET << US, 5065, 1, 654200)
(STARFRUIT, MARKET << US, 5065, 1, 654200)","{""AMETHYSTS"": -3, ""STARFRUIT"": -3}",4326,5068,10003
654300,-20142,29397,"(AMETHYSTS, US << MARKET, 10002, 1, 654300)
(STARFRUIT, US << MARKET, 5070, 1, 654300)
(STARFRUIT, US << MARKET, 5070, 1, 654300)","{""AMETHYSTS"": -2, ""STARFRUIT"": -1}",4320,5071,10003
654700,-159960,-130563,"(AMETHYSTS, US << MARKET, 9996, 1, 654700)
(AMETHYSTS, US << MARKET, 9996, 1, 654700)
(AMETHYSTS, US << MARKET, 9996, 1, 654700)
(AMETHYSTS, US << MARKET, 9996, 1, 654700)
(AMETHYSTS, US << MARKET, 9996, 1, 654700)
(AMETHYSTS, US << MARKET, 9996, 1, 654700)
(AMETHYSTS, US << MARKET, 9996, 1, 654700)
(AMETHYSTS, US << MARKET, 9996, 1, 654700)
(AMETHYSTS, US << MARKET, 9996, 1, 654700)
(AMETHYSTS, US << MARKET, 9996, 1, 654700)
(AMETHYSTS, US << MARKET, 9996, 1, 654700)
(AMETHYSTS, US << MARKET, 9996, 1, 654700)
(AMETHYSTS, US << MARKET, 10002, 1, 654700)
(AMETHYSTS, US << MARKET, 10002, 1, 654700)
(AMETHYSTS, US << MARKET, 10002, 1, 654700)
(AMETHYSTS, US << MARKET, 10002, 1, 654700)","{""AMETHYSTS"": 14, ""STARFRUIT"": -1}",4356,5067,9999
655000,9998,-120565,"(AMETHYSTS, MARKET << US, 9998, 1, 655000)","{""AMETHYSTS"": 13, ""STARFRUIT"": -1}",4381,5067,10001
655200,15201,-105364,"(STARFRUIT, MARKET << US, 5067, 1, 655200)
(STARFRUIT, MARKET << US, 5067, 1, 655200)
(STARFRUIT, MARKET << US, 5067, 1, 655200)","{""AMETHYSTS"": 13, ""STARFRUIT"": -4}",4350,5065,9998
655400,19724,-85640,"(AMETHYSTS, MARKET << US, 10002, 1, 655400)
(AMETHYSTS, MARKET << US, 10002, 1, 655400)
(AMETHYSTS, MARKET << US, 10002, 1, 655400)
(AMETHYSTS, MARKET << US, 10002, 1, 655400)
(STARFRUIT, US << MARKET, 5071, 1, 655400)
(STARFRUIT, US << MARKET, 5071, 1, 655400)
(STARFRUIT, US << MARKET, 5071, 1, 655400)
(STARFRUIT, US << MARKET, 5071, 1, 655400)","{""AMETHYSTS"": 9, ""STARFRUIT"": 0}",4342,5067,9998
656000,25069,-60571,"(AMETHYSTS, MARKET << US, 10002, 1, 656000)
(AMETHYSTS, MARKET << US, 10002, 1, 656000)
(STARFRUIT, MARKET << US, 5065, 1, 656000)","{""AMETHYSTS"": 7, ""STARFRUIT"": -1}",4362,5067,10000
656100,-10140,-70711,"(STARFRUIT, US << MARKET, 5070, 1, 656100)
(STARFRUIT, US << MARKET, 5070, 1, 656100)","{""AMETHYSTS"": 7, ""STARFRUIT"": 1}",4352,5070,9999
656400,-10142,-80853,"(STARFRUIT, US << MARKET, 5071, 1, 656400)
(STARFRUIT, US << MARKET, 5071, 1, 656400)
(STARFRUIT, US << MARKET, 5071, 1, 656400)
(STARFRUIT, US << MARKET, 5071, 1, 656400)
(STARFRUIT, MARKET << US, 5071, 1, 656400)
(STARFRUIT, MARKET << US, 5071, 1, 656400)","{""AMETHYSTS"": 7, ""STARFRUIT"": 3}",4368,5069,10002
656600,10258,-70595,"(AMETHYSTS, US << MARKET, 10002, 1, 656600)
(STARFRUIT, MARKET << US, 5065, 1, 656600)
(STARFRUIT, MARKET << US, 5065, 1, 656600)
(STARFRUIT, MARKET << US, 5065, 1, 656600)
(STARFRUIT, MARKET << US, 5065, 1, 656600)","{""AMETHYSTS"": 8, ""STARFRUIT"": -1}",4362,5067,10003
657100,15068,-55527,"(AMETHYSTS, MARKET << US, 9998, 1, 657100)
(STARFRUIT, MARKET << US, 5070, 1, 657100)","{""AMETHYSTS"": 7, ""STARFRUIT"": -2}",4303,5071,9996
657600,-20151,-75678,"(AMETHYSTS, US << MARKET, 10005, 1, 657600)
(STARFRUIT, US << MARKET, 5073, 1, 657600)
(STARFRUIT, US << MARKET, 5073, 1, 657600)","{""AMETHYSTS"": 8, ""STARFRUIT"": 0}",4346,5069,10003
657800,-30414,-106092,"(STARFRUIT, US << MARKET, 5069, 1, 657800)
(STARFRUIT, US << MARKET, 5069, 1, 657800)
(STARFRUIT, US << MARKET, 5069, 1, 657800)
(STARFRUIT, US << MARKET, 5069, 1, 657800)
(STARFRUIT, US << MARKET, 5069, 1, 657800)
(STARFRUIT, US << MARKET, 5069, 1, 657800)","{""AMETHYSTS"": 8, ""STARFRUIT"": 6}",4286,5067,9997
658100,5066,-101026,"(STARFRUIT, MARKET << US, 5066, 1, 658100)","{""AMETHYSTS"": 8, ""STARFRUIT"": 5}",4327,5069,10001
658200,40008,-61018,"(AMETHYSTS, MARKET << US, 10002, 1, 658200)
(AMETHYSTS, MARKET << US, 10002, 1, 658200)
(AMETHYSTS, MARKET << US, 10002, 1, 658200)
(AMETHYSTS, MARKET << US, 10002, 1, 658200)","{""AMETHYSTS"": 4, ""STARFRUIT"": 5}",4339,5069,10003
658300,15065,-45953,"(AMETHYSTS, MARKET << US, 9998, 1, 658300)
(STARFRUIT, MARKET << US, 5067, 1, 658300)","{""AMETHYSTS"": 3, ""STARFRUIT"": 4}",4326,5069,10001
658400,-40008,-85961,"(AMETHYSTS, US << MARKET, 10002, 1, 658400)
(AMETHYSTS, US << MARKET, 10002, 1, 658400)
(AMETHYSTS, US << MARKET, 10002, 1, 658400)
(AMETHYSTS, US << MARKET, 10002, 1, 658400)","{""AMETHYSTS"": 7, ""STARFRUIT"": 4}",4332,5068,10003
658600,-10002,-95963,"(AMETHYSTS, US << MARKET, 10002, 1, 658600)","{""AMETHYSTS"": 8, ""STARFRUIT"": 4}",4337,5069,10003
658700,20280,-75683,"(STARFRUIT, MARKET << US, 5070, 1, 658700)
(STARFRUIT, MARKET << US, 5070, 1, 658700)
(STARFRUIT, MARKET << US, 5070, 1, 658700)
(STARFRUIT, MARKET << US, 5070, 1, 658700)","{""AMETHYSTS"": 8, ""STARFRUIT"": 0}",4317,5071,10000
658900,-80257,-155940,"(AMETHYSTS, US << MARKET, 9996, 1, 658900)
(AMETHYSTS, US << MARKET, 9996, 1, 658900)
(AMETHYSTS, US << MARKET, 9996, 1, 658900)
(AMETHYSTS, US << MARKET, 9996, 1, 658900)
(AMETHYSTS, US << MARKET, 9996, 1, 658900)
(AMETHYSTS, US << MARKET, 9996, 1, 658900)
(AMETHYSTS, US << MARKET, 9996, 1, 658900)
(AMETHYSTS, US << MARKET, 9996, 1, 658900)
(AMETHYSTS, MARKET << US, 9996, 1, 658900)
(AMETHYSTS, MARKET << US, 9996, 1, 658900)
(STARFRUIT, US << MARKET, 5071, 1, 658900)
(STARFRUIT, US << MARKET, 5071, 1, 658900)
(STARFRUIT, US << MARKET, 5071, 1, 658900)
(STARFRUIT, US << MARKET, 5071, 1, 658900)
(STARFRUIT, US << MARKET, 5071, 1, 658900)
(STARFRUIT, US << MARKET, 5071, 1, 658900)
(STARFRUIT, MARKET << US, 5073, 1, 658900)
(STARFRUIT, MARKET << US, 5072, 1, 658900)","{""AMETHYSTS"": 14, ""STARFRUIT"": 4}",4348,5072,10000
659000,-19996,-175936,"(AMETHYSTS, US << MARKET, 9998, 1, 659000)
(AMETHYSTS, US << MARKET, 9998, 1, 659000)","{""AMETHYSTS"": 16, ""STARFRUIT"": 4}",4360,5070,10001
659300,-10134,-186070,"(STARFRUIT, US << MARKET, 5067, 1, 659300)
(STARFRUIT, US << MARKET, 5067, 1, 659300)","{""AMETHYSTS"": 16, ""STARFRUIT"": 6}",4366,5070,10001
660000,-272,-186342,"(AMETHYSTS, MARKET << US, 10000, 1, 660000)
(AMETHYSTS, MARKET << US, 10000, 1, 660000)
(STARFRUIT, US << MARKET, 5068, 1, 660000)
(STARFRUIT, US << MARKET, 5068, 1, 660000)
(STARFRUIT, US << MARKET, 5068, 1, 660000)
(STARFRUIT, US << MARKET, 5068, 1, 660000)","{""AMETHYSTS"": 14, ""STARFRUIT"": 10}",4290,5066,9998
660100,-15201,-201543,"(STARFRUIT, US << MARKET, 5067, 1, 660100)
(STARFRUIT, US << MARKET, 5067, 1, 660100)
(STARFRUIT, US << MARKET, 5067, 1, 660100)","{""AMETHYSTS"": 14, ""STARFRUIT"": 13}",4287,5066,9998
660200,10138,-191405,"(STARFRUIT, MARKET << US, 5069, 1, 660200)
(STARFRUIT, MARKET << US, 5069, 1, 660200)","{""AMETHYSTS"": 14, ""STARFRUIT"": 11}",4321,5066,10000
660300,40016,-151389,"(AMETHYSTS, MARKET << US, 10004, 1, 660300)
(AMETHYSTS, MARKET << US, 10004, 1, 660300)
(AMETHYSTS, MARKET << US, 10004, 1, 660300)
(AMETHYSTS, MARKET << US, 10004, 1, 660300)
(STARFRUIT, US << MARKET, 5070, 1, 660300)
(STARFRUIT, MARKET << US, 5070, 1, 660300)","{""AMETHYSTS"": 10, ""STARFRUIT"": 11}",4348,5067,10000
660400,5064,-146325,"(STARFRUIT, MARKET << US, 5064, 1, 660400)","{""AMETHYSTS"": 10, ""STARFRUIT"": 10}",4355,5068,10000
660500,45621,-100704,"(STARFRUIT, MARKET << US, 5069, 1, 660500)
(STARFRUIT, MARKET << US, 5069, 1, 660500)
(STARFRUIT, MARKET << US, 5069, 1, 660500)
(STARFRUIT, MARKET << US, 5069, 1, 660500)
(STARFRUIT, MARKET << US, 5069, 1, 660500)
(STARFRUIT, MARKET << US, 5069, 1, 660500)
(STARFRUIT, MARKET << US, 5069, 1, 660500)
(STARFRUIT, MARKET << US, 5069, 1, 660500)
(STARFRUIT, MARKET << US, 5069, 1, 660500)","{""AMETHYSTS"": 10, ""STARFRUIT"": 1}",4352,5066,9999
660700,30390,-70314,"(STARFRUIT, MARKET << US, 5065, 1, 660700)
(STARFRUIT, MARKET << US, 5065, 1, 660700)
(STARFRUIT, MARKET << US, 5065, 1, 660700)
(STARFRUIT, MARKET << US, 5065, 1, 660700)
(STARFRUIT, MARKET << US, 5065, 1, 660700)
(STARFRUIT, MARKET << US, 5065, 1, 660700)","{""AMETHYSTS"": 10, ""STARFRUIT"": -5}",4366,5064,10000
660900,-30120,-100434,"(AMETHYSTS, US << MARKET, 9996, 1, 660900)
(AMETHYSTS, US << MARKET, 9996, 1, 660900)
(STARFRUIT, US << MARKET, 5064, 1, 660900)
(STARFRUIT, US << MARKET, 5064, 1, 660900)","{""AMETHYSTS"": 12, ""STARFRUIT"": -3}",4368,5066,10000
661000,19726,-80708,"(AMETHYSTS, MARKET << US, 9996, 1, 661000)
(AMETHYSTS, MARKET << US, 9996, 1, 661000)
(AMETHYSTS, MARKET << US, 9995, 1, 661000)
(AMETHYSTS, MARKET << US, 9995, 1, 661000)
(STARFRUIT, US << MARKET, 5064, 1, 661000)
(STARFRUIT, US << MARKET, 5064, 1, 661000)
(STARFRUIT, US << MARKET, 5064, 1, 661000)
(STARFRUIT, US << MARKET, 5064, 1, 661000)","{""AMETHYSTS"": 8, ""STARFRUIT"": 1}",4356,5064,10000
661100,-10138,-90846,"(STARFRUIT, US << MARKET, 5069, 1, 661100)
(STARFRUIT, US << MARKET, 5069, 1, 661100)","{""AMETHYSTS"": 8, ""STARFRUIT"": 3}",4364,5070,10000
661200,-15327,-106173,"(AMETHYSTS, MARKET << US, 9998, 1, 661200)
(STARFRUIT, US << MARKET, 5065, 1, 661200)
(STARFRUIT, US << MARKET, 5065, 1, 661200)
(STARFRUIT, US << MARKET, 5065, 1, 661200)
(STARFRUIT, US << MARKET, 5065, 1, 661200)
(STARFRUIT, US << MARKET, 5065, 1, 661200)","{""AMETHYSTS"": 7, ""STARFRUIT"": 8}",4318,5064,9997
661400,29994,-76179,"(AMETHYSTS, MARKET << US, 9998, 1, 661400)
(AMETHYSTS, MARKET << US, 9998, 1, 661400)
(AMETHYSTS, MARKET << US, 9998, 1, 661400)","{""AMETHYSTS"": 4, ""STARFRUIT"": 8}",4345,5067,9997
661700,30420,-45759,"(STARFRUIT, MARKET << US, 5070, 1, 661700)
(STARFRUIT, MARKET << US, 5070, 1, 661700)
(STARFRUIT, MARKET << US, 5070, 1, 661700)
(STARFRUIT, MARKET << US, 5070, 1, 661700)
(STARFRUIT, MARKET << US, 5070, 1, 661700)
(STARFRUIT, MARKET << US, 5070, 1, 661700)","{""AMETHYSTS"": 4, ""STARFRUIT"": 2}",4379,5069,10000
661800,-4935,-50694,"(AMETHYSTS, US << MARKET, 10005, 1, 661800)
(STARFRUIT, MARKET << US, 5070, 1, 661800)","{""AMETHYSTS"": 5, ""STARFRUIT"": 1}",4377,5066,10001
661900,-10002,-60696,"(AMETHYSTS, US << MARKET, 10002, 1, 661900)","{""AMETHYSTS"": 6, ""STARFRUIT"": 1}",4388,5066,10003
662000,12,-60684,"(AMETHYSTS, US << MARKET, 9998, 1, 662000)
(AMETHYSTS, US << MARKET, 9998, 1, 662000)
(AMETHYSTS, MARKET << US, 10004, 1, 662000)
(AMETHYSTS, MARKET << US, 10004, 1, 662000)","{""AMETHYSTS"": 6, ""STARFRUIT"": 1}",4391,5069,10001
662100,-10138,-70822,"(STARFRUIT, US << MARKET, 5069, 1, 662100)
(STARFRUIT, US << MARKET, 5069, 1, 662100)","{""AMETHYSTS"": 6, ""STARFRUIT"": 3}",4385,5069,10000
662400,5064,-65758,"(STARFRUIT, MARKET << US, 5064, 1, 662400)","{""AMETHYSTS"": 6, ""STARFRUIT"": 2}",4352,5067,9996
663000,24645,-41113,"(AMETHYSTS, MARKET << US, 9998, 1, 663000)
(AMETHYSTS, MARKET << US, 9998, 1, 663000)
(AMETHYSTS, MARKET << US, 9998, 1, 663000)
(AMETHYSTS, MARKET << US, 9998, 1, 663000)
(AMETHYSTS, MARKET << US, 9998, 1, 663000)
(STARFRUIT, US << MARKET, 5069, 1, 663000)
(STARFRUIT, US << MARKET, 5069, 1, 663000)
(STARFRUIT, US << MARKET, 5069, 1, 663000)
(STARFRUIT, US << MARKET, 5069, 1, 663000)
(STARFRUIT, US << MARKET, 5069, 1, 663000)","{""AMETHYSTS"": 1, ""STARFRUIT"": 7}",4373,5070,9996
663100,-5069,-46182,"(STARFRUIT, US << MARKET, 5069, 1, 663100)","{""AMETHYSTS"": 1, ""STARFRUIT"": 8}",4378,5070,10000
663500,-39984,-86166,"(AMETHYSTS, US << MARKET, 9996, 1, 663500)
(AMETHYSTS, US << MARKET, 9996, 1, 663500)
(AMETHYSTS, US << MARKET, 9996, 1, 663500)
(AMETHYSTS, US << MARKET, 9996, 1, 663500)","{""AMETHYSTS"": 5, ""STARFRUIT"": 8}",4386,5069,10000
663800,40275,-45891,"(AMETHYSTS, MARKET << US, 10002, 1, 663800)
(AMETHYSTS, MARKET << US, 10002, 1, 663800)
(STARFRUIT, US << MARKET, 5069, 1, 663800)
(STARFRUIT, MARKET << US, 5068, 1, 663800)
(STARFRUIT, MARKET << US, 5068, 1, 663800)
(STARFRUIT, MARKET << US, 5068, 1, 663800)
(STARFRUIT, MARKET << US, 5068, 1, 663800)
(STARFRUIT, MARKET << US, 5068, 1, 663800)","{""AMETHYSTS"": 3, ""STARFRUIT"": 4}",4390,5068,10003
664500,-20004,-65895,"(AMETHYSTS, US << MARKET, 10002, 1, 664500)
(AMETHYSTS, US << MARKET, 10002, 1, 664500)","{""AMETHYSTS"": 5, ""STARFRUIT"": 4}",4367,5068,9998
664600,25069,-40826,"(AMETHYSTS, MARKET << US, 10002, 1, 664600)
(AMETHYSTS, MARKET << US, 10002, 1, 664600)
(STARFRUIT, MARKET << US, 5065, 1, 664600)","{""AMETHYSTS"": 3, ""STARFRUIT"": 3}",4387,5068,10003
664700,-25360,-66186,"(STARFRUIT, US << MARKET, 5072, 1, 664700)
(STARFRUIT, US << MARKET, 5072, 1, 664700)
(STARFRUIT, US << MARKET, 5072, 1, 664700)
(STARFRUIT, US << MARKET, 5072, 1, 664700)
(STARFRUIT, US << MARKET, 5072, 1, 664700)","{""AMETHYSTS"": 3, ""STARFRUIT"": 8}",4358,5068,10000
664800,-20272,-86458,"(STARFRUIT, US << MARKET, 5068, 1, 664800)
(STARFRUIT, US << MARKET, 5068, 1, 664800)
(STARFRUIT, US << MARKET, 5068, 1, 664800)
(STARFRUIT, US << MARKET, 5068, 1, 664800)","{""AMETHYSTS"": 3, ""STARFRUIT"": 12}",4328,5066,9998
665100,20004,-66454,"(AMETHYSTS, MARKET << US, 10002, 1, 665100)
(AMETHYSTS, MARKET << US, 10002, 1, 665100)","{""AMETHYSTS"": 1, ""STARFRUIT"": 12}",4353,5067,10003
665400,-54941,-121395,"(AMETHYSTS, US << MARKET, 10002, 1, 665400)
(AMETHYSTS, US << MARKET, 10002, 1, 665400)
(AMETHYSTS, US << MARKET, 10002, 1, 665400)
(AMETHYSTS, US << MARKET, 10002, 1, 665400)
(AMETHYSTS, US << MARKET, 10002, 1, 665400)
(AMETHYSTS, US << MARKET, 10002, 1, 665400)
(STARFRUIT, MARKET << US, 5071, 1, 665400)","{""AMETHYSTS"": 7, ""STARFRUIT"": 11}",4407,5071,10003
666400,10132,-111263,"(STARFRUIT, MARKET << US, 5066, 1, 666400)
(STARFRUIT, MARKET << US, 5066, 1, 666400)","{""AMETHYSTS"": 7, ""STARFRUIT"": 9}",4322,5065,10000
666600,-14927,-126190,"(AMETHYSTS, US << MARKET, 9998, 1, 666600)
(AMETHYSTS, US << MARKET, 9998, 1, 666600)
(STARFRUIT, MARKET << US, 5069, 1, 666600)","{""AMETHYSTS"": 9, ""STARFRUIT"": 8}",4335,5069,9997
667200,20004,-106186,"(AMETHYSTS, MARKET << US, 10002, 1, 667200)
(AMETHYSTS, MARKET << US, 10002, 1, 667200)","{""AMETHYSTS"": 7, ""STARFRUIT"": 8}",4363,5066,10003
667300,-10002,-116188,"(AMETHYSTS, US << MARKET, 10002, 1, 667300)","{""AMETHYSTS"": 8, ""STARFRUIT"": 8}",4332,5067,9998
667500,60012,-56176,"(AMETHYSTS, MARKET << US, 10002, 1, 667500)
(AMETHYSTS, MARKET << US, 10002, 1, 667500)
(AMETHYSTS, MARKET << US, 10002, 1, 667500)
(AMETHYSTS, MARKET << US, 10002, 1, 667500)
(AMETHYSTS, MARKET << US, 10002, 1, 667500)
(AMETHYSTS, MARKET << US, 10002, 1, 667500)","{""AMETHYSTS"": 2, ""STARFRUIT"": 8}",4348,5066,9998
667600,-19996,-76172,"(AMETHYSTS, US << MARKET, 9998, 1, 667600)
(AMETHYSTS, US << MARKET, 9998, 1, 667600)","{""AMETHYSTS"": 4, ""STARFRUIT"": 8}",4344,5066,9997
667800,10128,-66044,"(STARFRUIT, MARKET << US, 5064, 1, 667800)
(STARFRUIT, MARKET << US, 5064, 1, 667800)","{""AMETHYSTS"": 4, ""STARFRUIT"": 6}",4350,5067,9998
668300,5068,-60976,"(STARFRUIT, MARKET << US, 5068, 1, 668300)","{""AMETHYSTS"": 4, ""STARFRUIT"": 5}",4368,5068,10001
668400,25071,-35905,"(AMETHYSTS, MARKET << US, 10004, 1, 668400)
(AMETHYSTS, MARKET << US, 10004, 1, 668400)
(STARFRUIT, MARKET << US, 5063, 1, 668400)","{""AMETHYSTS"": 2, ""STARFRUIT"": 4}",4343,5062,10000
668600,-20252,-56157,"(STARFRUIT, US << MARKET, 5063, 1, 668600)
(STARFRUIT, US << MARKET, 5063, 1, 668600)
(STARFRUIT, US << MARKET, 5063, 1, 668600)
(STARFRUIT, US << MARKET, 5063, 1, 668600)","{""AMETHYSTS"": 2, ""STARFRUIT"": 8}",4371,5066,10000
668700,39992,-16165,"(AMETHYSTS, MARKET << US, 9998, 1, 668700)
(AMETHYSTS, MARKET << US, 9998, 1, 668700)
(AMETHYSTS, MARKET << US, 9998, 1, 668700)
(AMETHYSTS, MARKET << US, 9998, 1, 668700)","{""AMETHYSTS"": -2, ""STARFRUIT"": 8}",4353,5065,10001
668900,-39984,-56149,"(AMETHYSTS, US << MARKET, 9996, 1, 668900)
(AMETHYSTS, US << MARKET, 9996, 1, 668900)
(AMETHYSTS, US << MARKET, 9996, 1, 668900)
(AMETHYSTS, US << MARKET, 9996, 1, 668900)","{""AMETHYSTS"": 2, ""STARFRUIT"": 8}",4371,5065,10000
669100,-20252,-76401,"(STARFRUIT, US << MARKET, 5063, 1, 669100)
(STARFRUIT, US << MARKET, 5063, 1, 669100)
(STARFRUIT, US << MARKET, 5063, 1, 669100)
(STARFRUIT, US << MARKET, 5063, 1, 669100)","{""AMETHYSTS"": 2, ""STARFRUIT"": 12}",4391,5066,10000
669300,-20252,-96653,"(STARFRUIT, US << MARKET, 5063, 1, 669300)
(STARFRUIT, US << MARKET, 5063, 1, 669300)
(STARFRUIT, US << MARKET, 5063, 1, 669300)
(STARFRUIT, US << MARKET, 5063, 1, 669300)","{""AMETHYSTS"": 2, ""STARFRUIT"": 16}",4383,5065,9998
669600,9862,-86791,"(AMETHYSTS, MARKET << US, 9995, 1, 669600)
(AMETHYSTS, MARKET << US, 9995, 1, 669600)
(STARFRUIT, US << MARKET, 5064, 1, 669600)
(STARFRUIT, US << MARKET, 5064, 1, 669600)","{""AMETHYSTS"": 0, ""STARFRUIT"": 18}",4415,5067,9998
669900,-5069,-91860,"(STARFRUIT, US << MARKET, 5069, 1, 669900)","{""AMETHYSTS"": 0, ""STARFRUIT"": 19}",4451,5069,10001
670300,5070,-86790,"(STARFRUIT, MARKET << US, 5070, 1, 670300)","{""AMETHYSTS"": 0, ""STARFRUIT"": 18}",4416,5067,10003
670500,-10130,-96920,"(STARFRUIT, US << MARKET, 5065, 1, 670500)
(STARFRUIT, US << MARKET, 5065, 1, 670500)","{""AMETHYSTS"": 0, ""STARFRUIT"": 20}",4440,5068,9999
670600,5064,-91856,"(STARFRUIT, MARKET << US, 5064, 1, 670600)","{""AMETHYSTS"": 0, ""STARFRUIT"": 19}",4417,5067,10000
670800,15207,-76649,"(STARFRUIT, US << MARKET, 5069, 1, 670800)
(STARFRUIT, MARKET << US, 5069, 1, 670800)
(STARFRUIT, MARKET << US, 5069, 1, 670800)
(STARFRUIT, MARKET << US, 5069, 1, 670800)
(STARFRUIT, MARKET << US, 5069, 1, 670800)","{""AMETHYSTS"": 0, ""STARFRUIT"": 16}",4407,5066,10000
671100,5065,-71584,"(STARFRUIT, MARKET << US, 5065, 1, 671100)","{""AMETHYSTS"": 0, ""STARFRUIT"": 15}",4376,5064,10000
671800,-19996,-91580,"(AMETHYSTS, US << MARKET, 9998, 1, 671800)
(AMETHYSTS, US << MARKET, 9998, 1, 671800)","{""AMETHYSTS"": 2, ""STARFRUIT"": 15}",4417,5067,9996
672100,59988,-31592,"(AMETHYSTS, MARKET << US, 9998, 1, 672100)
(AMETHYSTS, MARKET << US, 9998, 1, 672100)
(AMETHYSTS, MARKET << US, 9998, 1, 672100)
(AMETHYSTS, MARKET << US, 9998, 1, 672100)
(AMETHYSTS, MARKET << US, 9998, 1, 672100)
(AMETHYSTS, MARKET << US, 9998, 1, 672100)","{""AMETHYSTS"": -4, ""STARFRUIT"": 15}",4394,5066,10001
672400,-5064,-36656,"(STARFRUIT, US << MARKET, 5064, 1, 672400)","{""AMETHYSTS"": -4, ""STARFRUIT"": 16}",4348,5063,10001
672600,9998,-26658,"(AMETHYSTS, US << MARKET, 9998, 1, 672600)
(AMETHYSTS, US << MARKET, 9998, 1, 672600)
(AMETHYSTS, MARKET << US, 9998, 1, 672600)
(AMETHYSTS, MARKET << US, 9998, 1, 672600)
(AMETHYSTS, MARKET << US, 9998, 1, 672600)","{""AMETHYSTS"": -5, ""STARFRUIT"": 16}",4434,5067,9996
672700,25345,-1313,"(STARFRUIT, US << MARKET, 5063, 1, 672700)
(STARFRUIT, MARKET << US, 5068, 1, 672700)
(STARFRUIT, MARKET << US, 5068, 1, 672700)
(STARFRUIT, MARKET << US, 5068, 1, 672700)
(STARFRUIT, MARKET << US, 5068, 1, 672700)
(STARFRUIT, MARKET << US, 5068, 1, 672700)
(STARFRUIT, MARKET << US, 5068, 1, 672700)","{""AMETHYSTS"": -5, ""STARFRUIT"": 11}",4446,5069,10000
672900,-10002,-11315,"(AMETHYSTS, US << MARKET, 10002, 1, 672900)","{""AMETHYSTS"": -4, ""STARFRUIT"": 11}",4410,5067,10003
673100,-5063,-16378,"(STARFRUIT, US << MARKET, 5063, 1, 673100)","{""AMETHYSTS"": -4, ""STARFRUIT"": 12}",4414,5066,10000
673300,9998,-6380,"(AMETHYSTS, MARKET << US, 9998, 1, 673300)","{""AMETHYSTS"": -5, ""STARFRUIT"": 12}",4432,5066,9996
673700,29994,23614,"(AMETHYSTS, MARKET << US, 9998, 1, 673700)
(AMETHYSTS, MARKET << US, 9998, 1, 673700)
(AMETHYSTS, MARKET << US, 9998, 1, 673700)","{""AMETHYSTS"": -8, ""STARFRUIT"": 12}",4430,5066,9997
673800,15192,38806,"(STARFRUIT, MARKET << US, 5064, 1, 673800)
(STARFRUIT, MARKET << US, 5064, 1, 673800)
(STARFRUIT, MARKET << US, 5064, 1, 673800)","{""AMETHYSTS"": -8, ""STARFRUIT"": 9}",4349,5063,10003
675200,-5064,33742,"(STARFRUIT, US << MARKET, 5064, 1, 675200)","{""AMETHYSTS"": -8, ""STARFRUIT"": 10}",4412,5067,10000
675300,-39992,-6250,"(AMETHYSTS, US << MARKET, 9998, 1, 675300)
(AMETHYSTS, US << MARKET, 9998, 1, 675300)
(AMETHYSTS, US << MARKET, 9998, 1, 675300)
(AMETHYSTS, US << MARKET, 9998, 1, 675300)","{""AMETHYSTS"": -4, ""STARFRUIT"": 10}",4406,5066,10001
675500,-39992,-46242,"(AMETHYSTS, US << MARKET, 9998, 1, 675500)
(AMETHYSTS, US << MARKET, 9998, 1, 675500)
(AMETHYSTS, US << MARKET, 9998, 1, 675500)
(AMETHYSTS, US << MARKET, 9998, 1, 675500)","{""AMETHYSTS"": 0, ""STARFRUIT"": 10}",4418,5066,10001
675700,30414,-15828,"(STARFRUIT, MARKET << US, 5069, 1, 675700)
(STARFRUIT, MARKET << US, 5069, 1, 675700)
(STARFRUIT, MARKET << US, 5069, 1, 675700)
(STARFRUIT, MARKET << US, 5069, 1, 675700)
(STARFRUIT, MARKET << US, 5069, 1, 675700)
(STARFRUIT, MARKET << US, 5069, 1, 675700)","{""AMETHYSTS"": 0, ""STARFRUIT"": 4}",4436,5066,10000
676400,-10002,-25830,"(AMETHYSTS, US << MARKET, 10002, 1, 676400)","{""AMETHYSTS"": 1, ""STARFRUIT"": 4}",4445,5068,10003
676900,-10142,-35972,"(STARFRUIT, US << MARKET, 5071, 1, 676900)
(STARFRUIT, US << MARKET, 5071, 1, 676900)","{""AMETHYSTS"": 1, ""STARFRUIT"": 6}",4434,5068,9998
677100,-100020,-135992,"(AMETHYSTS, US << MARKET, 10002, 1, 677100)
(AMETHYSTS, US << MARKET, 10002, 1, 677100)
(AMETHYSTS, US << MARKET, 10002, 1, 677100)
(AMETHYSTS, US << MARKET, 10002, 1, 677100)
(AMETHYSTS, US << MARKET, 10002, 1, 677100)
(AMETHYSTS, US << MARKET, 10002, 1, 677100)
(AMETHYSTS, US << MARKET, 10002, 1, 677100)
(AMETHYSTS, US << MARKET, 10002, 1, 677100)
(AMETHYSTS, US << MARKET, 10002, 1, 677100)
(AMETHYSTS, US << MARKET, 10002, 1, 677100)","{""AMETHYSTS"": 11, ""STARFRUIT"": 6}",4405,5068,9999
677200,20129,-115863,"(AMETHYSTS, MARKET << US, 9998, 1, 677200)
(STARFRUIT, MARKET << US, 5066, 1, 677200)
(STARFRUIT, MARKET << US, 5065, 1, 677200)","{""AMETHYSTS"": 10, ""STARFRUIT"": 4}",4407,5065,10001
677300,-20288,-136151,"(STARFRUIT, US << MARKET, 5072, 1, 677300)
(STARFRUIT, US << MARKET, 5072, 1, 677300)
(STARFRUIT, US << MARKET, 5072, 1, 677300)
(STARFRUIT, US << MARKET, 5072, 1, 677300)","{""AMETHYSTS"": 10, ""STARFRUIT"": 8}",4393,5068,10000
677600,9998,-126153,"(AMETHYSTS, MARKET << US, 9998, 1, 677600)","{""AMETHYSTS"": 9, ""STARFRUIT"": 8}",4364,5068,9997
677800,-20264,-146417,"(STARFRUIT, US << MARKET, 5066, 1, 677800)
(STARFRUIT, US << MARKET, 5066, 1, 677800)
(STARFRUIT, US << MARKET, 5066, 1, 677800)
(STARFRUIT, US << MARKET, 5066, 1, 677800)","{""AMETHYSTS"": 9, ""STARFRUIT"": 12}",4354,5065,9999
677900,5070,-141347,"(STARFRUIT, MARKET << US, 5070, 1, 677900)","{""AMETHYSTS"": 9, ""STARFRUIT"": 11}",4434,5071,10000
678000,-10002,-151349,"(AMETHYSTS, US << MARKET, 10002, 1, 678000)","{""AMETHYSTS"": 10, ""STARFRUIT"": 11}",4429,5068,10003
678200,10136,-141213,"(STARFRUIT, MARKET << US, 5068, 1, 678200)
(STARFRUIT, MARKET << US, 5068, 1, 678200)","{""AMETHYSTS"": 10, ""STARFRUIT"": 9}",4418,5069,10001
679200,9998,-131215,"(AMETHYSTS, MARKET << US, 9998, 1, 679200)","{""AMETHYSTS"": 9, ""STARFRUIT"": 9}",4361,5067,9997
679300,40016,-91199,"(AMETHYSTS, MARKET << US, 10004, 1, 679300)
(AMETHYSTS, MARKET << US, 10004, 1, 679300)
(AMETHYSTS, MARKET << US, 10004, 1, 679300)
(AMETHYSTS, MARKET << US, 10004, 1, 679300)","{""AMETHYSTS"": 5, ""STARFRUIT"": 9}",4409,5067,10001
679600,-30132,-121331,"(AMETHYSTS, US << MARKET, 10002, 1, 679600)
(AMETHYSTS, US << MARKET, 10002, 1, 679600)
(AMETHYSTS, US << MARKET, 10002, 1, 679600)
(AMETHYSTS, US << MARKET, 10002, 1, 679600)
(AMETHYSTS, US << MARKET, 10002, 1, 679600)
(AMETHYSTS, US << MARKET, 10002, 1, 679600)
(AMETHYSTS, MARKET << US, 10002, 1, 679600)
(AMETHYSTS, MARKET << US, 10002, 1, 679600)
(AMETHYSTS, MARKET << US, 10002, 1, 679600)
(AMETHYSTS, MARKET << US, 10002, 1, 679600)
(STARFRUIT, US << MARKET, 5064, 1, 679600)
(STARFRUIT, US << MARKET, 5064, 1, 679600)","{""AMETHYSTS"": 7, ""STARFRUIT"": 11}",4427,5067,10003
679700,-114870,-236201,"(AMETHYSTS, US << MARKET, 9995, 1, 679700)
(AMETHYSTS, US << MARKET, 9995, 1, 679700)
(AMETHYSTS, US << MARKET, 9995, 1, 679700)
(AMETHYSTS, US << MARKET, 9995, 1, 679700)
(AMETHYSTS, US << MARKET, 9995, 1, 679700)
(AMETHYSTS, US << MARKET, 9995, 1, 679700)
(AMETHYSTS, US << MARKET, 9995, 1, 679700)
(AMETHYSTS, US << MARKET, 9995, 1, 679700)
(AMETHYSTS, US << MARKET, 9995, 1, 679700)
(AMETHYSTS, US << MARKET, 9995, 1, 679700)
(AMETHYSTS, US << MARKET, 9995, 1, 679700)
(AMETHYSTS, US << MARKET, 9995, 1, 679700)
(STARFRUIT, MARKET << US, 5070, 1, 679700)","{""AMETHYSTS"": 19, ""STARFRUIT"": 10}",4499,5070,10000
680000,5197,-231004,"(AMETHYSTS, US << MARKET, 9998, 1, 680000)
(STARFRUIT, MARKET << US, 5065, 1, 680000)
(STARFRUIT, MARKET << US, 5065, 1, 680000)
(STARFRUIT, MARKET << US, 5065, 1, 680000)","{""AMETHYSTS"": 20, ""STARFRUIT"": 7}",4364,5064,9996
680200,25076,-205928,"(AMETHYSTS, MARKET << US, 10004, 1, 680200)
(AMETHYSTS, MARKET << US, 10004, 1, 680200)
(STARFRUIT, MARKET << US, 5068, 1, 680200)","{""AMETHYSTS"": 18, ""STARFRUIT"": 6}",4462,5065,10000
680600,10128,-195800,"(STARFRUIT, MARKET << US, 5064, 1, 680600)
(STARFRUIT, MARKET << US, 5064, 1, 680600)","{""AMETHYSTS"": 18, ""STARFRUIT"": 4}",4472,5068,10000
680800,9868,-185932,"(AMETHYSTS, MARKET << US, 10005, 1, 680800)
(AMETHYSTS, MARKET << US, 10005, 1, 680800)
(STARFRUIT, US << MARKET, 5071, 1, 680800)
(STARFRUIT, US << MARKET, 5071, 1, 680800)","{""AMETHYSTS"": 16, ""STARFRUIT"": 6}",4488,5070,10000
681000,-10126,-196058,"(STARFRUIT, US << MARKET, 5063, 1, 681000)
(STARFRUIT, US << MARKET, 5063, 1, 681000)","{""AMETHYSTS"": 16, ""STARFRUIT"": 8}",4518,5066,10003
681500,30366,-165692,"(STARFRUIT, MARKET << US, 5061, 1, 681500)
(STARFRUIT, MARKET << US, 5061, 1, 681500)
(STARFRUIT, MARKET << US, 5061, 1, 681500)
(STARFRUIT, MARKET << US, 5061, 1, 681500)
(STARFRUIT, MARKET << US, 5061, 1, 681500)
(STARFRUIT, MARKET << US, 5061, 1, 681500)","{""AMETHYSTS"": 16, ""STARFRUIT"": 2}",4434,5063,10000
682000,-264,-165956,"(AMETHYSTS, MARKET << US, 9996, 1, 682000)
(AMETHYSTS, MARKET << US, 9996, 1, 682000)
(STARFRUIT, US << MARKET, 5064, 1, 682000)
(STARFRUIT, US << MARKET, 5064, 1, 682000)
(STARFRUIT, US << MARKET, 5064, 1, 682000)
(STARFRUIT, US << MARKET, 5064, 1, 682000)","{""AMETHYSTS"": 14, ""STARFRUIT"": 6}",4446,5067,10000
683000,-30120,-196076,"(AMETHYSTS, US << MARKET, 9998, 1, 683000)
(AMETHYSTS, US << MARKET, 9998, 1, 683000)
(STARFRUIT, US << MARKET, 5062, 1, 683000)
(STARFRUIT, US << MARKET, 5062, 1, 683000)","{""AMETHYSTS"": 16, ""STARFRUIT"": 8}",4460,5065,10001
683700,-5066,-201142,"(STARFRUIT, US << MARKET, 5066, 1, 683700)","{""AMETHYSTS"": 16, ""STARFRUIT"": 9}",4461,5067,10000
683800,25325,-175817,"(STARFRUIT, MARKET << US, 5065, 1, 683800)
(STARFRUIT, MARKET << US, 5065, 1, 683800)
(STARFRUIT, MARKET << US, 5065, 1, 683800)
(STARFRUIT, MARKET << US, 5065, 1, 683800)
(STARFRUIT, MARKET << US, 5065, 1, 683800)","{""AMETHYSTS"": 16, ""STARFRUIT"": 4}",4447,5066,10000
684000,5061,-170756,"(STARFRUIT, MARKET << US, 5061, 1, 684000)","{""AMETHYSTS"": 16, ""STARFRUIT"": 3}",4449,5063,10001
684200,-25325,-196081,"(STARFRUIT, US << MARKET, 5065, 1, 684200)
(STARFRUIT, US << MARKET, 5065, 1, 684200)
(STARFRUIT, US << MARKET, 5065, 1, 684200)
(STARFRUIT, US << MARKET, 5065, 1, 684200)
(STARFRUIT, US << MARKET, 5065, 1, 684200)","{""AMETHYSTS"": 16, ""STARFRUIT"": 8}",4447,5066,10000
684600,-5061,-201142,"(STARFRUIT, US << MARKET, 5061, 1, 684600)","{""AMETHYSTS"": 16, ""STARFRUIT"": 9}",4409,5063,9999
684700,5061,-196081,"(STARFRUIT, MARKET << US, 5061, 1, 684700)","{""AMETHYSTS"": 16, ""STARFRUIT"": 8}",4431,5064,10000
684800,25349,-170732,"(AMETHYSTS, US << MARKET, 9995, 1, 684800)
(AMETHYSTS, US << MARKET, 9995, 1, 684800)
(AMETHYSTS, MARKET << US, 9996, 1, 684800)
(AMETHYSTS, MARKET << US, 9996, 1, 684800)
(STARFRUIT, US << MARKET, 5061, 1, 684800)
(STARFRUIT, MARKET << US, 5068, 1, 684800)
(STARFRUIT, MARKET << US, 5068, 1, 684800)
(STARFRUIT, MARKET << US, 5068, 1, 684800)
(STARFRUIT, MARKET << US, 5068, 1, 684800)
(STARFRUIT, MARKET << US, 5068, 1, 684800)
(STARFRUIT, MARKET << US, 5068, 1, 684800)","{""AMETHYSTS"": 16, ""STARFRUIT"": 3}",4444,5064,9999
685000,-10134,-180866,"(STARFRUIT, US << MARKET, 5067, 1, 685000)
(STARFRUIT, US << MARKET, 5067, 1, 685000)","{""AMETHYSTS"": 16, ""STARFRUIT"": 5}",4449,5063,10000
685200,-10134,-191000,"(STARFRUIT, US << MARKET, 5067, 1, 685200)
(STARFRUIT, US << MARKET, 5067, 1, 685200)","{""AMETHYSTS"": 16, ""STARFRUIT"": 7}",4453,5067,9999
685500,15189,-175811,"(STARFRUIT, MARKET << US, 5063, 1, 685500)
(STARFRUIT, MARKET << US, 5063, 1, 685500)
(STARFRUIT, MARKET << US, 5063, 1, 685500)","{""AMETHYSTS"": 16, ""STARFRUIT"": 4}",4437,5062,10000
685600,5066,-170745,"(STARFRUIT, MARKET << US, 5066, 1, 685600)","{""AMETHYSTS"": 16, ""STARFRUIT"": 3}",4456,5067,10000
686100,-39992,-210737,"(AMETHYSTS, US << MARKET, 9998, 1, 686100)
(AMETHYSTS, US << MARKET, 9998, 1, 686100)
(AMETHYSTS, US << MARKET, 9998, 1, 686100)
(AMETHYSTS, US << MARKET, 9998, 1, 686100)","{""AMETHYSTS"": 20, ""STARFRUIT"": 3}",4395,5064,9997
686400,19992,-190745,"(AMETHYSTS, MARKET << US, 9996, 1, 686400)
(AMETHYSTS, MARKET << US, 9996, 1, 686400)","{""AMETHYSTS"": 18, ""STARFRUIT"": 3}",4408,5063,9998
686700,-10124,-200869,"(STARFRUIT, US << MARKET, 5062, 1, 686700)
(STARFRUIT, US << MARKET, 5062, 1, 686700)","{""AMETHYSTS"": 18, ""STARFRUIT"": 5}",4454,5061,10001
686800,5066,-195803,"(STARFRUIT, MARKET << US, 5066, 1, 686800)","{""AMETHYSTS"": 18, ""STARFRUIT"": 4}",4461,5066,10000
687600,-10136,-205939,"(STARFRUIT, US << MARKET, 5068, 1, 687600)
(STARFRUIT, US << MARKET, 5068, 1, 687600)","{""AMETHYSTS"": 18, ""STARFRUIT"": 6}",4487,5068,10001
687700,15212,-190727,"(STARFRUIT, US << MARKET, 5069, 1, 687700)
(STARFRUIT, US << MARKET, 5069, 1, 687700)
(STARFRUIT, MARKET << US, 5070, 1, 687700)
(STARFRUIT, MARKET << US, 5070, 1, 687700)
(STARFRUIT, MARKET << US, 5070, 1, 687700)
(STARFRUIT, MARKET << US, 5070, 1, 687700)
(STARFRUIT, MARKET << US, 5070, 1, 687700)","{""AMETHYSTS"": 18, ""STARFRUIT"": 3}",4480,5069,10000
687800,15068,-175659,"(AMETHYSTS, MARKET << US, 9998, 1, 687800)
(STARFRUIT, MARKET << US, 5070, 1, 687800)","{""AMETHYSTS"": 17, ""STARFRUIT"": 2}",4407,5067,9996
687900,60012,-115647,"(AMETHYSTS, MARKET << US, 10002, 1, 687900)
(AMETHYSTS, MARKET << US, 10002, 1, 687900)
(AMETHYSTS, MARKET << US, 10002, 1, 687900)
(AMETHYSTS, MARKET << US, 10002, 1, 687900)
(AMETHYSTS, MARKET << US, 10002, 1, 687900)
(AMETHYSTS, MARKET << US, 10002, 1, 687900)","{""AMETHYSTS"": 11, ""STARFRUIT"": 2}",4514,5064,10003
688000,5067,-110580,"(STARFRUIT, MARKET << US, 5067, 1, 688000)","{""AMETHYSTS"": 11, ""STARFRUIT"": 1}",4488,5068,10000
688100,-60024,-170604,"(AMETHYSTS, US << MARKET, 10004, 1, 688100)
(AMETHYSTS, US << MARKET, 10004, 1, 688100)
(AMETHYSTS, US << MARKET, 10004, 1, 688100)
(AMETHYSTS, US << MARKET, 10004, 1, 688100)
(AMETHYSTS, US << MARKET, 10004, 1, 688100)
(AMETHYSTS, US << MARKET, 10004, 1, 688100)
(AMETHYSTS, US << MARKET, 10004, 1, 688100)
(AMETHYSTS, US << MARKET, 10004, 1, 688100)
(AMETHYSTS, MARKET << US, 10004, 1, 688100)
(AMETHYSTS, MARKET << US, 10004, 1, 688100)","{""AMETHYSTS"": 17, ""STARFRUIT"": 1}",4461,5065,10000
688600,-25345,-195949,"(STARFRUIT, US << MARKET, 5069, 1, 688600)
(STARFRUIT, US << MARKET, 5069, 1, 688600)
(STARFRUIT, US << MARKET, 5069, 1, 688600)
(STARFRUIT, US << MARKET, 5069, 1, 688600)
(STARFRUIT, US << MARKET, 5069, 1, 688600)","{""AMETHYSTS"": 17, ""STARFRUIT"": 6}",4447,5066,10000
689300,-20122,-216071,"(AMETHYSTS, US << MARKET, 9996, 1, 689300)
(AMETHYSTS, US << MARKET, 9996, 1, 689300)
(AMETHYSTS, MARKET << US, 9996, 1, 689300)
(STARFRUIT, US << MARKET, 5063, 1, 689300)
(STARFRUIT, US << MARKET, 5063, 1, 689300)","{""AMETHYSTS"": 18, ""STARFRUIT"": 8}",4457,5066,10000
689600,-5064,-221135,"(STARFRUIT, US << MARKET, 5064, 1, 689600)","{""AMETHYSTS"": 18, ""STARFRUIT"": 9}",4432,5063,10000
689700,-10002,-231137,"(AMETHYSTS, US << MARKET, 10002, 1, 689700)","{""AMETHYSTS"": 19, ""STARFRUIT"": 9}",4523,5067,10003
689800,-5064,-236201,"(STARFRUIT, US << MARKET, 5064, 1, 689800)","{""AMETHYSTS"": 19, ""STARFRUIT"": 10}",4459,5066,10000
690100,-9998,-246199,"(AMETHYSTS, US << MARKET, 9998, 1, 690100)","{""AMETHYSTS"": 20, ""STARFRUIT"": 10}",4411,5067,9997
690200,5070,-241129,"(STARFRUIT, MARKET << US, 5070, 1, 690200)","{""AMETHYSTS"": 20, ""STARFRUIT"": 9}",4434,5067,9998
690700,39764,-201365,"(AMETHYSTS, MARKET << US, 10002, 1, 690700)
(AMETHYSTS, MARKET << US, 10002, 1, 690700)
(AMETHYSTS, MARKET << US, 10002, 1, 690700)
(AMETHYSTS, MARKET << US, 10002, 1, 690700)
(AMETHYSTS, MARKET << US, 10002, 1, 690700)
(AMETHYSTS, MARKET << US, 10002, 1, 690700)
(STARFRUIT, US << MARKET, 5062, 1, 690700)
(STARFRUIT, US << MARKET, 5062, 1, 690700)
(STARFRUIT, US << MARKET, 5062, 1, 690700)
(STARFRUIT, US << MARKET, 5062, 1, 690700)","{""AMETHYSTS"": 14, ""STARFRUIT"": 13}",4522,5065,10003
691000,-10278,-211643,"(AMETHYSTS, MARKET << US, 9998, 1, 691000)
(STARFRUIT, US << MARKET, 5069, 1, 691000)
(STARFRUIT, US << MARKET, 5069, 1, 691000)
(STARFRUIT, US << MARKET, 5069, 1, 691000)
(STARFRUIT, US << MARKET, 5069, 1, 691000)","{""AMETHYSTS"": 13, ""STARFRUIT"": 17}",4475,5065,10001
692000,-10143,-221786,"(STARFRUIT, US << MARKET, 5068, 1, 692000)
(STARFRUIT, US << MARKET, 5068, 1, 692000)
(STARFRUIT, US << MARKET, 5068, 1, 692000)
(STARFRUIT, MARKET << US, 5061, 1, 692000)","{""AMETHYSTS"": 13, ""STARFRUIT"": 19}",4430,5064,10000
692100,14931,-206855,"(AMETHYSTS, MARKET << US, 9996, 1, 692100)
(AMETHYSTS, MARKET << US, 9996, 1, 692100)
(STARFRUIT, US << MARKET, 5061, 1, 692100)","{""AMETHYSTS"": 11, ""STARFRUIT"": 20}",4405,5063,10000
692200,15466,-191389,"(AMETHYSTS, US << MARKET, 9998, 1, 692200)
(AMETHYSTS, US << MARKET, 9998, 1, 692200)
(STARFRUIT, MARKET << US, 5066, 1, 692200)
(STARFRUIT, MARKET << US, 5066, 1, 692200)
(STARFRUIT, MARKET << US, 5066, 1, 692200)
(STARFRUIT, MARKET << US, 5066, 1, 692200)
(STARFRUIT, MARKET << US, 5066, 1, 692200)
(STARFRUIT, MARKET << US, 5066, 1, 692200)
(STARFRUIT, MARKET << US, 5066, 1, 692200)","{""AMETHYSTS"": 13, ""STARFRUIT"": 13}",4378,5063,9996
692900,-5067,-196456,"(STARFRUIT, US << MARKET, 5067, 1, 692900)","{""AMETHYSTS"": 13, ""STARFRUIT"": 14}",4398,5061,10000
693100,-5066,-201522,"(STARFRUIT, US << MARKET, 5066, 1, 693100)","{""AMETHYSTS"": 13, ""STARFRUIT"": 15}",4483,5067,10000
693200,-54908,-256430,"(AMETHYSTS, US << MARKET, 9995, 1, 693200)
(AMETHYSTS, US << MARKET, 9995, 1, 693200)
(AMETHYSTS, US << MARKET, 9995, 1, 693200)
(AMETHYSTS, US << MARKET, 9995, 1, 693200)
(AMETHYSTS, US << MARKET, 9995, 1, 693200)
(AMETHYSTS, US << MARKET, 9995, 1, 693200)
(STARFRUIT, MARKET << US, 5062, 1, 693200)","{""AMETHYSTS"": 19, ""STARFRUIT"": 14}",4442,5065,9998
694200,-5059,-261489,"(STARFRUIT, US << MARKET, 5059, 1, 694200)","{""AMETHYSTS"": 19, ""STARFRUIT"": 15}",4441,5062,10000
694800,5064,-256425,"(STARFRUIT, MARKET << US, 5064, 1, 694800)","{""AMETHYSTS"": 19, ""STARFRUIT"": 14}",4377,5060,9998
694900,-5059,-261484,"(STARFRUIT, US << MARKET, 5059, 1, 694900)","{""AMETHYSTS"": 19, ""STARFRUIT"": 15}",4431,5061,10000
695200,10004,-251480,"(AMETHYSTS, US << MARKET, 10004, 1, 695200)
(AMETHYSTS, MARKET << US, 10004, 1, 695200)
(AMETHYSTS, MARKET << US, 10004, 1, 695200)","{""AMETHYSTS"": 18, ""STARFRUIT"": 15}",4450,5062,10000
695300,5059,-246421,"(STARFRUIT, MARKET << US, 5059, 1, 695300)","{""AMETHYSTS"": 18, ""STARFRUIT"": 14}",4425,5063,9998
695600,20008,-226413,"(AMETHYSTS, MARKET << US, 10004, 1, 695600)
(AMETHYSTS, MARKET << US, 10004, 1, 695600)","{""AMETHYSTS"": 16, ""STARFRUIT"": 14}",4441,5061,10000
696100,20004,-206409,"(AMETHYSTS, MARKET << US, 10002, 1, 696100)
(AMETHYSTS, MARKET << US, 10002, 1, 696100)","{""AMETHYSTS"": 14, ""STARFRUIT"": 14}",4501,5062,10003
696600,-20236,-226645,"(STARFRUIT, US << MARKET, 5059, 1, 696600)
(STARFRUIT, US << MARKET, 5059, 1, 696600)
(STARFRUIT, US << MARKET, 5059, 1, 696600)
(STARFRUIT, US << MARKET, 5059, 1, 696600)","{""AMETHYSTS"": 14, ""STARFRUIT"": 18}",4471,5062,10000
697100,45594,-181051,"(STARFRUIT, MARKET << US, 5066, 1, 697100)
(STARFRUIT, MARKET << US, 5066, 1, 697100)
(STARFRUIT, MARKET << US, 5066, 1, 697100)
(STARFRUIT, MARKET << US, 5066, 1, 697100)
(STARFRUIT, MARKET << US, 5066, 1, 697100)
(STARFRUIT, MARKET << US, 5066, 1, 697100)
(STARFRUIT, MARKET << US, 5066, 1, 697100)
(STARFRUIT, MARKET << US, 5066, 1, 697100)
(STARFRUIT, MARKET << US, 5066, 1, 697100)","{""AMETHYSTS"": 14, ""STARFRUIT"": 9}",4511,5064,9999
697400,-19996,-201047,"(AMETHYSTS, US << MARKET, 9998, 1, 697400)
(AMETHYSTS, US << MARKET, 9998, 1, 697400)","{""AMETHYSTS"": 16, ""STARFRUIT"": 9}",4518,5061,10001
697600,30366,-170681,"(STARFRUIT, MARKET << US, 5061, 1, 697600)
(STARFRUIT, MARKET << US, 5061, 1, 697600)
(STARFRUIT, MARKET << US, 5061, 1, 697600)
(STARFRUIT, MARKET << US, 5061, 1, 697600)
(STARFRUIT, MARKET << US, 5061, 1, 697600)
(STARFRUIT, MARKET << US, 5061, 1, 697600)","{""AMETHYSTS"": 16, ""STARFRUIT"": 3}",4499,5060,10000
697700,20004,-150677,"(AMETHYSTS, MARKET << US, 10002, 1, 697700)
(AMETHYSTS, MARKET << US, 10002, 1, 697700)","{""AMETHYSTS"": 14, ""STARFRUIT"": 3}",4551,5062,10003
697800,9998,-140679,"(AMETHYSTS, MARKET << US, 9998, 1, 697800)","{""AMETHYSTS"": 13, ""STARFRUIT"": 3}",4520,5062,10001
698300,25073,-115606,"(AMETHYSTS, MARKET << US, 10004, 1, 698300)
(AMETHYSTS, MARKET << US, 10004, 1, 698300)
(STARFRUIT, MARKET << US, 5065, 1, 698300)","{""AMETHYSTS"": 11, ""STARFRUIT"": 2}",4522,5064,10000
698400,-40124,-155730,"(AMETHYSTS, US << MARKET, 10002, 1, 698400)
(AMETHYSTS, US << MARKET, 10002, 1, 698400)
(AMETHYSTS, US << MARKET, 10002, 1, 698400)
(STARFRUIT, US << MARKET, 5059, 1, 698400)
(STARFRUIT, US << MARKET, 5059, 1, 698400)","{""AMETHYSTS"": 14, ""STARFRUIT"": 4}",4560,5062,10003
698500,-49990,-205720,"(AMETHYSTS, US << MARKET, 9998, 1, 698500)
(AMETHYSTS, US << MARKET, 9998, 1, 698500)
(AMETHYSTS, US << MARKET, 9998, 1, 698500)
(AMETHYSTS, US << MARKET, 9998, 1, 698500)
(AMETHYSTS, US << MARKET, 9998, 1, 698500)","{""AMETHYSTS"": 19, ""STARFRUIT"": 4}",4479,5064,9997
698700,-10002,-215722,"(AMETHYSTS, US << MARKET, 10002, 1, 698700)","{""AMETHYSTS"": 20, ""STARFRUIT"": 4}",4554,5064,10001
698900,-132,-215854,"(AMETHYSTS, MARKET << US, 9996, 1, 698900)
(STARFRUIT, US << MARKET, 5064, 1, 698900)
(STARFRUIT, US << MARKET, 5064, 1, 698900)","{""AMETHYSTS"": 19, ""STARFRUIT"": 6}",4530,5064,10000
699100,20232,-195622,"(STARFRUIT, MARKET << US, 5058, 1, 699100)
(STARFRUIT, MARKET << US, 5058, 1, 699100)
(STARFRUIT, MARKET << US, 5058, 1, 699100)
(STARFRUIT, MARKET << US, 5058, 1, 699100)","{""AMETHYSTS"": 19, ""STARFRUIT"": 2}",4494,5058,10000
699300,20004,-175618,"(AMETHYSTS, MARKET << US, 10002, 1, 699300)
(AMETHYSTS, MARKET << US, 10002, 1, 699300)","{""AMETHYSTS"": 17, ""STARFRUIT"": 2}",4504,5061,10000
699800,15186,-160432,"(STARFRUIT, MARKET << US, 5062, 1, 699800)
(STARFRUIT, MARKET << US, 5062, 1, 699800)
(STARFRUIT, MARKET << US, 5062, 1, 699800)","{""AMETHYSTS"": 17, ""STARFRUIT"": -1}",4505,5063,10000
700500,-4941,-165373,"(AMETHYSTS, US << MARKET, 10004, 1, 700500)
(STARFRUIT, MARKET << US, 5063, 1, 700500)","{""AMETHYSTS"": 18, ""STARFRUIT"": -2}",4507,5060,10000
700700,20126,-145247,"(AMETHYSTS, US << MARKET, 10000, 1, 700700)
(AMETHYSTS, MARKET << US, 10002, 1, 700700)
(AMETHYSTS, MARKET << US, 10002, 1, 700700)
(STARFRUIT, MARKET << US, 5061, 1, 700700)
(STARFRUIT, MARKET << US, 5061, 1, 700700)","{""AMETHYSTS"": 17, ""STARFRUIT"": -4}",4462,5060,9997
700900,-35441,-180688,"(STARFRUIT, US << MARKET, 5063, 1, 700900)
(STARFRUIT, US << MARKET, 5063, 1, 700900)
(STARFRUIT, US << MARKET, 5063, 1, 700900)
(STARFRUIT, US << MARKET, 5063, 1, 700900)
(STARFRUIT, US << MARKET, 5063, 1, 700900)
(STARFRUIT, US << MARKET, 5063, 1, 700900)
(STARFRUIT, US << MARKET, 5063, 1, 700900)","{""AMETHYSTS"": 17, ""STARFRUIT"": 3}",4470,5064,9998
701100,80010,-100678,"(AMETHYSTS, US << MARKET, 10005, 1, 701100)
(AMETHYSTS, US << MARKET, 10005, 1, 701100)
(AMETHYSTS, MARKET << US, 10002, 1, 701100)
(AMETHYSTS, MARKET << US, 10002, 1, 701100)
(AMETHYSTS, MARKET << US, 10002, 1, 701100)
(AMETHYSTS, MARKET << US, 10002, 1, 701100)
(AMETHYSTS, MARKET << US, 10002, 1, 701100)
(AMETHYSTS, MARKET << US, 10002, 1, 701100)
(AMETHYSTS, MARKET << US, 10002, 1, 701100)
(AMETHYSTS, MARKET << US, 10002, 1, 701100)
(AMETHYSTS, MARKET << US, 10002, 1, 701100)
(AMETHYSTS, MARKET << US, 10002, 1, 701100)","{""AMETHYSTS"": 9, ""STARFRUIT"": 3}",4532,5061,10003
701500,-50096,-150774,"(AMETHYSTS, US << MARKET, 9995, 1, 701500)
(AMETHYSTS, US << MARKET, 9995, 1, 701500)
(AMETHYSTS, US << MARKET, 9995, 1, 701500)
(AMETHYSTS, US << MARKET, 9995, 1, 701500)
(STARFRUIT, US << MARKET, 5058, 1, 701500)
(STARFRUIT, US << MARKET, 5058, 1, 701500)
(STARFRUIT, US << MARKET, 5059, 1, 701500)
(STARFRUIT, MARKET << US, 5059, 1, 701500)","{""AMETHYSTS"": 13, ""STARFRUIT"": 5}",4536,5062,10000
701700,-10118,-160892,"(STARFRUIT, US << MARKET, 5059, 1, 701700)
(STARFRUIT, US << MARKET, 5059, 1, 701700)","{""AMETHYSTS"": 13, ""STARFRUIT"": 7}",4514,5058,10000
701900,25073,-135819,"(AMETHYSTS, MARKET << US, 10004, 1, 701900)
(AMETHYSTS, MARKET << US, 10004, 1, 701900)
(STARFRUIT, MARKET << US, 5065, 1, 701900)","{""AMETHYSTS"": 11, ""STARFRUIT"": 6}",4553,5062,10000
702000,15197,-120622,"(STARFRUIT, US << MARKET, 5064, 1, 702000)
(STARFRUIT, US << MARKET, 5064, 1, 702000)
(STARFRUIT, MARKET << US, 5065, 1, 702000)
(STARFRUIT, MARKET << US, 5065, 1, 702000)
(STARFRUIT, MARKET << US, 5065, 1, 702000)
(STARFRUIT, MARKET << US, 5065, 1, 702000)
(STARFRUIT, MARKET << US, 5065, 1, 702000)","{""AMETHYSTS"": 11, ""STARFRUIT"": 3}",4570,5064,10000
702100,5058,-115564,"(STARFRUIT, MARKET << US, 5058, 1, 702100)","{""AMETHYSTS"": 11, ""STARFRUIT"": 2}",4536,5061,9998
702200,14726,-100838,"(AMETHYSTS, MARKET << US, 10004, 1, 702200)
(AMETHYSTS, MARKET << US, 10004, 1, 702200)
(AMETHYSTS, MARKET << US, 10004, 1, 702200)
(AMETHYSTS, MARKET << US, 10004, 1, 702200)
(STARFRUIT, US << MARKET, 5058, 1, 702200)
(STARFRUIT, US << MARKET, 5058, 1, 702200)
(STARFRUIT, US << MARKET, 5058, 1, 702200)
(STARFRUIT, US << MARKET, 5058, 1, 702200)
(STARFRUIT, US << MARKET, 5058, 1, 702200)","{""AMETHYSTS"": 7, ""STARFRUIT"": 7}",4596,5061,10001
702300,160080,59242,"(AMETHYSTS, MARKET << US, 10005, 1, 702300)
(AMETHYSTS, MARKET << US, 10005, 1, 702300)
(AMETHYSTS, MARKET << US, 10005, 1, 702300)
(AMETHYSTS, MARKET << US, 10005, 1, 702300)
(AMETHYSTS, MARKET << US, 10005, 1, 702300)
(AMETHYSTS, MARKET << US, 10005, 1, 702300)
(AMETHYSTS, MARKET << US, 10005, 1, 702300)
(AMETHYSTS, MARKET << US, 10005, 1, 702300)
(AMETHYSTS, MARKET << US, 10005, 1, 702300)
(AMETHYSTS, MARKET << US, 10005, 1, 702300)
(AMETHYSTS, MARKET << US, 10005, 1, 702300)
(AMETHYSTS, MARKET << US, 10005, 1, 702300)
(AMETHYSTS, MARKET << US, 10005, 1, 702300)
(AMETHYSTS, MARKET << US, 10005, 1, 702300)
(AMETHYSTS, MARKET << US, 10005, 1, 702300)
(AMETHYSTS, MARKET << US, 10005, 1, 702300)","{""AMETHYSTS"": -9, ""STARFRUIT"": 7}",4635,5060,10003
702900,-5059,54183,"(STARFRUIT, US << MARKET, 5059, 1, 702900)","{""AMETHYSTS"": -9, ""STARFRUIT"": 8}",4652,5062,10003
703000,-20256,33927,"(STARFRUIT, US << MARKET, 5064, 1, 703000)
(STARFRUIT, US << MARKET, 5064, 1, 703000)
(STARFRUIT, US << MARKET, 5064, 1, 703000)
(STARFRUIT, US << MARKET, 5064, 1, 703000)","{""AMETHYSTS"": -9, ""STARFRUIT"": 12}",4698,5065,10001
703300,-10104,23823,"(AMETHYSTS, US << MARKET, 9996, 1, 703300)
(AMETHYSTS, US << MARKET, 9996, 1, 703300)
(AMETHYSTS, MARKET << US, 10002, 1, 703300)
(AMETHYSTS, MARKET << US, 10002, 1, 703300)
(STARFRUIT, US << MARKET, 5058, 1, 703300)
(STARFRUIT, US << MARKET, 5058, 1, 703300)","{""AMETHYSTS"": -9, ""STARFRUIT"": 14}",4686,5061,9999
703400,5063,28886,"(STARFRUIT, MARKET << US, 5063, 1, 703400)","{""AMETHYSTS"": -9, ""STARFRUIT"": 13}",4727,5064,9999
703500,19996,48882,"(AMETHYSTS, MARKET << US, 9998, 1, 703500)
(AMETHYSTS, MARKET << US, 9998, 1, 703500)","{""AMETHYSTS"": -11, ""STARFRUIT"": 13}",4747,5064,9997
703600,5058,53940,"(STARFRUIT, MARKET << US, 5058, 1, 703600)","{""AMETHYSTS"": -11, ""STARFRUIT"": 12}",4672,5061,10000
704100,-74919,-20979,"(AMETHYSTS, US << MARKET, 9998, 1, 704100)
(AMETHYSTS, US << MARKET, 9998, 1, 704100)
(AMETHYSTS, US << MARKET, 9998, 1, 704100)
(AMETHYSTS, US << MARKET, 9998, 1, 704100)
(AMETHYSTS, US << MARKET, 9998, 1, 704100)
(AMETHYSTS, US << MARKET, 9998, 1, 704100)
(AMETHYSTS, US << MARKET, 9998, 1, 704100)
(AMETHYSTS, US << MARKET, 9998, 1, 704100)
(STARFRUIT, MARKET << US, 5065, 1, 704100)","{""AMETHYSTS"": -3, ""STARFRUIT"": 11}",4745,5065,9997
704500,-5060,-26039,"(STARFRUIT, US << MARKET, 5060, 1, 704500)","{""AMETHYSTS"": -3, ""STARFRUIT"": 12}",4714,5063,10001
704600,-39984,-66023,"(AMETHYSTS, US << MARKET, 9996, 1, 704600)
(AMETHYSTS, US << MARKET, 9996, 1, 704600)
(AMETHYSTS, US << MARKET, 9996, 1, 704600)
(AMETHYSTS, US << MARKET, 9996, 1, 704600)
(AMETHYSTS, US << MARKET, 9996, 1, 704600)
(AMETHYSTS, US << MARKET, 9996, 1, 704600)
(AMETHYSTS, MARKET << US, 9996, 1, 704600)
(AMETHYSTS, MARKET << US, 9996, 1, 704600)","{""AMETHYSTS"": 1, ""STARFRUIT"": 12}",4732,5063,9999
705100,5061,-60962,"(STARFRUIT, MARKET << US, 5061, 1, 705100)","{""AMETHYSTS"": 1, ""STARFRUIT"": 11}",4698,5060,10000
705200,-20264,-81226,"(STARFRUIT, US << MARKET, 5066, 1, 705200)
(STARFRUIT, US << MARKET, 5066, 1, 705200)
(STARFRUIT, US << MARKET, 5066, 1, 705200)
(STARFRUIT, US << MARKET, 5066, 1, 705200)","{""AMETHYSTS"": 1, ""STARFRUIT"": 15}",4702,5062,9998
705300,-99980,-181206,"(AMETHYSTS, US << MARKET, 9998, 1, 705300)
(AMETHYSTS, US << MARKET, 9998, 1, 705300)
(AMETHYSTS, US << MARKET, 9998, 1, 705300)
(AMETHYSTS, US << MARKET, 9998, 1, 705300)
(AMETHYSTS, US << MARKET, 9998, 1, 705300)
(AMETHYSTS, US << MARKET, 9998, 1, 705300)
(AMETHYSTS, US << MARKET, 9998, 1, 705300)
(AMETHYSTS, US << MARKET, 9998, 1, 705300)
(AMETHYSTS, US << MARKET, 9998, 1, 705300)
(AMETHYSTS, US << MARKET, 9998, 1, 705300)","{""AMETHYSTS"": 11, ""STARFRUIT"": 15}",4680,5062,9996
705600,15069,-166137,"(AMETHYSTS, US << MARKET, 10005, 1, 705600)
(AMETHYSTS, MARKET << US, 10004, 1, 705600)
(AMETHYSTS, MARKET << US, 10004, 1, 705600)
(STARFRUIT, MARKET << US, 5066, 1, 705600)","{""AMETHYSTS"": 10, ""STARFRUIT"": 14}",4755,5063,10001
706100,50152,-115985,"(AMETHYSTS, MARKET << US, 10005, 1, 706100)
(AMETHYSTS, MARKET << US, 10005, 1, 706100)
(AMETHYSTS, MARKET << US, 10005, 1, 706100)
(AMETHYSTS, MARKET << US, 10005, 1, 706100)
(STARFRUIT, MARKET << US, 5066, 1, 706100)
(STARFRUIT, MARKET << US, 5066, 1, 706100)","{""AMETHYSTS"": 6, ""STARFRUIT"": 12}",4759,5062,10000
706200,-15189,-131174,"(STARFRUIT, US << MARKET, 5063, 1, 706200)
(STARFRUIT, US << MARKET, 5063, 1, 706200)
(STARFRUIT, US << MARKET, 5063, 1, 706200)","{""AMETHYSTS"": 6, ""STARFRUIT"": 15}",4795,5065,9999
706300,4938,-126236,"(AMETHYSTS, MARKET << US, 9998, 1, 706300)
(STARFRUIT, US << MARKET, 5060, 1, 706300)","{""AMETHYSTS"": 5, ""STARFRUIT"": 16}",4761,5062,10001
706900,25305,-100931,"(STARFRUIT, MARKET << US, 5061, 1, 706900)
(STARFRUIT, MARKET << US, 5061, 1, 706900)
(STARFRUIT, MARKET << US, 5061, 1, 706900)
(STARFRUIT, MARKET << US, 5061, 1, 706900)
(STARFRUIT, MARKET << US, 5061, 1, 706900)","{""AMETHYSTS"": 5, ""STARFRUIT"": 11}",4713,5059,9999
707300,-19996,-120927,"(AMETHYSTS, US << MARKET, 9998, 1, 707300)
(AMETHYSTS, US << MARKET, 9998, 1, 707300)","{""AMETHYSTS"": 7, ""STARFRUIT"": 11}",4712,5060,9997
707800,-20260,-141187,"(STARFRUIT, US << MARKET, 5065, 1, 707800)
(STARFRUIT, US << MARKET, 5065, 1, 707800)
(STARFRUIT, US << MARKET, 5065, 1, 707800)
(STARFRUIT, US << MARKET, 5065, 1, 707800)","{""AMETHYSTS"": 7, ""STARFRUIT"": 15}",4728,5061,10000
708200,-9882,-151069,"(AMETHYSTS, US << MARKET, 10005, 1, 708200)
(AMETHYSTS, US << MARKET, 10005, 1, 708200)
(STARFRUIT, MARKET << US, 5064, 1, 708200)
(STARFRUIT, MARKET << US, 5064, 1, 708200)","{""AMETHYSTS"": 9, ""STARFRUIT"": 13}",4711,5060,10000
708300,35448,-115621,"(STARFRUIT, MARKET << US, 5064, 1, 708300)
(STARFRUIT, MARKET << US, 5064, 1, 708300)
(STARFRUIT, MARKET << US, 5064, 1, 708300)
(STARFRUIT, MARKET << US, 5064, 1, 708300)
(STARFRUIT, MARKET << US, 5064, 1, 708300)
(STARFRUIT, MARKET << US, 5064, 1, 708300)
(STARFRUIT, MARKET << US, 5064, 1, 708300)","{""AMETHYSTS"": 9, ""STARFRUIT"": 6}",4739,5060,10000
708400,-10114,-125735,"(STARFRUIT, US << MARKET, 5057, 1, 708400)
(STARFRUIT, US << MARKET, 5057, 1, 708400)","{""AMETHYSTS"": 9, ""STARFRUIT"": 8}",4737,5059,10000
708600,100020,-25715,"(AMETHYSTS, MARKET << US, 10002, 1, 708600)
(AMETHYSTS, MARKET << US, 10002, 1, 708600)
(AMETHYSTS, MARKET << US, 10002, 1, 708600)
(AMETHYSTS, MARKET << US, 10002, 1, 708600)
(AMETHYSTS, MARKET << US, 10002, 1, 708600)
(AMETHYSTS, MARKET << US, 10002, 1, 708600)
(AMETHYSTS, MARKET << US, 10002, 1, 708600)
(AMETHYSTS, MARKET << US, 10002, 1, 708600)
(AMETHYSTS, MARKET << US, 10002, 1, 708600)
(AMETHYSTS, MARKET << US, 10002, 1, 708600)","{""AMETHYSTS"": -1, ""STARFRUIT"": 8}",4760,5059,9997
708900,-10004,-35719,"(AMETHYSTS, US << MARKET, 10004, 1, 708900)","{""AMETHYSTS"": 0, ""STARFRUIT"": 8}",4785,5063,10000
709100,-10002,-45721,"(AMETHYSTS, US << MARKET, 10002, 1, 709100)","{""AMETHYSTS"": 1, ""STARFRUIT"": 8}",4766,5061,9999
709300,20236,-25485,"(STARFRUIT, MARKET << US, 5059, 1, 709300)
(STARFRUIT, MARKET << US, 5059, 1, 709300)
(STARFRUIT, MARKET << US, 5059, 1, 709300)
(STARFRUIT, MARKET << US, 5059, 1, 709300)","{""AMETHYSTS"": 1, ""STARFRUIT"": 4}",4763,5062,10000
710300,-20004,-45489,"(AMETHYSTS, US << MARKET, 10002, 1, 710300)
(AMETHYSTS, US << MARKET, 10002, 1, 710300)","{""AMETHYSTS"": 3, ""STARFRUIT"": 4}",4776,5064,10003
710400,5062,-40427,"(STARFRUIT, MARKET << US, 5062, 1, 710400)","{""AMETHYSTS"": 3, ""STARFRUIT"": 3}",4768,5064,10001
710900,-35212,-75639,"(AMETHYSTS, US << MARKET, 10004, 1, 710900)
(AMETHYSTS, US << MARKET, 10004, 1, 710900)
(STARFRUIT, US << MARKET, 5068, 1, 710900)
(STARFRUIT, US << MARKET, 5068, 1, 710900)
(STARFRUIT, US << MARKET, 5068, 1, 710900)","{""AMETHYSTS"": 5, ""STARFRUIT"": 6}",4756,5065,10001
711900,4806,-70833,"(AMETHYSTS, MARKET << US, 10002, 1, 711900)
(AMETHYSTS, MARKET << US, 10002, 1, 711900)
(STARFRUIT, US << MARKET, 5066, 1, 711900)
(STARFRUIT, US << MARKET, 5066, 1, 711900)
(STARFRUIT, US << MARKET, 5066, 1, 711900)","{""AMETHYSTS"": 3, ""STARFRUIT"": 9}",4737,5064,9998
712000,-20124,-90957,"(AMETHYSTS, US << MARKET, 9996, 1, 712000)
(AMETHYSTS, US << MARKET, 9996, 1, 712000)
(AMETHYSTS, MARKET << US, 9996, 1, 712000)
(STARFRUIT, US << MARKET, 5064, 1, 712000)
(STARFRUIT, US << MARKET, 5064, 1, 712000)","{""AMETHYSTS"": 4, ""STARFRUIT"": 11}",4769,5066,10000
712100,-5068,-96025,"(STARFRUIT, US << MARKET, 5068, 1, 712100)","{""AMETHYSTS"": 4, ""STARFRUIT"": 12}",4803,5069,10000
712300,5065,-90960,"(STARFRUIT, MARKET << US, 5065, 1, 712300)","{""AMETHYSTS"": 4, ""STARFRUIT"": 11}",4777,5067,10000
712400,-19996,-110956,"(AMETHYSTS, US << MARKET, 9998, 1, 712400)
(AMETHYSTS, US << MARKET, 9998, 1, 712400)","{""AMETHYSTS"": 6, ""STARFRUIT"": 11}",4763,5067,9997
712700,29994,-80962,"(AMETHYSTS, MARKET << US, 9998, 1, 712700)
(AMETHYSTS, MARKET << US, 9998, 1, 712700)
(AMETHYSTS, MARKET << US, 9998, 1, 712700)","{""AMETHYSTS"": 3, ""STARFRUIT"": 11}",4777,5068,9997
713000,5065,-75897,"(STARFRUIT, MARKET << US, 5065, 1, 713000)","{""AMETHYSTS"": 3, ""STARFRUIT"": 10}",4737,5064,9998
713100,20264,-55633,"(STARFRUIT, MARKET << US, 5066, 1, 713100)
(STARFRUIT, MARKET << US, 5066, 1, 713100)
(STARFRUIT, MARKET << US, 5066, 1, 713100)
(STARFRUIT, MARKET << US, 5066, 1, 713100)","{""AMETHYSTS"": 3, ""STARFRUIT"": 6}",4757,5065,10000
713300,-20146,-75779,"(AMETHYSTS, US << MARKET, 10004, 1, 713300)
(STARFRUIT, US << MARKET, 5071, 1, 713300)
(STARFRUIT, US << MARKET, 5071, 1, 713300)","{""AMETHYSTS"": 4, ""STARFRUIT"": 8}",4777,5068,10003
713400,-10002,-85781,"(AMETHYSTS, US << MARKET, 10002, 1, 713400)","{""AMETHYSTS"": 5, ""STARFRUIT"": 8}",4778,5068,10003
713500,-5066,-90847,"(STARFRUIT, US << MARKET, 5066, 1, 713500)","{""AMETHYSTS"": 5, ""STARFRUIT"": 9}",4765,5068,10000
713600,5071,-85776,"(STARFRUIT, MARKET << US, 5071, 1, 713600)","{""AMETHYSTS"": 5, ""STARFRUIT"": 8}",4792,5071,10000
713900,10130,-75646,"(STARFRUIT, MARKET << US, 5065, 1, 713900)
(STARFRUIT, MARKET << US, 5065, 1, 713900)","{""AMETHYSTS"": 5, ""STARFRUIT"": 6}",4753,5064,10003
714000,-10002,-85648,"(AMETHYSTS, US << MARKET, 10002, 1, 714000)","{""AMETHYSTS"": 6, ""STARFRUIT"": 6}",4772,5067,10003
714300,-10130,-95778,"(STARFRUIT, US << MARKET, 5065, 1, 714300)
(STARFRUIT, US << MARKET, 5065, 1, 714300)","{""AMETHYSTS"": 6, ""STARFRUIT"": 8}",4746,5067,9998
714400,-5065,-100843,"(STARFRUIT, US << MARKET, 5065, 1, 714400)","{""AMETHYSTS"": 6, ""STARFRUIT"": 9}",4763,5068,9999
714800,-5070,-105913,"(STARFRUIT, US << MARKET, 5070, 1, 714800)","{""AMETHYSTS"": 6, ""STARFRUIT"": 10}",4787,5070,10000
714900,120024,14111,"(AMETHYSTS, MARKET << US, 10002, 1, 714900)
(AMETHYSTS, MARKET << US, 10002, 1, 714900)
(AMETHYSTS, MARKET << US, 10002, 1, 714900)
(AMETHYSTS, MARKET << US, 10002, 1, 714900)
(AMETHYSTS, MARKET << US, 10002, 1, 714900)
(AMETHYSTS, MARKET << US, 10002, 1, 714900)
(AMETHYSTS, MARKET << US, 10002, 1, 714900)
(AMETHYSTS, MARKET << US, 10002, 1, 714900)
(AMETHYSTS, MARKET << US, 10002, 1, 714900)
(AMETHYSTS, MARKET << US, 10002, 1, 714900)
(AMETHYSTS, MARKET << US, 10002, 1, 714900)
(AMETHYSTS, MARKET << US, 10002, 1, 714900)","{""AMETHYSTS"": -6, ""STARFRUIT"": 10}",4797,5068,9999
715600,70028,84139,"(AMETHYSTS, MARKET << US, 10005, 1, 715600)
(AMETHYSTS, MARKET << US, 10005, 1, 715600)
(AMETHYSTS, MARKET << US, 10005, 1, 715600)
(AMETHYSTS, MARKET << US, 10005, 1, 715600)
(AMETHYSTS, MARKET << US, 10005, 1, 715600)
(AMETHYSTS, MARKET << US, 10005, 1, 715600)
(AMETHYSTS, MARKET << US, 9998, 1, 715600)","{""AMETHYSTS"": -13, ""STARFRUIT"": 10}",4796,5067,10001
715800,-10136,74003,"(STARFRUIT, US << MARKET, 5068, 1, 715800)
(STARFRUIT, US << MARKET, 5068, 1, 715800)","{""AMETHYSTS"": -13, ""STARFRUIT"": 12}",4794,5067,10001
716100,-5069,68934,"(STARFRUIT, US << MARKET, 5069, 1, 716100)","{""AMETHYSTS"": -13, ""STARFRUIT"": 13}",4792,5066,10000
716400,-79984,-11050,"(AMETHYSTS, US << MARKET, 9998, 1, 716400)
(AMETHYSTS, US << MARKET, 9998, 1, 716400)
(AMETHYSTS, US << MARKET, 9998, 1, 716400)
(AMETHYSTS, US << MARKET, 9998, 1, 716400)
(AMETHYSTS, US << MARKET, 9998, 1, 716400)
(AMETHYSTS, US << MARKET, 9998, 1, 716400)
(AMETHYSTS, US << MARKET, 9998, 1, 716400)
(AMETHYSTS, US << MARKET, 9998, 1, 716400)","{""AMETHYSTS"": -5, ""STARFRUIT"": 13}",4836,5067,9997
716700,5065,-5985,"(STARFRUIT, MARKET << US, 5065, 1, 716700)","{""AMETHYSTS"": -5, ""STARFRUIT"": 12}",4824,5067,9999
716900,-30015,-36000,"(AMETHYSTS, US << MARKET, 10005, 1, 716900)
(AMETHYSTS, US << MARKET, 10005, 1, 716900)
(AMETHYSTS, US << MARKET, 10005, 1, 716900)","{""AMETHYSTS"": -2, ""STARFRUIT"": 12}",4804,5067,10000
717100,-5070,-41070,"(STARFRUIT, US << MARKET, 5070, 1, 717100)","{""AMETHYSTS"": -2, ""STARFRUIT"": 13}",4840,5070,10000
717300,130022,88952,"(AMETHYSTS, MARKET << US, 10002, 1, 717300)
(AMETHYSTS, MARKET << US, 10002, 1, 717300)
(AMETHYSTS, MARKET << US, 10002, 1, 717300)
(AMETHYSTS, MARKET << US, 10002, 1, 717300)
(AMETHYSTS, MARKET << US, 10002, 1, 717300)
(AMETHYSTS, MARKET << US, 10002, 1, 717300)
(AMETHYSTS, MARKET << US, 10002, 1, 717300)
(AMETHYSTS, MARKET << US, 10002, 1, 717300)
(AMETHYSTS, MARKET << US, 10002, 1, 717300)
(AMETHYSTS, MARKET << US, 10002, 1, 717300)
(AMETHYSTS, MARKET << US, 10002, 1, 717300)
(AMETHYSTS, MARKET << US, 10002, 1, 717300)
(AMETHYSTS, MARKET << US, 9998, 1, 717300)","{""AMETHYSTS"": -15, ""STARFRUIT"": 13}",4791,5068,10003
717500,-5070,83882,"(STARFRUIT, US << MARKET, 5070, 1, 717500)","{""AMETHYSTS"": -15, ""STARFRUIT"": 14}",4847,5070,10001
717600,-20276,63606,"(STARFRUIT, US << MARKET, 5069, 1, 717600)
(STARFRUIT, US << MARKET, 5069, 1, 717600)
(STARFRUIT, US << MARKET, 5069, 1, 717600)
(STARFRUIT, US << MARKET, 5069, 1, 717600)","{""AMETHYSTS"": -15, ""STARFRUIT"": 18}",4866,5070,10000
718400,132,63738,"(AMETHYSTS, US << MARKET, 9996, 1, 718400)
(AMETHYSTS, US << MARKET, 9996, 1, 718400)
(AMETHYSTS, MARKET << US, 9996, 1, 718400)
(STARFRUIT, MARKET << US, 5064, 1, 718400)
(STARFRUIT, MARKET << US, 5064, 1, 718400)","{""AMETHYSTS"": -14, ""STARFRUIT"": 16}",4810,5067,10000
718700,-20284,43454,"(STARFRUIT, US << MARKET, 5071, 1, 718700)
(STARFRUIT, US << MARKET, 5071, 1, 718700)
(STARFRUIT, US << MARKET, 5071, 1, 718700)
(STARFRUIT, US << MARKET, 5071, 1, 718700)","{""AMETHYSTS"": -14, ""STARFRUIT"": 20}",4794,5067,10000
718800,40544,83998,"(STARFRUIT, MARKET << US, 5068, 1, 718800)
(STARFRUIT, MARKET << US, 5068, 1, 718800)
(STARFRUIT, MARKET << US, 5068, 1, 718800)
(STARFRUIT, MARKET << US, 5068, 1, 718800)
(STARFRUIT, MARKET << US, 5068, 1, 718800)
(STARFRUIT, MARKET << US, 5068, 1, 718800)
(STARFRUIT, MARKET << US, 5068, 1, 718800)
(STARFRUIT, MARKET << US, 5068, 1, 718800)","{""AMETHYSTS"": -14, ""STARFRUIT"": 12}",4790,5066,10000
719000,5063,89061,"(STARFRUIT, MARKET << US, 5063, 1, 719000)","{""AMETHYSTS"": -14, ""STARFRUIT"": 11}",4743,5062,10000
719400,-10004,79057,"(AMETHYSTS, US << MARKET, 10004, 1, 719400)","{""AMETHYSTS"": -13, ""STARFRUIT"": 11}",4748,5064,10001
719700,5062,84119,"(STARFRUIT, MARKET << US, 5062, 1, 719700)","{""AMETHYSTS"": -13, ""STARFRUIT"": 10}",4769,5065,10000
720500,9998,94117,"(AMETHYSTS, MARKET << US, 9998, 1, 720500)","{""AMETHYSTS"": -14, ""STARFRUIT"": 10}",4823,5065,9996
720600,5067,99184,"(STARFRUIT, MARKET << US, 5067, 1, 720600)","{""AMETHYSTS"": -14, ""STARFRUIT"": 9}",4796,5068,10000
721000,-5067,94117,"(STARFRUIT, US << MARKET, 5067, 1, 721000)","{""AMETHYSTS"": -14, ""STARFRUIT"": 10}",4797,5068,10000
721200,-10002,84115,"(AMETHYSTS, US << MARKET, 10002, 1, 721200)","{""AMETHYSTS"": -13, ""STARFRUIT"": 10}",4726,5065,10003
721600,20004,104119,"(AMETHYSTS, MARKET << US, 10002, 1, 721600)
(AMETHYSTS, MARKET << US, 10002, 1, 721600)","{""AMETHYSTS"": -15, ""STARFRUIT"": 10}",4714,5064,10003
721800,-10002,94117,"(AMETHYSTS, US << MARKET, 10002, 1, 721800)","{""AMETHYSTS"": -14, ""STARFRUIT"": 10}",4725,5065,10003
721900,5067,99184,"(STARFRUIT, MARKET << US, 5067, 1, 721900)","{""AMETHYSTS"": -14, ""STARFRUIT"": 9}",4829,5067,9997
722400,-29856,69328,"(AMETHYSTS, US << MARKET, 9996, 1, 722400)
(AMETHYSTS, US << MARKET, 9996, 1, 722400)
(AMETHYSTS, US << MARKET, 9996, 1, 722400)
(AMETHYSTS, US << MARKET, 9996, 1, 722400)
(STARFRUIT, MARKET << US, 5064, 1, 722400)
(STARFRUIT, MARKET << US, 5064, 1, 722400)","{""AMETHYSTS"": -10, ""STARFRUIT"": 7}",4786,5064,9999
722700,-25208,44120,"(AMETHYSTS, US << MARKET, 10004, 1, 722700)
(STARFRUIT, US << MARKET, 5068, 1, 722700)
(STARFRUIT, US << MARKET, 5068, 1, 722700)
(STARFRUIT, US << MARKET, 5068, 1, 722700)","{""AMETHYSTS"": -9, ""STARFRUIT"": 10}",4770,5065,10000
722800,10130,54250,"(STARFRUIT, MARKET << US, 5065, 1, 722800)
(STARFRUIT, MARKET << US, 5065, 1, 722800)","{""AMETHYSTS"": -9, ""STARFRUIT"": 8}",4762,5064,10000
723300,-10002,44248,"(AMETHYSTS, US << MARKET, 10002, 1, 723300)","{""AMETHYSTS"": -8, ""STARFRUIT"": 8}",4752,5066,10003
723400,5068,49316,"(STARFRUIT, MARKET << US, 5068, 1, 723400)","{""AMETHYSTS"": -8, ""STARFRUIT"": 7}",4792,5068,10000
723500,-5062,44254,"(STARFRUIT, US << MARKET, 5062, 1, 723500)","{""AMETHYSTS"": -8, ""STARFRUIT"": 8}",4774,5065,10000
723600,20004,64258,"(AMETHYSTS, MARKET << US, 10002, 1, 723600)
(AMETHYSTS, MARKET << US, 10002, 1, 723600)","{""AMETHYSTS"": -10, ""STARFRUIT"": 8}",4764,5067,10003
724000,30114,94372,"(AMETHYSTS, MARKET << US, 9995, 1, 724000)
(AMETHYSTS, MARKET << US, 9995, 1, 724000)
(STARFRUIT, MARKET << US, 5062, 1, 724000)
(STARFRUIT, MARKET << US, 5062, 1, 724000)","{""AMETHYSTS"": -12, ""STARFRUIT"": 6}",4762,5065,10000
724100,25315,119687,"(STARFRUIT, MARKET << US, 5063, 1, 724100)
(STARFRUIT, MARKET << US, 5063, 1, 724100)
(STARFRUIT, MARKET << US, 5063, 1, 724100)
(STARFRUIT, MARKET << US, 5063, 1, 724100)
(STARFRUIT, MARKET << US, 5063, 1, 724100)","{""AMETHYSTS"": -12, ""STARFRUIT"": 1}",4752,5065,10000
724400,15198,134885,"(STARFRUIT, MARKET << US, 5066, 1, 724400)
(STARFRUIT, MARKET << US, 5066, 1, 724400)
(STARFRUIT, MARKET << US, 5066, 1, 724400)","{""AMETHYSTS"": -12, ""STARFRUIT"": -2}",4783,5063,9998
724700,10122,145007,"(STARFRUIT, MARKET << US, 5061, 1, 724700)
(STARFRUIT, MARKET << US, 5061, 1, 724700)","{""AMETHYSTS"": -12, ""STARFRUIT"": -4}",4751,5064,10000
725100,-9876,135131,"(AMETHYSTS, US << MARKET, 9998, 1, 725100)
(AMETHYSTS, US << MARKET, 9998, 1, 725100)
(STARFRUIT, MARKET << US, 5060, 1, 725100)
(STARFRUIT, MARKET << US, 5060, 1, 725100)","{""AMETHYSTS"": -10, ""STARFRUIT"": -6}",4743,5063,10001
725300,-10122,125009,"(STARFRUIT, US << MARKET, 5061, 1, 725300)
(STARFRUIT, US << MARKET, 5061, 1, 725300)","{""AMETHYSTS"": -10, ""STARFRUIT"": -4}",4753,5064,10000
725400,-99950,25059,"(AMETHYSTS, US << MARKET, 9995, 1, 725400)
(AMETHYSTS, US << MARKET, 9995, 1, 725400)
(AMETHYSTS, US << MARKET, 9995, 1, 725400)
(AMETHYSTS, US << MARKET, 9995, 1, 725400)
(AMETHYSTS, US << MARKET, 9995, 1, 725400)
(AMETHYSTS, US << MARKET, 9995, 1, 725400)
(AMETHYSTS, US << MARKET, 9995, 1, 725400)
(AMETHYSTS, US << MARKET, 9995, 1, 725400)
(AMETHYSTS, US << MARKET, 9995, 1, 725400)
(AMETHYSTS, US << MARKET, 9995, 1, 725400)","{""AMETHYSTS"": 0, ""STARFRUIT"": -4}",4799,5065,10000
725800,10122,35181,"(STARFRUIT, MARKET << US, 5061, 1, 725800)
(STARFRUIT, MARKET << US, 5061, 1, 725800)","{""AMETHYSTS"": 0, ""STARFRUIT"": -6}",4797,5064,10000
726000,5067,40248,"(STARFRUIT, MARKET << US, 5067, 1, 726000)","{""AMETHYSTS"": 0, ""STARFRUIT"": -7}",4807,5063,9998
726400,-25326,14922,"(STARFRUIT, US << MARKET, 5065, 1, 726400)
(STARFRUIT, US << MARKET, 5065, 1, 726400)
(STARFRUIT, US << MARKET, 5065, 1, 726400)
(STARFRUIT, US << MARKET, 5065, 1, 726400)
(STARFRUIT, US << MARKET, 5066, 1, 726400)","{""AMETHYSTS"": 0, ""STARFRUIT"": -2}",4788,5067,10000
726600,-30006,-15084,"(AMETHYSTS, US << MARKET, 10002, 1, 726600)
(AMETHYSTS, US << MARKET, 10002, 1, 726600)
(AMETHYSTS, US << MARKET, 10002, 1, 726600)
(AMETHYSTS, US << MARKET, 10002, 1, 726600)
(AMETHYSTS, US << MARKET, 10002, 1, 726600)
(AMETHYSTS, US << MARKET, 10002, 1, 726600)
(AMETHYSTS, US << MARKET, 10002, 1, 726600)
(AMETHYSTS, US << MARKET, 10002, 1, 726600)
(AMETHYSTS, US << MARKET, 10002, 1, 726600)
(AMETHYSTS, MARKET << US, 10002, 1, 726600)
(AMETHYSTS, MARKET << US, 10002, 1, 726600)
(AMETHYSTS, MARKET << US, 10002, 1, 726600)
(AMETHYSTS, MARKET << US, 10002, 1, 726600)
(AMETHYSTS, MARKET << US, 10002, 1, 726600)
(AMETHYSTS, MARKET << US, 10002, 1, 726600)","{""AMETHYSTS"": 3, ""STARFRUIT"": -2}",4797,5064,10003
727000,-20252,-35336,"(STARFRUIT, US << MARKET, 5063, 1, 727000)
(STARFRUIT, US << MARKET, 5063, 1, 727000)
(STARFRUIT, US << MARKET, 5063, 1, 727000)
(STARFRUIT, US << MARKET, 5063, 1, 727000)
(STARFRUIT, US << MARKET, 5063, 1, 727000)
(STARFRUIT, US << MARKET, 5063, 1, 727000)
(STARFRUIT, MARKET << US, 5063, 1, 727000)
(STARFRUIT, MARKET << US, 5063, 1, 727000)","{""AMETHYSTS"": 3, ""STARFRUIT"": 2}",4800,5065,10002
727100,10122,-25214,"(STARFRUIT, MARKET << US, 5061, 1, 727100)
(STARFRUIT, MARKET << US, 5061, 1, 727100)","{""AMETHYSTS"": 3, ""STARFRUIT"": 0}",4786,5060,10000
727200,-54928,-80142,"(AMETHYSTS, US << MARKET, 9998, 1, 727200)
(AMETHYSTS, US << MARKET, 9998, 1, 727200)
(AMETHYSTS, US << MARKET, 9998, 1, 727200)
(AMETHYSTS, US << MARKET, 9998, 1, 727200)
(AMETHYSTS, US << MARKET, 9998, 1, 727200)
(AMETHYSTS, US << MARKET, 9998, 1, 727200)
(STARFRUIT, MARKET << US, 5060, 1, 727200)","{""AMETHYSTS"": 9, ""STARFRUIT"": -1}",4768,5063,9997
727300,-5316,-85458,"(AMETHYSTS, MARKET << US, 10002, 1, 727300)
(AMETHYSTS, MARKET << US, 10002, 1, 727300)
(STARFRUIT, US << MARKET, 5064, 1, 727300)
(STARFRUIT, US << MARKET, 5064, 1, 727300)
(STARFRUIT, US << MARKET, 5064, 1, 727300)
(STARFRUIT, US << MARKET, 5064, 1, 727300)
(STARFRUIT, US << MARKET, 5064, 1, 727300)","{""AMETHYSTS"": 7, ""STARFRUIT"": 4}",4823,5065,10003
727400,15054,-70404,"(AMETHYSTS, MARKET << US, 9995, 1, 727400)
(STARFRUIT, MARKET << US, 5059, 1, 727400)","{""AMETHYSTS"": 6, ""STARFRUIT"": 3}",4782,5062,10000
727500,5064,-65340,"(STARFRUIT, MARKET << US, 5064, 1, 727500)","{""AMETHYSTS"": 6, ""STARFRUIT"": 2}",4796,5065,10001
727700,5065,-60275,"(STARFRUIT, MARKET << US, 5065, 1, 727700)","{""AMETHYSTS"": 6, ""STARFRUIT"": 1}",4791,5066,10000
727800,20004,-40271,"(AMETHYSTS, MARKET << US, 10002, 1, 727800)
(AMETHYSTS, MARKET << US, 10002, 1, 727800)","{""AMETHYSTS"": 4, ""STARFRUIT"": 1}",4804,5063,10003
727900,-30258,-70529,"(AMETHYSTS, US << MARKET, 10002, 1, 727900)
(STARFRUIT, US << MARKET, 5064, 1, 727900)
(STARFRUIT, US << MARKET, 5064, 1, 727900)
(STARFRUIT, US << MARKET, 5064, 1, 727900)
(STARFRUIT, US << MARKET, 5064, 1, 727900)","{""AMETHYSTS"": 5, ""STARFRUIT"": 5}",4811,5065,10003
728100,5066,-65463,"(STARFRUIT, MARKET << US, 5066, 1, 728100)","{""AMETHYSTS"": 5, ""STARFRUIT"": 4}",4805,5067,10000
728200,-10004,-75467,"(AMETHYSTS, US << MARKET, 10004, 1, 728200)","{""AMETHYSTS"": 6, ""STARFRUIT"": 4}",4795,5064,10001
728700,-20248,-95715,"(STARFRUIT, US << MARKET, 5062, 1, 728700)
(STARFRUIT, US << MARKET, 5062, 1, 728700)
(STARFRUIT, US << MARKET, 5062, 1, 728700)
(STARFRUIT, US << MARKET, 5062, 1, 728700)","{""AMETHYSTS"": 6, ""STARFRUIT"": 8}",4767,5061,9999
728900,-10002,-105717,"(AMETHYSTS, US << MARKET, 10002, 1, 728900)","{""AMETHYSTS"": 7, ""STARFRUIT"": 8}",4816,5064,10003
729000,19992,-85725,"(AMETHYSTS, MARKET << US, 9996, 1, 729000)
(AMETHYSTS, MARKET << US, 9996, 1, 729000)","{""AMETHYSTS"": 5, ""STARFRUIT"": 8}",4782,5064,9999
729500,9874,-75851,"(AMETHYSTS, MARKET << US, 10004, 1, 729500)
(AMETHYSTS, MARKET << US, 10004, 1, 729500)
(STARFRUIT, US << MARKET, 5067, 1, 729500)
(STARFRUIT, US << MARKET, 5067, 1, 729500)","{""AMETHYSTS"": 3, ""STARFRUIT"": 10}",4779,5063,10000
729700,-5060,-80911,"(STARFRUIT, US << MARKET, 5060, 1, 729700)","{""AMETHYSTS"": 3, ""STARFRUIT"": 11}",4782,5063,10000
730000,14939,-65972,"(AMETHYSTS, MARKET << US, 10002, 1, 730000)
(AMETHYSTS, MARKET << US, 10002, 1, 730000)
(STARFRUIT, US << MARKET, 5065, 1, 730000)","{""AMETHYSTS"": 1, ""STARFRUIT"": 12}",4799,5064,10003
730200,-109963,-175935,"(AMETHYSTS, US << MARKET, 9996, 1, 730200)
(AMETHYSTS, US << MARKET, 9996, 1, 730200)
(AMETHYSTS, US << MARKET, 9996, 1, 730200)
(AMETHYSTS, US << MARKET, 9996, 1, 730200)
(AMETHYSTS, US << MARKET, 9996, 1, 730200)
(AMETHYSTS, US << MARKET, 9996, 1, 730200)
(AMETHYSTS, US << MARKET, 9996, 1, 730200)
(AMETHYSTS, US << MARKET, 9996, 1, 730200)
(AMETHYSTS, US << MARKET, 9996, 1, 730200)
(AMETHYSTS, US << MARKET, 9996, 1, 730200)
(AMETHYSTS, US << MARKET, 9996, 1, 730200)
(AMETHYSTS, US << MARKET, 9996, 1, 730200)
(AMETHYSTS, US << MARKET, 9996, 1, 730200)
(AMETHYSTS, US << MARKET, 9996, 1, 730200)
(AMETHYSTS, US << MARKET, 9996, 1, 730200)
(AMETHYSTS, US << MARKET, 9996, 1, 730200)
(AMETHYSTS, US << MARKET, 9996, 1, 730200)
(AMETHYSTS, US << MARKET, 9996, 1, 730200)
(AMETHYSTS, MARKET << US, 9995, 1, 730200)
(AMETHYSTS, MARKET << US, 9995, 1, 730200)
(AMETHYSTS, MARKET << US, 9995, 1, 730200)
(AMETHYSTS, MARKET << US, 9995, 1, 730200)
(AMETHYSTS, MARKET << US, 9995, 1, 730200)
(AMETHYSTS, MARKET << US, 9995, 1, 730200)
(AMETHYSTS, MARKET << US, 9995, 1, 730200)","{""AMETHYSTS"": 12, ""STARFRUIT"": 12}",4809,5062,10000
730400,-44793,-220728,"(AMETHYSTS, US << MARKET, 9996, 1, 730400)
(AMETHYSTS, US << MARKET, 9996, 1, 730400)
(AMETHYSTS, US << MARKET, 9996, 1, 730400)
(AMETHYSTS, US << MARKET, 9996, 1, 730400)
(AMETHYSTS, US << MARKET, 9996, 1, 730400)
(AMETHYSTS, US << MARKET, 9996, 1, 730400)
(AMETHYSTS, US << MARKET, 9996, 1, 730400)
(AMETHYSTS, US << MARKET, 9996, 1, 730400)
(AMETHYSTS, MARKET << US, 9996, 1, 730400)
(AMETHYSTS, MARKET << US, 9996, 1, 730400)
(STARFRUIT, MARKET << US, 5061, 1, 730400)
(STARFRUIT, MARKET << US, 5061, 1, 730400)
(STARFRUIT, MARKET << US, 5061, 1, 730400)","{""AMETHYSTS"": 18, ""STARFRUIT"": 9}",4767,5059,9998
730800,-15065,-235793,"(AMETHYSTS, US << MARKET, 10002, 1, 730800)
(STARFRUIT, US << MARKET, 5063, 1, 730800)","{""AMETHYSTS"": 19, ""STARFRUIT"": 10}",4894,5063,10003
730900,5063,-230730,"(STARFRUIT, MARKET << US, 5063, 1, 730900)","{""AMETHYSTS"": 19, ""STARFRUIT"": 9}",4866,5062,10002
731300,-10002,-240732,"(AMETHYSTS, US << MARKET, 10002, 1, 731300)","{""AMETHYSTS"": 20, ""STARFRUIT"": 9}",4868,5060,10003
731500,40016,-200716,"(AMETHYSTS, MARKET << US, 10004, 1, 731500)
(AMETHYSTS, MARKET << US, 10004, 1, 731500)
(AMETHYSTS, MARKET << US, 10004, 1, 731500)
(AMETHYSTS, MARKET << US, 10004, 1, 731500)","{""AMETHYSTS"": 16, ""STARFRUIT"": 9}",4863,5059,10003
731600,-4941,-205657,"(AMETHYSTS, US << MARKET, 10004, 1, 731600)
(STARFRUIT, MARKET << US, 5063, 1, 731600)","{""AMETHYSTS"": 17, ""STARFRUIT"": 8}",4815,5059,10000
731700,5061,-200596,"(STARFRUIT, MARKET << US, 5061, 1, 731700)","{""AMETHYSTS"": 17, ""STARFRUIT"": 7}",4838,5062,10000
732200,-20010,-220606,"(AMETHYSTS, US << MARKET, 10005, 1, 732200)
(AMETHYSTS, US << MARKET, 10005, 1, 732200)","{""AMETHYSTS"": 19, ""STARFRUIT"": 7}",4807,5059,10000
732700,-5058,-225664,"(STARFRUIT, US << MARKET, 5058, 1, 732700)","{""AMETHYSTS"": 19, ""STARFRUIT"": 8}",4824,5061,10000
732800,20004,-205660,"(AMETHYSTS, MARKET << US, 10002, 1, 732800)
(AMETHYSTS, MARKET << US, 10002, 1, 732800)","{""AMETHYSTS"": 17, ""STARFRUIT"": 8}",4887,5062,10003
733000,-5063,-210723,"(STARFRUIT, US << MARKET, 5063, 1, 733000)","{""AMETHYSTS"": 17, ""STARFRUIT"": 9}",4844,5063,10000
733500,-19996,-230719,"(AMETHYSTS, US << MARKET, 9998, 1, 733500)
(AMETHYSTS, US << MARKET, 9998, 1, 733500)","{""AMETHYSTS"": 19, ""STARFRUIT"": 9}",4745,5060,9996
733800,30118,-200601,"(AMETHYSTS, MARKET << US, 10002, 1, 733800)
(AMETHYSTS, MARKET << US, 10002, 1, 733800)
(STARFRUIT, MARKET << US, 5057, 1, 733800)
(STARFRUIT, MARKET << US, 5057, 1, 733800)","{""AMETHYSTS"": 17, ""STARFRUIT"": 7}",4870,5060,10003
734200,-40108,-240709,"(AMETHYSTS, US << MARKET, 9998, 1, 734200)
(AMETHYSTS, US << MARKET, 9998, 1, 734200)
(AMETHYSTS, US << MARKET, 9998, 1, 734200)
(STARFRUIT, US << MARKET, 5057, 1, 734200)
(STARFRUIT, US << MARKET, 5057, 1, 734200)","{""AMETHYSTS"": 20, ""STARFRUIT"": 9}",4842,5059,10001
734400,4937,-235772,"(AMETHYSTS, MARKET << US, 9996, 1, 734400)
(STARFRUIT, US << MARKET, 5058, 1, 734400)
(STARFRUIT, US << MARKET, 5058, 1, 734400)
(STARFRUIT, MARKET << US, 5057, 1, 734400)","{""AMETHYSTS"": 19, ""STARFRUIT"": 10}",4798,5057,10000
734500,15052,-220720,"(AMETHYSTS, MARKET << US, 9995, 1, 734500)
(STARFRUIT, MARKET << US, 5057, 1, 734500)","{""AMETHYSTS"": 18, ""STARFRUIT"": 9}",4820,5060,10000
734700,4946,-215774,"(AMETHYSTS, US << MARKET, 10004, 1, 734700)
(AMETHYSTS, MARKET << US, 10004, 1, 734700)
(AMETHYSTS, MARKET << US, 10004, 1, 734700)
(STARFRUIT, US << MARKET, 5058, 1, 734700)","{""AMETHYSTS"": 17, ""STARFRUIT"": 10}",4826,5060,10000
734900,-14938,-230712,"(AMETHYSTS, US << MARKET, 9998, 1, 734900)
(AMETHYSTS, US << MARKET, 9998, 1, 734900)
(STARFRUIT, MARKET << US, 5058, 1, 734900)","{""AMETHYSTS"": 19, ""STARFRUIT"": 9}",4847,5060,10001
735000,-9996,-240708,"(AMETHYSTS, US << MARKET, 9996, 1, 735000)","{""AMETHYSTS"": 20, ""STARFRUIT"": 9}",4841,5061,10000
735700,-5064,-245772,"(STARFRUIT, US << MARKET, 5064, 1, 735700)","{""AMETHYSTS"": 20, ""STARFRUIT"": 10}",4828,5060,10000
736100,50370,-195402,"(AMETHYSTS, MARKET << US, 10002, 1, 736100)
(AMETHYSTS, MARKET << US, 10002, 1, 736100)
(STARFRUIT, MARKET << US, 5061, 1, 736100)
(STARFRUIT, MARKET << US, 5061, 1, 736100)
(STARFRUIT, MARKET << US, 5061, 1, 736100)
(STARFRUIT, MARKET << US, 5061, 1, 736100)
(STARFRUIT, MARKET << US, 5061, 1, 736100)
(STARFRUIT, MARKET << US, 5061, 1, 736100)","{""AMETHYSTS"": 18, ""STARFRUIT"": 4}",4802,5060,9998
736300,-10002,-205404,"(AMETHYSTS, US << MARKET, 10002, 1, 736300)","{""AMETHYSTS"": 19, ""STARFRUIT"": 4}",4897,5061,10003
736400,80016,-125388,"(AMETHYSTS, MARKET << US, 10002, 1, 736400)
(AMETHYSTS, MARKET << US, 10002, 1, 736400)
(AMETHYSTS, MARKET << US, 10002, 1, 736400)
(AMETHYSTS, MARKET << US, 10002, 1, 736400)
(AMETHYSTS, MARKET << US, 10002, 1, 736400)
(AMETHYSTS, MARKET << US, 10002, 1, 736400)
(AMETHYSTS, MARKET << US, 10002, 1, 736400)
(AMETHYSTS, MARKET << US, 10002, 1, 736400)","{""AMETHYSTS"": 11, ""STARFRUIT"": 4}",4871,5062,10001
736500,40256,-85132,"(AMETHYSTS, MARKET << US, 10002, 1, 736500)
(AMETHYSTS, MARKET << US, 10002, 1, 736500)
(STARFRUIT, MARKET << US, 5063, 1, 736500)
(STARFRUIT, MARKET << US, 5063, 1, 736500)
(STARFRUIT, MARKET << US, 5063, 1, 736500)
(STARFRUIT, MARKET << US, 5063, 1, 736500)","{""AMETHYSTS"": 9, ""STARFRUIT"": 0}",4859,5064,9999
736900,9878,-75254,"(AMETHYSTS, MARKET << US, 10004, 1, 736900)
(AMETHYSTS, MARKET << US, 10004, 1, 736900)
(STARFRUIT, US << MARKET, 5065, 1, 736900)
(STARFRUIT, US << MARKET, 5065, 1, 736900)","{""AMETHYSTS"": 7, ""STARFRUIT"": 2}",4875,5061,10001
737200,5062,-70192,"(STARFRUIT, MARKET << US, 5062, 1, 737200)","{""AMETHYSTS"": 7, ""STARFRUIT"": 1}",4864,5063,9999
737500,-25315,-95507,"(STARFRUIT, US << MARKET, 5063, 1, 737500)
(STARFRUIT, US << MARKET, 5063, 1, 737500)
(STARFRUIT, US << MARKET, 5063, 1, 737500)
(STARFRUIT, US << MARKET, 5063, 1, 737500)
(STARFRUIT, US << MARKET, 5063, 1, 737500)","{""AMETHYSTS"": 7, ""STARFRUIT"": 6}",4853,5060,10000
738000,20004,-75503,"(AMETHYSTS, MARKET << US, 10002, 1, 738000)
(AMETHYSTS, MARKET << US, 10002, 1, 738000)","{""AMETHYSTS"": 5, ""STARFRUIT"": 6}",4852,5060,9999
738300,9882,-65621,"(AMETHYSTS, MARKET << US, 9998, 1, 738300)
(AMETHYSTS, MARKET << US, 9998, 1, 738300)
(STARFRUIT, US << MARKET, 5057, 1, 738300)
(STARFRUIT, US << MARKET, 5057, 1, 738300)","{""AMETHYSTS"": 3, ""STARFRUIT"": 8}",4818,5056,9997
738900,-79984,-145605,"(AMETHYSTS, US << MARKET, 9998, 1, 738900)
(AMETHYSTS, US << MARKET, 9998, 1, 738900)
(AMETHYSTS, US << MARKET, 9998, 1, 738900)
(AMETHYSTS, US << MARKET, 9998, 1, 738900)
(AMETHYSTS, US << MARKET, 9998, 1, 738900)
(AMETHYSTS, US << MARKET, 9998, 1, 738900)
(AMETHYSTS, US << MARKET, 9998, 1, 738900)
(AMETHYSTS, US << MARKET, 9998, 1, 738900)","{""AMETHYSTS"": 11, ""STARFRUIT"": 8}",4823,5059,9996
739600,49990,-95615,"(AMETHYSTS, MARKET << US, 9998, 1, 739600)
(AMETHYSTS, MARKET << US, 9998, 1, 739600)
(AMETHYSTS, MARKET << US, 9998, 1, 739600)
(AMETHYSTS, MARKET << US, 9998, 1, 739600)
(AMETHYSTS, MARKET << US, 9998, 1, 739600)","{""AMETHYSTS"": 6, ""STARFRUIT"": 8}",4857,5059,10000
740100,-5062,-100677,"(STARFRUIT, US << MARKET, 5062, 1, 740100)","{""AMETHYSTS"": 6, ""STARFRUIT"": 9}",4881,5062,10000
740300,-5062,-105739,"(STARFRUIT, US << MARKET, 5062, 1, 740300)","{""AMETHYSTS"": 6, ""STARFRUIT"": 10}",4881,5062,10000
740600,14953,-90786,"(AMETHYSTS, MARKET << US, 10005, 1, 740600)
(AMETHYSTS, MARKET << US, 10005, 1, 740600)
(STARFRUIT, US << MARKET, 5057, 1, 740600)","{""AMETHYSTS"": 4, ""STARFRUIT"": 11}",4830,5056,10000
740800,-30232,-121018,"(AMETHYSTS, US << MARKET, 10004, 1, 740800)
(STARFRUIT, US << MARKET, 5057, 1, 740800)
(STARFRUIT, US << MARKET, 5057, 1, 740800)
(STARFRUIT, US << MARKET, 5057, 1, 740800)
(STARFRUIT, US << MARKET, 5057, 1, 740800)","{""AMETHYSTS"": 5, ""STARFRUIT"": 15}",4822,5056,10000
740900,40496,-80522,"(STARFRUIT, MARKET << US, 5062, 1, 740900)
(STARFRUIT, MARKET << US, 5062, 1, 740900)
(STARFRUIT, MARKET << US, 5062, 1, 740900)
(STARFRUIT, MARKET << US, 5062, 1, 740900)
(STARFRUIT, MARKET << US, 5062, 1, 740900)
(STARFRUIT, MARKET << US, 5062, 1, 740900)
(STARFRUIT, MARKET << US, 5062, 1, 740900)
(STARFRUIT, MARKET << US, 5062, 1, 740900)","{""AMETHYSTS"": 5, ""STARFRUIT"": 7}",4891,5059,10000
741700,-54951,-135473,"(AMETHYSTS, US << MARKET, 10002, 1, 741700)
(AMETHYSTS, US << MARKET, 10002, 1, 741700)
(AMETHYSTS, US << MARKET, 10002, 1, 741700)
(AMETHYSTS, US << MARKET, 10002, 1, 741700)
(AMETHYSTS, US << MARKET, 10002, 1, 741700)
(AMETHYSTS, US << MARKET, 10002, 1, 741700)
(STARFRUIT, MARKET << US, 5061, 1, 741700)","{""AMETHYSTS"": 11, ""STARFRUIT"": 6}",4932,5062,10003
741900,-10112,-145585,"(STARFRUIT, US << MARKET, 5056, 1, 741900)
(STARFRUIT, US << MARKET, 5056, 1, 741900)","{""AMETHYSTS"": 11, ""STARFRUIT"": 8}",4895,5060,10000
742200,-116,-145701,"(AMETHYSTS, MARKET << US, 9996, 1, 742200)
(STARFRUIT, US << MARKET, 5056, 1, 742200)
(STARFRUIT, US << MARKET, 5056, 1, 742200)","{""AMETHYSTS"": 10, ""STARFRUIT"": 10}",4889,5059,10000
742400,9998,-135703,"(AMETHYSTS, MARKET << US, 9998, 1, 742400)","{""AMETHYSTS"": 9, ""STARFRUIT"": 10}",4896,5059,10001
742500,-116,-135819,"(AMETHYSTS, MARKET << US, 9998, 1, 742500)
(STARFRUIT, US << MARKET, 5057, 1, 742500)
(STARFRUIT, US << MARKET, 5057, 1, 742500)
(STARFRUIT, US << MARKET, 5057, 1, 742500)
(STARFRUIT, US << MARKET, 5057, 1, 742500)
(STARFRUIT, MARKET << US, 5057, 1, 742500)
(STARFRUIT, MARKET << US, 5057, 1, 742500)","{""AMETHYSTS"": 8, ""STARFRUIT"": 12}",4877,5060,9997
742700,39992,-95827,"(AMETHYSTS, MARKET << US, 9998, 1, 742700)
(AMETHYSTS, MARKET << US, 9998, 1, 742700)
(AMETHYSTS, MARKET << US, 9998, 1, 742700)
(AMETHYSTS, MARKET << US, 9998, 1, 742700)","{""AMETHYSTS"": 4, ""STARFRUIT"": 12}",4893,5061,9997
743100,-19996,-115823,"(AMETHYSTS, US << MARKET, 9998, 1, 743100)
(AMETHYSTS, US << MARKET, 9998, 1, 743100)","{""AMETHYSTS"": 6, ""STARFRUIT"": 12}",4903,5060,10001
743200,-5057,-120880,"(STARFRUIT, US << MARKET, 5057, 1, 743200)","{""AMETHYSTS"": 6, ""STARFRUIT"": 13}",4900,5060,10000
743600,5055,-115825,"(STARFRUIT, MARKET << US, 5055, 1, 743600)","{""AMETHYSTS"": 6, ""STARFRUIT"": 12}",4871,5058,10000
743700,14944,-100881,"(AMETHYSTS, MARKET << US, 10002, 1, 743700)
(AMETHYSTS, MARKET << US, 10002, 1, 743700)
(STARFRUIT, US << MARKET, 5060, 1, 743700)","{""AMETHYSTS"": 4, ""STARFRUIT"": 13}",4924,5061,10003
743900,-90018,-190899,"(AMETHYSTS, US << MARKET, 10002, 1, 743900)
(AMETHYSTS, US << MARKET, 10002, 1, 743900)
(AMETHYSTS, US << MARKET, 10002, 1, 743900)
(AMETHYSTS, US << MARKET, 10002, 1, 743900)
(AMETHYSTS, US << MARKET, 10002, 1, 743900)
(AMETHYSTS, US << MARKET, 10002, 1, 743900)
(AMETHYSTS, US << MARKET, 10002, 1, 743900)
(AMETHYSTS, US << MARKET, 10002, 1, 743900)
(AMETHYSTS, US << MARKET, 10002, 1, 743900)","{""AMETHYSTS"": 13, ""STARFRUIT"": 13}",4842,5058,9999
744000,20007,-170892,"(AMETHYSTS, MARKET << US, 10004, 1, 744000)
(AMETHYSTS, MARKET << US, 10004, 1, 744000)
(STARFRUIT, US << MARKET, 5061, 1, 744000)
(STARFRUIT, MARKET << US, 5060, 1, 744000)","{""AMETHYSTS"": 11, ""STARFRUIT"": 13}",4862,5058,10000
744200,5061,-165831,"(STARFRUIT, MARKET << US, 5061, 1, 744200)","{""AMETHYSTS"": 11, ""STARFRUIT"": 12}",4913,5062,10000
744400,20124,-145707,"(AMETHYSTS, MARKET << US, 9998, 1, 744400)
(STARFRUIT, MARKET << US, 5063, 1, 744400)
(STARFRUIT, MARKET << US, 5063, 1, 744400)","{""AMETHYSTS"": 10, ""STARFRUIT"": 10}",4863,5060,9997
745000,10112,-135595,"(STARFRUIT, MARKET << US, 5056, 1, 745000)
(STARFRUIT, MARKET << US, 5056, 1, 745000)","{""AMETHYSTS"": 10, ""STARFRUIT"": 8}",4839,5058,9997
745100,-5057,-140652,"(STARFRUIT, US << MARKET, 5057, 1, 745100)","{""AMETHYSTS"": 10, ""STARFRUIT"": 9}",4917,5061,10002
745400,-5057,-145709,"(STARFRUIT, US << MARKET, 5057, 1, 745400)","{""AMETHYSTS"": 10, ""STARFRUIT"": 10}",4891,5061,9999
745600,10348,-135361,"(AMETHYSTS, US << MARKET, 10004, 1, 745600)
(AMETHYSTS, US << MARKET, 10004, 1, 745600)
(STARFRUIT, MARKET << US, 5064, 1, 745600)
(STARFRUIT, MARKET << US, 5064, 1, 745600)
(STARFRUIT, MARKET << US, 5057, 1, 745600)
(STARFRUIT, MARKET << US, 5057, 1, 745600)
(STARFRUIT, MARKET << US, 5057, 1, 745600)
(STARFRUIT, MARKET << US, 5057, 1, 745600)","{""AMETHYSTS"": 12, ""STARFRUIT"": 4}",4879,5060,10000
745800,14820,-120541,"(AMETHYSTS, US << MARKET, 10002, 1, 745800)
(AMETHYSTS, MARKET << US, 10002, 1, 745800)
(AMETHYSTS, MARKET << US, 10002, 1, 745800)
(AMETHYSTS, MARKET << US, 10002, 1, 745800)
(AMETHYSTS, MARKET << US, 10002, 1, 745800)
(STARFRUIT, US << MARKET, 5062, 1, 745800)
(STARFRUIT, US << MARKET, 5062, 1, 745800)
(STARFRUIT, US << MARKET, 5062, 1, 745800)","{""AMETHYSTS"": 9, ""STARFRUIT"": 7}",4891,5063,9999
746300,15171,-105370,"(STARFRUIT, MARKET << US, 5057, 1, 746300)
(STARFRUIT, MARKET << US, 5057, 1, 746300)
(STARFRUIT, MARKET << US, 5057, 1, 746300)","{""AMETHYSTS"": 9, ""STARFRUIT"": 4}",4854,5056,10000
746800,-20116,-125486,"(AMETHYSTS, US << MARKET, 10000, 1, 746800)
(STARFRUIT, US << MARKET, 5058, 1, 746800)
(STARFRUIT, US << MARKET, 5058, 1, 746800)","{""AMETHYSTS"": 10, ""STARFRUIT"": 6}",4820,5056,9997
747100,-19992,-145478,"(AMETHYSTS, US << MARKET, 9996, 1, 747100)
(AMETHYSTS, US << MARKET, 9996, 1, 747100)","{""AMETHYSTS"": 12, ""STARFRUIT"": 6}",4870,5058,10000
747200,-10120,-155598,"(STARFRUIT, US << MARKET, 5060, 1, 747200)
(STARFRUIT, US << MARKET, 5060, 1, 747200)","{""AMETHYSTS"": 12, ""STARFRUIT"": 8}",4882,5060,10000
747300,25275,-130323,"(STARFRUIT, US << MARKET, 5055, 1, 747300)
(STARFRUIT, MARKET << US, 5055, 1, 747300)
(STARFRUIT, MARKET << US, 5055, 1, 747300)
(STARFRUIT, MARKET << US, 5055, 1, 747300)
(STARFRUIT, MARKET << US, 5055, 1, 747300)
(STARFRUIT, MARKET << US, 5055, 1, 747300)
(STARFRUIT, MARKET << US, 5055, 1, 747300)","{""AMETHYSTS"": 12, ""STARFRUIT"": 3}",4851,5058,10000
747600,15174,-115149,"(STARFRUIT, MARKET << US, 5058, 1, 747600)
(STARFRUIT, MARKET << US, 5058, 1, 747600)
(STARFRUIT, MARKET << US, 5058, 1, 747600)","{""AMETHYSTS"": 12, ""STARFRUIT"": 0}",4863,5058,10001
747700,49990,-65159,"(AMETHYSTS, MARKET << US, 9998, 1, 747700)
(AMETHYSTS, MARKET << US, 9998, 1, 747700)
(AMETHYSTS, MARKET << US, 9998, 1, 747700)
(AMETHYSTS, MARKET << US, 9998, 1, 747700)
(AMETHYSTS, MARKET << US, 9998, 1, 747700)","{""AMETHYSTS"": 7, ""STARFRUIT"": 0}",4820,5058,9997
748800,9998,-55161,"(AMETHYSTS, MARKET << US, 9998, 1, 748800)","{""AMETHYSTS"": 6, ""STARFRUIT"": 0}",4845,5057,10001
749100,-39984,-95145,"(AMETHYSTS, US << MARKET, 9996, 1, 749100)
(AMETHYSTS, US << MARKET, 9996, 1, 749100)
(AMETHYSTS, US << MARKET, 9996, 1, 749100)
(AMETHYSTS, US << MARKET, 9996, 1, 749100)","{""AMETHYSTS"": 10, ""STARFRUIT"": 0}",4845,5058,9999
749200,-30342,-125487,"(STARFRUIT, US << MARKET, 5057, 1, 749200)
(STARFRUIT, US << MARKET, 5057, 1, 749200)
(STARFRUIT, US << MARKET, 5057, 1, 749200)
(STARFRUIT, US << MARKET, 5057, 1, 749200)
(STARFRUIT, US << MARKET, 5057, 1, 749200)
(STARFRUIT, US << MARKET, 5057, 1, 749200)","{""AMETHYSTS"": 10, ""STARFRUIT"": 6}",4829,5056,9998
749300,-20216,-145703,"(STARFRUIT, US << MARKET, 5054, 1, 749300)
(STARFRUIT, US << MARKET, 5054, 1, 749300)
(STARFRUIT, US << MARKET, 5054, 1, 749300)
(STARFRUIT, US << MARKET, 5054, 1, 749300)","{""AMETHYSTS"": 10, ""STARFRUIT"": 10}",4847,5057,9998
749400,9996,-135707,"(AMETHYSTS, MARKET << US, 9996, 1, 749400)","{""AMETHYSTS"": 9, ""STARFRUIT"": 10}",4863,5057,10000
749600,-10002,-145709,"(AMETHYSTS, US << MARKET, 10002, 1, 749600)","{""AMETHYSTS"": 10, ""STARFRUIT"": 10}",4901,5058,10003
750400,-5060,-150769,"(STARFRUIT, US << MARKET, 5060, 1, 750400)","{""AMETHYSTS"": 10, ""STARFRUIT"": 11}",4882,5061,9998
751000,-74906,-225675,"(AMETHYSTS, US << MARKET, 9996, 1, 751000)
(AMETHYSTS, US << MARKET, 9996, 1, 751000)
(AMETHYSTS, US << MARKET, 9996, 1, 751000)
(AMETHYSTS, US << MARKET, 9996, 1, 751000)
(AMETHYSTS, US << MARKET, 9996, 1, 751000)
(AMETHYSTS, US << MARKET, 9996, 1, 751000)
(AMETHYSTS, US << MARKET, 9996, 1, 751000)
(AMETHYSTS, US << MARKET, 9996, 1, 751000)
(AMETHYSTS, US << MARKET, 9996, 1, 751000)
(AMETHYSTS, MARKET << US, 9996, 1, 751000)
(STARFRUIT, MARKET << US, 5062, 1, 751000)","{""AMETHYSTS"": 18, ""STARFRUIT"": 10}",4915,5059,10000
751400,-15060,-240735,"(AMETHYSTS, US << MARKET, 10004, 1, 751400)
(STARFRUIT, US << MARKET, 5056, 1, 751400)","{""AMETHYSTS"": 19, ""STARFRUIT"": 11}",4914,5059,10000
751800,114,-240621,"(AMETHYSTS, US << MARKET, 9996, 1, 751800)
(STARFRUIT, MARKET << US, 5055, 1, 751800)
(STARFRUIT, MARKET << US, 5055, 1, 751800)","{""AMETHYSTS"": 20, ""STARFRUIT"": 9}",4901,5058,10000
752300,0,-240621,,"{""AMETHYSTS"": 20, ""STARFRUIT"": 9}",4961,5058,10003
752400,40008,-200613,"(AMETHYSTS, MARKET << US, 10002, 1, 752400)
(AMETHYSTS, MARKET << US, 10002, 1, 752400)
(AMETHYSTS, MARKET << US, 10002, 1, 752400)
(AMETHYSTS, MARKET << US, 10002, 1, 752400)","{""AMETHYSTS"": 16, ""STARFRUIT"": 9}",4957,5058,10003
752700,-20232,-220845,"(STARFRUIT, US << MARKET, 5058, 1, 752700)
(STARFRUIT, US << MARKET, 5058, 1, 752700)
(STARFRUIT, US << MARKET, 5058, 1, 752700)
(STARFRUIT, US << MARKET, 5058, 1, 752700)","{""AMETHYSTS"": 16, ""STARFRUIT"": 13}",4867,5056,9999
752900,-30122,-250967,"(AMETHYSTS, US << MARKET, 10002, 1, 752900)
(AMETHYSTS, US << MARKET, 10002, 1, 752900)
(STARFRUIT, US << MARKET, 5059, 1, 752900)
(STARFRUIT, US << MARKET, 5059, 1, 752900)","{""AMETHYSTS"": 18, ""STARFRUIT"": 15}",4870,5057,9999
753600,20228,-230739,"(STARFRUIT, MARKET << US, 5057, 1, 753600)
(STARFRUIT, MARKET << US, 5057, 1, 753600)
(STARFRUIT, MARKET << US, 5057, 1, 753600)
(STARFRUIT, MARKET << US, 5057, 1, 753600)","{""AMETHYSTS"": 18, ""STARFRUIT"": 11}",4830,5055,9998
753700,-19996,-250735,"(AMETHYSTS, US << MARKET, 9998, 1, 753700)
(AMETHYSTS, US << MARKET, 9998, 1, 753700)","{""AMETHYSTS"": 20, ""STARFRUIT"": 11}",4923,5058,10001
754000,5055,-245680,"(STARFRUIT, MARKET << US, 5055, 1, 754000)","{""AMETHYSTS"": 20, ""STARFRUIT"": 10}",4900,5058,10000
754100,25065,-220615,"(AMETHYSTS, MARKET << US, 10005, 1, 754100)
(AMETHYSTS, MARKET << US, 10005, 1, 754100)
(STARFRUIT, MARKET << US, 5055, 1, 754100)","{""AMETHYSTS"": 18, ""STARFRUIT"": 9}",4871,5054,10000
754300,25070,-195545,"(AMETHYSTS, MARKET << US, 10004, 1, 754300)
(AMETHYSTS, MARKET << US, 10004, 1, 754300)
(STARFRUIT, MARKET << US, 5062, 1, 754300)","{""AMETHYSTS"": 16, ""STARFRUIT"": 8}",4943,5061,10000
754500,-19996,-215541,"(AMETHYSTS, US << MARKET, 9998, 1, 754500)
(AMETHYSTS, US << MARKET, 9998, 1, 754500)","{""AMETHYSTS"": 18, ""STARFRUIT"": 8}",4861,5057,9997
756100,35057,-180484,"(AMETHYSTS, MARKET << US, 9998, 1, 756100)
(AMETHYSTS, MARKET << US, 9998, 1, 756100)
(AMETHYSTS, MARKET << US, 9998, 1, 756100)
(STARFRUIT, MARKET << US, 5063, 1, 756100)","{""AMETHYSTS"": 15, ""STARFRUIT"": 7}",4897,5063,9996
756300,20004,-160480,"(AMETHYSTS, MARKET << US, 10002, 1, 756300)
(AMETHYSTS, MARKET << US, 10002, 1, 756300)","{""AMETHYSTS"": 13, ""STARFRUIT"": 7}",4934,5061,9999
756900,-15194,-175674,"(STARFRUIT, US << MARKET, 5063, 1, 756900)
(STARFRUIT, US << MARKET, 5063, 1, 756900)
(STARFRUIT, US << MARKET, 5063, 1, 756900)
(STARFRUIT, US << MARKET, 5063, 1, 756900)
(STARFRUIT, MARKET << US, 5058, 1, 756900)","{""AMETHYSTS"": 13, ""STARFRUIT"": 10}",4956,5063,10000
757100,-14929,-190603,"(AMETHYSTS, US << MARKET, 9996, 1, 757100)
(AMETHYSTS, US << MARKET, 9996, 1, 757100)
(STARFRUIT, MARKET << US, 5063, 1, 757100)","{""AMETHYSTS"": 15, ""STARFRUIT"": 9}",4964,5063,10000
757300,-20252,-210855,"(STARFRUIT, US << MARKET, 5063, 1, 757300)
(STARFRUIT, US << MARKET, 5063, 1, 757300)
(STARFRUIT, US << MARKET, 5063, 1, 757300)
(STARFRUIT, US << MARKET, 5063, 1, 757300)","{""AMETHYSTS"": 15, ""STARFRUIT"": 13}",4947,5064,9998
757400,5064,-205791,"(STARFRUIT, MARKET << US, 5064, 1, 757400)","{""AMETHYSTS"": 15, ""STARFRUIT"": 12}",4992,5064,10001
757500,80356,-125435,"(AMETHYSTS, MARKET << US, 9998, 1, 757500)
(AMETHYSTS, MARKET << US, 9998, 1, 757500)
(AMETHYSTS, MARKET << US, 9998, 1, 757500)
(AMETHYSTS, MARKET << US, 9998, 1, 757500)
(AMETHYSTS, MARKET << US, 9998, 1, 757500)
(STARFRUIT, MARKET << US, 5061, 1, 757500)
(STARFRUIT, MARKET << US, 5061, 1, 757500)
(STARFRUIT, MARKET << US, 5061, 1, 757500)
(STARFRUIT, MARKET << US, 5061, 1, 757500)
(STARFRUIT, MARKET << US, 5061, 1, 757500)
(STARFRUIT, MARKET << US, 5061, 1, 757500)","{""AMETHYSTS"": 10, ""STARFRUIT"": 6}",4879,5059,9996
758000,9880,-115555,"(AMETHYSTS, MARKET << US, 10004, 1, 758000)
(AMETHYSTS, MARKET << US, 10004, 1, 758000)
(STARFRUIT, US << MARKET, 5064, 1, 758000)
(STARFRUIT, US << MARKET, 5064, 1, 758000)","{""AMETHYSTS"": 8, ""STARFRUIT"": 8}",4933,5061,10000
758100,-5063,-120618,"(STARFRUIT, US << MARKET, 5063, 1, 758100)","{""AMETHYSTS"": 8, ""STARFRUIT"": 9}",4914,5060,9999
758200,5063,-115555,"(STARFRUIT, MARKET << US, 5063, 1, 758200)","{""AMETHYSTS"": 8, ""STARFRUIT"": 8}",4949,5064,9999
758500,-5063,-120618,"(STARFRUIT, US << MARKET, 5063, 1, 758500)","{""AMETHYSTS"": 8, ""STARFRUIT"": 9}",4913,5059,10000
758700,140070,19452,"(AMETHYSTS, MARKET << US, 10005, 1, 758700)
(AMETHYSTS, MARKET << US, 10005, 1, 758700)
(AMETHYSTS, MARKET << US, 10005, 1, 758700)
(AMETHYSTS, MARKET << US, 10005, 1, 758700)
(AMETHYSTS, MARKET << US, 10005, 1, 758700)
(AMETHYSTS, MARKET << US, 10005, 1, 758700)
(AMETHYSTS, MARKET << US, 10005, 1, 758700)
(AMETHYSTS, MARKET << US, 10005, 1, 758700)
(AMETHYSTS, MARKET << US, 10005, 1, 758700)
(AMETHYSTS, MARKET << US, 10005, 1, 758700)
(AMETHYSTS, MARKET << US, 10005, 1, 758700)
(AMETHYSTS, MARKET << US, 10005, 1, 758700)
(AMETHYSTS, MARKET << US, 10005, 1, 758700)
(AMETHYSTS, MARKET << US, 10005, 1, 758700)","{""AMETHYSTS"": -6, ""STARFRUIT"": 9}",4986,5060,10001
758900,20004,39456,"(AMETHYSTS, MARKET << US, 10002, 1, 758900)
(AMETHYSTS, MARKET << US, 10002, 1, 758900)","{""AMETHYSTS"": -8, ""STARFRUIT"": 9}",4972,5060,10003
759100,5058,44514,"(STARFRUIT, MARKET << US, 5058, 1, 759100)","{""AMETHYSTS"": -8, ""STARFRUIT"": 8}",4978,5058,10000
759200,29890,74404,"(AMETHYSTS, MARKET << US, 10005, 1, 759200)
(AMETHYSTS, MARKET << US, 10005, 1, 759200)
(AMETHYSTS, MARKET << US, 10005, 1, 759200)
(AMETHYSTS, MARKET << US, 10005, 1, 759200)
(STARFRUIT, US << MARKET, 5065, 1, 759200)
(STARFRUIT, US << MARKET, 5065, 1, 759200)","{""AMETHYSTS"": -12, ""STARFRUIT"": 10}",5014,5061,10000
759300,5063,79467,"(STARFRUIT, MARKET << US, 5063, 1, 759300)","{""AMETHYSTS"": -12, ""STARFRUIT"": 9}",5043,5064,10000
759500,10126,89593,"(STARFRUIT, US << MARKET, 5063, 1, 759500)
(STARFRUIT, MARKET << US, 5063, 1, 759500)
(STARFRUIT, MARKET << US, 5063, 1, 759500)
(STARFRUIT, MARKET << US, 5063, 1, 759500)","{""AMETHYSTS"": -12, ""STARFRUIT"": 7}",5053,5064,9999
759700,-25054,64539,"(AMETHYSTS, US << MARKET, 9998, 1, 759700)
(AMETHYSTS, US << MARKET, 9998, 1, 759700)
(STARFRUIT, US << MARKET, 5058, 1, 759700)","{""AMETHYSTS"": -10, ""STARFRUIT"": 8}",5017,5061,10001
759800,-20004,44535,"(AMETHYSTS, US << MARKET, 10002, 1, 759800)
(AMETHYSTS, US << MARKET, 10002, 1, 759800)","{""AMETHYSTS"": -8, ""STARFRUIT"": 8}",5031,5060,9998
760100,15055,59590,"(AMETHYSTS, MARKET << US, 9996, 1, 760100)
(STARFRUIT, MARKET << US, 5059, 1, 760100)","{""AMETHYSTS"": -9, ""STARFRUIT"": 7}",5033,5062,9999
760500,25073,84663,"(AMETHYSTS, MARKET << US, 10004, 1, 760500)
(AMETHYSTS, MARKET << US, 10004, 1, 760500)
(STARFRUIT, MARKET << US, 5065, 1, 760500)","{""AMETHYSTS"": -11, ""STARFRUIT"": 6}",5035,5062,10000
760900,70028,154691,"(AMETHYSTS, US << MARKET, 10004, 1, 760900)
(AMETHYSTS, US << MARKET, 10004, 1, 760900)
(AMETHYSTS, MARKET << US, 10004, 1, 760900)
(AMETHYSTS, MARKET << US, 10004, 1, 760900)
(AMETHYSTS, MARKET << US, 10004, 1, 760900)
(AMETHYSTS, MARKET << US, 10004, 1, 760900)
(AMETHYSTS, MARKET << US, 10004, 1, 760900)
(AMETHYSTS, MARKET << US, 10004, 1, 760900)
(AMETHYSTS, MARKET << US, 10004, 1, 760900)
(AMETHYSTS, MARKET << US, 10004, 1, 760900)
(AMETHYSTS, MARKET << US, 10004, 1, 760900)","{""AMETHYSTS"": -18, ""STARFRUIT"": 6}",5063,5062,10000
761200,25315,180006,"(STARFRUIT, MARKET << US, 5063, 1, 761200)
(STARFRUIT, MARKET << US, 5063, 1, 761200)
(STARFRUIT, MARKET << US, 5063, 1, 761200)
(STARFRUIT, MARKET << US, 5063, 1, 761200)
(STARFRUIT, MARKET << US, 5063, 1, 761200)","{""AMETHYSTS"": -18, ""STARFRUIT"": 1}",5066,5060,10000
761600,5058,185064,"(STARFRUIT, MARKET << US, 5058, 1, 761600)","{""AMETHYSTS"": -18, ""STARFRUIT"": 0}",5046,5061,10001
761700,5058,190122,"(STARFRUIT, MARKET << US, 5058, 1, 761700)","{""AMETHYSTS"": -18, ""STARFRUIT"": -1}",5043,5061,10001
762000,-89964,100158,"(AMETHYSTS, US << MARKET, 9996, 1, 762000)
(AMETHYSTS, US << MARKET, 9996, 1, 762000)
(AMETHYSTS, US << MARKET, 9996, 1, 762000)
(AMETHYSTS, US << MARKET, 9996, 1, 762000)
(AMETHYSTS, US << MARKET, 9996, 1, 762000)
(AMETHYSTS, US << MARKET, 9996, 1, 762000)
(AMETHYSTS, US << MARKET, 9996, 1, 762000)
(AMETHYSTS, US << MARKET, 9996, 1, 762000)
(AMETHYSTS, US << MARKET, 9996, 1, 762000)
(AMETHYSTS, US << MARKET, 9996, 1, 762000)
(AMETHYSTS, MARKET << US, 9996, 1, 762000)","{""AMETHYSTS"": -9, ""STARFRUIT"": -1}",5107,5060,9999
762200,-30354,69804,"(STARFRUIT, US << MARKET, 5059, 1, 762200)
(STARFRUIT, US << MARKET, 5059, 1, 762200)
(STARFRUIT, US << MARKET, 5059, 1, 762200)
(STARFRUIT, US << MARKET, 5059, 1, 762200)
(STARFRUIT, US << MARKET, 5059, 1, 762200)
(STARFRUIT, US << MARKET, 5059, 1, 762200)","{""AMETHYSTS"": -9, ""STARFRUIT"": 5}",5103,5058,9999
762300,-159920,-90116,"(AMETHYSTS, US << MARKET, 9995, 1, 762300)
(AMETHYSTS, US << MARKET, 9995, 1, 762300)
(AMETHYSTS, US << MARKET, 9995, 1, 762300)
(AMETHYSTS, US << MARKET, 9995, 1, 762300)
(AMETHYSTS, US << MARKET, 9995, 1, 762300)
(AMETHYSTS, US << MARKET, 9995, 1, 762300)
(AMETHYSTS, US << MARKET, 9995, 1, 762300)
(AMETHYSTS, US << MARKET, 9995, 1, 762300)
(AMETHYSTS, US << MARKET, 9995, 1, 762300)
(AMETHYSTS, US << MARKET, 9995, 1, 762300)
(AMETHYSTS, US << MARKET, 9995, 1, 762300)
(AMETHYSTS, US << MARKET, 9995, 1, 762300)
(AMETHYSTS, US << MARKET, 9995, 1, 762300)
(AMETHYSTS, US << MARKET, 9995, 1, 762300)
(AMETHYSTS, US << MARKET, 9995, 1, 762300)
(AMETHYSTS, US << MARKET, 9995, 1, 762300)","{""AMETHYSTS"": 7, ""STARFRUIT"": 5}",5189,5061,10000
762400,5058,-85058,"(STARFRUIT, MARKET << US, 5058, 1, 762400)","{""AMETHYSTS"": 7, ""STARFRUIT"": 4}",5174,5058,10000
762500,20004,-65054,"(AMETHYSTS, MARKET << US, 10002, 1, 762500)
(AMETHYSTS, MARKET << US, 10002, 1, 762500)","{""AMETHYSTS"": 5, ""STARFRUIT"": 4}",5209,5062,10003
762700,-15177,-80231,"(STARFRUIT, US << MARKET, 5059, 1, 762700)
(STARFRUIT, US << MARKET, 5059, 1, 762700)
(STARFRUIT, US << MARKET, 5059, 1, 762700)","{""AMETHYSTS"": 5, ""STARFRUIT"": 7}",5180,5058,10001
762800,-20232,-100463,"(STARFRUIT, US << MARKET, 5058, 1, 762800)
(STARFRUIT, US << MARKET, 5058, 1, 762800)
(STARFRUIT, US << MARKET, 5058, 1, 762800)
(STARFRUIT, US << MARKET, 5058, 1, 762800)","{""AMETHYSTS"": 5, ""STARFRUIT"": 11}",5208,5061,10000
762900,9998,-90465,"(AMETHYSTS, MARKET << US, 9998, 1, 762900)","{""AMETHYSTS"": 4, ""STARFRUIT"": 11}",5221,5062,10001
763000,20256,-70209,"(STARFRUIT, MARKET << US, 5064, 1, 763000)
(STARFRUIT, MARKET << US, 5064, 1, 763000)
(STARFRUIT, MARKET << US, 5064, 1, 763000)
(STARFRUIT, MARKET << US, 5064, 1, 763000)","{""AMETHYSTS"": 4, ""STARFRUIT"": 7}",5218,5061,10000
763500,-15180,-85389,"(STARFRUIT, US << MARKET, 5060, 1, 763500)
(STARFRUIT, US << MARKET, 5060, 1, 763500)
(STARFRUIT, US << MARKET, 5060, 1, 763500)","{""AMETHYSTS"": 4, ""STARFRUIT"": 10}",5253,5063,10003
764200,-125034,-210423,"(AMETHYSTS, US << MARKET, 9998, 1, 764200)
(AMETHYSTS, US << MARKET, 9998, 1, 764200)
(AMETHYSTS, US << MARKET, 9998, 1, 764200)
(AMETHYSTS, US << MARKET, 9998, 1, 764200)
(AMETHYSTS, US << MARKET, 9998, 1, 764200)
(AMETHYSTS, US << MARKET, 9998, 1, 764200)
(AMETHYSTS, US << MARKET, 9998, 1, 764200)
(AMETHYSTS, US << MARKET, 9998, 1, 764200)
(AMETHYSTS, US << MARKET, 9998, 1, 764200)
(AMETHYSTS, US << MARKET, 9998, 1, 764200)
(AMETHYSTS, US << MARKET, 9998, 1, 764200)
(AMETHYSTS, US << MARKET, 9998, 1, 764200)
(STARFRUIT, US << MARKET, 5058, 1, 764200)","{""AMETHYSTS"": 16, ""STARFRUIT"": 11}",5264,5061,10001
764300,60012,-150411,"(AMETHYSTS, MARKET << US, 10002, 1, 764300)
(AMETHYSTS, MARKET << US, 10002, 1, 764300)
(AMETHYSTS, MARKET << US, 10002, 1, 764300)
(AMETHYSTS, MARKET << US, 10002, 1, 764300)
(AMETHYSTS, MARKET << US, 10002, 1, 764300)
(AMETHYSTS, MARKET << US, 10002, 1, 764300)","{""AMETHYSTS"": 10, ""STARFRUIT"": 11}",5279,5060,10003
764500,14933,-135478,"(AMETHYSTS, MARKET << US, 9996, 1, 764500)
(AMETHYSTS, MARKET << US, 9996, 1, 764500)
(STARFRUIT, US << MARKET, 5059, 1, 764500)","{""AMETHYSTS"": 8, ""STARFRUIT"": 12}",5254,5061,10000
765600,5060,-130418,"(STARFRUIT, MARKET << US, 5060, 1, 765600)","{""AMETHYSTS"": 8, ""STARFRUIT"": 11}",5267,5063,9999
765700,-69832,-200250,"(AMETHYSTS, US << MARKET, 9996, 1, 765700)
(AMETHYSTS, US << MARKET, 9996, 1, 765700)
(AMETHYSTS, US << MARKET, 9996, 1, 765700)
(AMETHYSTS, US << MARKET, 9996, 1, 765700)
(AMETHYSTS, US << MARKET, 9996, 1, 765700)
(AMETHYSTS, US << MARKET, 9996, 1, 765700)
(AMETHYSTS, US << MARKET, 9996, 1, 765700)
(AMETHYSTS, US << MARKET, 9996, 1, 765700)
(AMETHYSTS, US << MARKET, 9996, 1, 765700)
(AMETHYSTS, US << MARKET, 9996, 1, 765700)
(AMETHYSTS, US << MARKET, 9996, 1, 765700)
(AMETHYSTS, MARKET << US, 10002, 1, 765700)
(AMETHYSTS, MARKET << US, 10002, 1, 765700)
(AMETHYSTS, MARKET << US, 9996, 1, 765700)
(STARFRUIT, MARKET << US, 5062, 1, 765700)
(STARFRUIT, MARKET << US, 5062, 1, 765700)","{""AMETHYSTS"": 16, ""STARFRUIT"": 9}",5267,5061,9998
766000,-20240,-220490,"(STARFRUIT, US << MARKET, 5060, 1, 766000)
(STARFRUIT, US << MARKET, 5060, 1, 766000)
(STARFRUIT, US << MARKET, 5060, 1, 766000)
(STARFRUIT, US << MARKET, 5060, 1, 766000)","{""AMETHYSTS"": 16, ""STARFRUIT"": 13}",5284,5062,9998
766300,20004,-200486,"(AMETHYSTS, MARKET << US, 10002, 1, 766300)
(AMETHYSTS, MARKET << US, 10002, 1, 766300)","{""AMETHYSTS"": 14, ""STARFRUIT"": 13}",5305,5063,9998
766500,-20268,-220754,"(STARFRUIT, US << MARKET, 5067, 1, 766500)
(STARFRUIT, US << MARKET, 5067, 1, 766500)
(STARFRUIT, US << MARKET, 5067, 1, 766500)
(STARFRUIT, US << MARKET, 5067, 1, 766500)","{""AMETHYSTS"": 14, ""STARFRUIT"": 17}",5334,5064,10000
766700,-29858,-250612,"(AMETHYSTS, US << MARKET, 9995, 1, 766700)
(AMETHYSTS, US << MARKET, 9995, 1, 766700)
(AMETHYSTS, US << MARKET, 9995, 1, 766700)
(AMETHYSTS, US << MARKET, 9995, 1, 766700)
(STARFRUIT, MARKET << US, 5061, 1, 766700)
(STARFRUIT, MARKET << US, 5061, 1, 766700)","{""AMETHYSTS"": 18, ""STARFRUIT"": 15}",5312,5064,9998
766800,20004,-230608,"(AMETHYSTS, MARKET << US, 10002, 1, 766800)
(AMETHYSTS, MARKET << US, 10002, 1, 766800)","{""AMETHYSTS"": 16, ""STARFRUIT"": 15}",5400,5064,10003
767300,-5062,-235670,"(STARFRUIT, US << MARKET, 5062, 1, 767300)","{""AMETHYSTS"": 16, ""STARFRUIT"": 16}",5370,5065,10000
767500,-10002,-245672,"(AMETHYSTS, US << MARKET, 10002, 1, 767500)","{""AMETHYSTS"": 17, ""STARFRUIT"": 16}",5350,5066,9998
767700,-19859,-265531,"(AMETHYSTS, US << MARKET, 9995, 1, 767700)
(AMETHYSTS, US << MARKET, 9995, 1, 767700)
(AMETHYSTS, US << MARKET, 9995, 1, 767700)
(STARFRUIT, MARKET << US, 5063, 1, 767700)
(STARFRUIT, MARKET << US, 5063, 1, 767700)","{""AMETHYSTS"": 20, ""STARFRUIT"": 14}",5393,5066,10000
767800,5063,-260468,"(STARFRUIT, MARKET << US, 5063, 1, 767800)","{""AMETHYSTS"": 20, ""STARFRUIT"": 13}",5390,5066,10000
768200,-5063,-265531,"(STARFRUIT, US << MARKET, 5063, 1, 768200)","{""AMETHYSTS"": 20, ""STARFRUIT"": 14}",5373,5066,9999
768500,5070,-260461,"(STARFRUIT, MARKET << US, 5070, 1, 768500)","{""AMETHYSTS"": 20, ""STARFRUIT"": 13}",5337,5066,9997
768700,30140,-230321,"(AMETHYSTS, MARKET << US, 10002, 1, 768700)
(AMETHYSTS, MARKET << US, 10002, 1, 768700)
(STARFRUIT, MARKET << US, 5068, 1, 768700)
(STARFRUIT, MARKET << US, 5068, 1, 768700)","{""AMETHYSTS"": 18, ""STARFRUIT"": 11}",5409,5068,9999
769300,-5070,-235391,"(STARFRUIT, US << MARKET, 5070, 1, 769300)","{""AMETHYSTS"": 18, ""STARFRUIT"": 12}",5449,5070,10000
769500,29994,-205397,"(AMETHYSTS, MARKET << US, 9998, 1, 769500)
(AMETHYSTS, MARKET << US, 9998, 1, 769500)
(AMETHYSTS, MARKET << US, 9998, 1, 769500)","{""AMETHYSTS"": 15, ""STARFRUIT"": 12}",5362,5067,9997
769800,-5068,-210465,"(STARFRUIT, US << MARKET, 5068, 1, 769800)","{""AMETHYSTS"": 15, ""STARFRUIT"": 13}",5434,5068,10001
770200,-20272,-230737,"(STARFRUIT, US << MARKET, 5068, 1, 770200)
(STARFRUIT, US << MARKET, 5068, 1, 770200)
(STARFRUIT, US << MARKET, 5068, 1, 770200)
(STARFRUIT, US << MARKET, 5068, 1, 770200)","{""AMETHYSTS"": 15, ""STARFRUIT"": 17}",5368,5065,10000
770300,20004,-210733,"(AMETHYSTS, MARKET << US, 10002, 1, 770300)
(AMETHYSTS, MARKET << US, 10002, 1, 770300)","{""AMETHYSTS"": 13, ""STARFRUIT"": 17}",5428,5066,10003
770500,-15192,-225925,"(STARFRUIT, US << MARKET, 5064, 1, 770500)
(STARFRUIT, US << MARKET, 5064, 1, 770500)
(STARFRUIT, US << MARKET, 5064, 1, 770500)","{""AMETHYSTS"": 13, ""STARFRUIT"": 20}",5415,5067,10000
770700,-19992,-245917,"(AMETHYSTS, US << MARKET, 9996, 1, 770700)
(AMETHYSTS, US << MARKET, 9996, 1, 770700)","{""AMETHYSTS"": 15, ""STARFRUIT"": 20}",5443,5068,10000
770800,5071,-240846,"(STARFRUIT, MARKET << US, 5071, 1, 770800)","{""AMETHYSTS"": 15, ""STARFRUIT"": 19}",5382,5067,9997
771000,-5065,-245911,"(STARFRUIT, US << MARKET, 5065, 1, 771000)","{""AMETHYSTS"": 15, ""STARFRUIT"": 20}",5404,5068,9997
771500,5070,-240841,"(STARFRUIT, MARKET << US, 5070, 1, 771500)","{""AMETHYSTS"": 15, ""STARFRUIT"": 19}",5489,5070,10000
771600,45621,-195220,"(STARFRUIT, MARKET << US, 5069, 1, 771600)
(STARFRUIT, MARKET << US, 5069, 1, 771600)
(STARFRUIT, MARKET << US, 5069, 1, 771600)
(STARFRUIT, MARKET << US, 5069, 1, 771600)
(STARFRUIT, MARKET << US, 5069, 1, 771600)
(STARFRUIT, MARKET << US, 5069, 1, 771600)
(STARFRUIT, MARKET << US, 5069, 1, 771600)
(STARFRUIT, MARKET << US, 5069, 1, 771600)
(STARFRUIT, MARKET << US, 5069, 1, 771600)","{""AMETHYSTS"": 15, ""STARFRUIT"": 10}",5435,5070,9997
772200,-39984,-235204,"(AMETHYSTS, US << MARKET, 9996, 1, 772200)
(AMETHYSTS, US << MARKET, 9996, 1, 772200)
(AMETHYSTS, US << MARKET, 9996, 1, 772200)
(AMETHYSTS, US << MARKET, 9996, 1, 772200)","{""AMETHYSTS"": 19, ""STARFRUIT"": 10}",5476,5068,10000
772800,-10002,-245206,"(AMETHYSTS, US << MARKET, 10002, 1, 772800)","{""AMETHYSTS"": 20, ""STARFRUIT"": 10}",5554,5070,10003
773200,-5066,-250272,"(STARFRUIT, US << MARKET, 5066, 1, 773200)","{""AMETHYSTS"": 20, ""STARFRUIT"": 11}",5507,5069,10001
773500,5071,-245201,"(STARFRUIT, MARKET << US, 5071, 1, 773500)","{""AMETHYSTS"": 20, ""STARFRUIT"": 10}",5509,5071,10000
773600,50162,-195039,"(AMETHYSTS, MARKET << US, 10004, 1, 773600)
(AMETHYSTS, MARKET << US, 10004, 1, 773600)
(AMETHYSTS, MARKET << US, 10004, 1, 773600)
(AMETHYSTS, MARKET << US, 10004, 1, 773600)
(STARFRUIT, MARKET << US, 5073, 1, 773600)
(STARFRUIT, MARKET << US, 5073, 1, 773600)","{""AMETHYSTS"": 16, ""STARFRUIT"": 8}",5529,5069,10001
773900,-30006,-225045,"(AMETHYSTS, US << MARKET, 10002, 1, 773900)
(AMETHYSTS, US << MARKET, 10002, 1, 773900)
(AMETHYSTS, US << MARKET, 10002, 1, 773900)","{""AMETHYSTS"": 19, ""STARFRUIT"": 8}",5572,5070,10003
774000,9998,-215047,"(AMETHYSTS, MARKET << US, 9998, 1, 774000)","{""AMETHYSTS"": 18, ""STARFRUIT"": 8}",5531,5070,10001
774300,40008,-175039,"(AMETHYSTS, MARKET << US, 10002, 1, 774300)
(AMETHYSTS, MARKET << US, 10002, 1, 774300)
(AMETHYSTS, MARKET << US, 10002, 1, 774300)
(AMETHYSTS, MARKET << US, 10002, 1, 774300)","{""AMETHYSTS"": 14, ""STARFRUIT"": 8}",5547,5068,10003
774800,-5065,-180104,"(AMETHYSTS, US << MARKET, 10002, 1, 774800)
(AMETHYSTS, US << MARKET, 10002, 1, 774800)
(AMETHYSTS, MARKET << US, 10002, 1, 774800)
(AMETHYSTS, MARKET << US, 10002, 1, 774800)
(STARFRUIT, US << MARKET, 5065, 1, 774800)","{""AMETHYSTS"": 14, ""STARFRUIT"": 9}",5550,5068,10003
774900,-14943,-195047,"(AMETHYSTS, US << MARKET, 10004, 1, 774900)
(AMETHYSTS, US << MARKET, 10004, 1, 774900)
(STARFRUIT, MARKET << US, 5065, 1, 774900)","{""AMETHYSTS"": 16, ""STARFRUIT"": 8}",5545,5068,10003
775500,-10136,-205183,"(STARFRUIT, US << MARKET, 5068, 1, 775500)
(STARFRUIT, US << MARKET, 5068, 1, 775500)","{""AMETHYSTS"": 16, ""STARFRUIT"": 10}",5439,5067,9997
776000,-264,-205447,"(AMETHYSTS, MARKET << US, 10002, 1, 776000)
(AMETHYSTS, MARKET << US, 10002, 1, 776000)
(STARFRUIT, US << MARKET, 5067, 1, 776000)
(STARFRUIT, US << MARKET, 5067, 1, 776000)
(STARFRUIT, US << MARKET, 5067, 1, 776000)
(STARFRUIT, US << MARKET, 5067, 1, 776000)","{""AMETHYSTS"": 14, ""STARFRUIT"": 14}",5519,5066,10003
776100,-10270,-215717,"(AMETHYSTS, MARKET << US, 9998, 1, 776100)
(STARFRUIT, US << MARKET, 5067, 1, 776100)
(STARFRUIT, US << MARKET, 5067, 1, 776100)
(STARFRUIT, US << MARKET, 5067, 1, 776100)
(STARFRUIT, US << MARKET, 5067, 1, 776100)","{""AMETHYSTS"": 13, ""STARFRUIT"": 18}",5432,5066,9997
776200,-34909,-250626,"(AMETHYSTS, US << MARKET, 9995, 1, 776200)
(AMETHYSTS, US << MARKET, 9995, 1, 776200)
(AMETHYSTS, US << MARKET, 9995, 1, 776200)
(AMETHYSTS, US << MARKET, 9995, 1, 776200)
(STARFRUIT, MARKET << US, 5071, 1, 776200)","{""AMETHYSTS"": 17, ""STARFRUIT"": 17}",5598,5072,10000
776500,30375,-220251,"(STARFRUIT, US << MARKET, 5070, 1, 776500)
(STARFRUIT, US << MARKET, 5070, 1, 776500)
(STARFRUIT, US << MARKET, 5070, 1, 776500)
(STARFRUIT, MARKET << US, 5065, 1, 776500)
(STARFRUIT, MARKET << US, 5065, 1, 776500)
(STARFRUIT, MARKET << US, 5065, 1, 776500)
(STARFRUIT, MARKET << US, 5065, 1, 776500)
(STARFRUIT, MARKET << US, 5065, 1, 776500)
(STARFRUIT, MARKET << US, 5065, 1, 776500)
(STARFRUIT, MARKET << US, 5065, 1, 776500)
(STARFRUIT, MARKET << US, 5065, 1, 776500)
(STARFRUIT, MARKET << US, 5065, 1, 776500)","{""AMETHYSTS"": 17, ""STARFRUIT"": 11}",5469,5067,9999
776800,50164,-170087,"(AMETHYSTS, MARKET << US, 10005, 1, 776800)
(AMETHYSTS, MARKET << US, 10005, 1, 776800)
(AMETHYSTS, MARKET << US, 10005, 1, 776800)
(AMETHYSTS, MARKET << US, 10005, 1, 776800)
(STARFRUIT, MARKET << US, 5072, 1, 776800)
(STARFRUIT, MARKET << US, 5072, 1, 776800)","{""AMETHYSTS"": 13, ""STARFRUIT"": 9}",5525,5068,10000
777100,30150,-139937,"(AMETHYSTS, MARKET << US, 10004, 1, 777100)
(AMETHYSTS, MARKET << US, 10004, 1, 777100)
(STARFRUIT, MARKET << US, 5071, 1, 777100)
(STARFRUIT, MARKET << US, 5071, 1, 777100)","{""AMETHYSTS"": 11, ""STARFRUIT"": 7}",5539,5068,10000
777200,-30138,-170075,"(AMETHYSTS, US << MARKET, 9998, 1, 777200)
(AMETHYSTS, US << MARKET, 9998, 1, 777200)
(STARFRUIT, US << MARKET, 5071, 1, 777200)
(STARFRUIT, US << MARKET, 5071, 1, 777200)","{""AMETHYSTS"": 13, ""STARFRUIT"": 9}",5485,5068,9996
777300,9998,-160077,"(AMETHYSTS, MARKET << US, 9998, 1, 777300)","{""AMETHYSTS"": 12, ""STARFRUIT"": 9}",5538,5067,10001
777800,-20256,-180333,"(STARFRUIT, US << MARKET, 5064, 1, 777800)
(STARFRUIT, US << MARKET, 5064, 1, 777800)
(STARFRUIT, US << MARKET, 5064, 1, 777800)
(STARFRUIT, US << MARKET, 5064, 1, 777800)","{""AMETHYSTS"": 12, ""STARFRUIT"": 13}",5574,5067,10003
777900,-5069,-185402,"(STARFRUIT, US << MARKET, 5069, 1, 777900)","{""AMETHYSTS"": 12, ""STARFRUIT"": 14}",5578,5070,10000
778200,-60024,-245426,"(AMETHYSTS, US << MARKET, 10004, 1, 778200)
(AMETHYSTS, US << MARKET, 10004, 1, 778200)
(AMETHYSTS, US << MARKET, 10004, 1, 778200)
(AMETHYSTS, US << MARKET, 10004, 1, 778200)
(AMETHYSTS, US << MARKET, 10004, 1, 778200)
(AMETHYSTS, US << MARKET, 10004, 1, 778200)","{""AMETHYSTS"": 18, ""STARFRUIT"": 14}",5498,5066,10000
778400,40496,-204930,"(STARFRUIT, MARKET << US, 5062, 1, 778400)
(STARFRUIT, MARKET << US, 5062, 1, 778400)
(STARFRUIT, MARKET << US, 5062, 1, 778400)
(STARFRUIT, MARKET << US, 5062, 1, 778400)
(STARFRUIT, MARKET << US, 5062, 1, 778400)
(STARFRUIT, MARKET << US, 5062, 1, 778400)
(STARFRUIT, MARKET << US, 5062, 1, 778400)
(STARFRUIT, MARKET << US, 5062, 1, 778400)","{""AMETHYSTS"": 18, ""STARFRUIT"": 6}",5514,5065,10003
778600,-30268,-235198,"(AMETHYSTS, US << MARKET, 9996, 1, 778600)
(AMETHYSTS, US << MARKET, 9996, 1, 778600)
(AMETHYSTS, MARKET << US, 9996, 1, 778600)
(STARFRUIT, US << MARKET, 5068, 1, 778600)
(STARFRUIT, US << MARKET, 5068, 1, 778600)
(STARFRUIT, US << MARKET, 5068, 1, 778600)
(STARFRUIT, US << MARKET, 5068, 1, 778600)","{""AMETHYSTS"": 19, ""STARFRUIT"": 10}",5433,5065,9999
778800,4934,-230264,"(AMETHYSTS, MARKET << US, 9996, 1, 778800)
(STARFRUIT, US << MARKET, 5062, 1, 778800)","{""AMETHYSTS"": 18, ""STARFRUIT"": 11}",5433,5065,9999
779100,-5065,-235329,"(STARFRUIT, US << MARKET, 5064, 1, 779100)
(STARFRUIT, US << MARKET, 5064, 1, 779100)
(STARFRUIT, MARKET << US, 5063, 1, 779100)","{""AMETHYSTS"": 18, ""STARFRUIT"": 12}",5427,5063,10000
779600,-15069,-250398,"(AMETHYSTS, US << MARKET, 10002, 1, 779600)
(STARFRUIT, US << MARKET, 5067, 1, 779600)","{""AMETHYSTS"": 19, ""STARFRUIT"": 13}",5543,5068,10003
779800,9872,-240526,"(AMETHYSTS, MARKET << US, 10004, 1, 779800)
(AMETHYSTS, MARKET << US, 10004, 1, 779800)
(STARFRUIT, US << MARKET, 5068, 1, 779800)
(STARFRUIT, US << MARKET, 5068, 1, 779800)","{""AMETHYSTS"": 17, ""STARFRUIT"": 15}",5434,5064,10000
779900,-20004,-260530,"(AMETHYSTS, US << MARKET, 10002, 1, 779900)
(AMETHYSTS, US << MARKET, 10002, 1, 779900)","{""AMETHYSTS"": 19, ""STARFRUIT"": 15}",5502,5065,10003
780300,-5061,-265591,"(STARFRUIT, US << MARKET, 5061, 1, 780300)","{""AMETHYSTS"": 19, ""STARFRUIT"": 16}",5363,5062,9998
780400,20004,-245587,"(AMETHYSTS, MARKET << US, 10002, 1, 780400)
(AMETHYSTS, MARKET << US, 10002, 1, 780400)","{""AMETHYSTS"": 17, ""STARFRUIT"": 16}",5472,5063,10003
780600,5061,-240526,"(STARFRUIT, MARKET << US, 5061, 1, 780600)","{""AMETHYSTS"": 17, ""STARFRUIT"": 15}",5400,5064,9998
780700,-5067,-245593,"(STARFRUIT, US << MARKET, 5067, 1, 780700)","{""AMETHYSTS"": 17, ""STARFRUIT"": 16}",5445,5067,9998
780800,20004,-225589,"(AMETHYSTS, MARKET << US, 10002, 1, 780800)
(AMETHYSTS, MARKET << US, 10002, 1, 780800)","{""AMETHYSTS"": 15, ""STARFRUIT"": 16}",5436,5065,9999
781000,-20000,-245589,"(AMETHYSTS, US << MARKET, 10002, 1, 781000)
(AMETHYSTS, US << MARKET, 10002, 1, 781000)
(AMETHYSTS, US << MARKET, 10002, 1, 781000)
(AMETHYSTS, US << MARKET, 10002, 1, 781000)
(AMETHYSTS, MARKET << US, 10004, 1, 781000)
(AMETHYSTS, MARKET << US, 10004, 1, 781000)","{""AMETHYSTS"": 17, ""STARFRUIT"": 16}",5486,5064,10003
781200,9998,-235591,"(AMETHYSTS, MARKET << US, 9998, 1, 781200)","{""AMETHYSTS"": 16, ""STARFRUIT"": 16}",5481,5066,10001
781500,85084,-150507,"(AMETHYSTS, MARKET << US, 10002, 1, 781500)
(AMETHYSTS, MARKET << US, 10002, 1, 781500)
(AMETHYSTS, MARKET << US, 10002, 1, 781500)
(AMETHYSTS, MARKET << US, 10002, 1, 781500)
(AMETHYSTS, MARKET << US, 10002, 1, 781500)
(AMETHYSTS, MARKET << US, 10002, 1, 781500)
(AMETHYSTS, MARKET << US, 10002, 1, 781500)
(AMETHYSTS, MARKET << US, 10002, 1, 781500)
(STARFRUIT, MARKET << US, 5068, 1, 781500)","{""AMETHYSTS"": 8, ""STARFRUIT"": 15}",5537,5068,10003
781700,5063,-145444,"(STARFRUIT, MARKET << US, 5063, 1, 781700)","{""AMETHYSTS"": 8, ""STARFRUIT"": 14}",5504,5066,10003
782100,20004,-125440,"(AMETHYSTS, MARKET << US, 10002, 1, 782100)
(AMETHYSTS, MARKET << US, 10002, 1, 782100)","{""AMETHYSTS"": 6, ""STARFRUIT"": 14}",5424,5063,9997
783000,40560,-84880,"(STARFRUIT, MARKET << US, 5070, 1, 783000)
(STARFRUIT, MARKET << US, 5070, 1, 783000)
(STARFRUIT, MARKET << US, 5070, 1, 783000)
(STARFRUIT, MARKET << US, 5070, 1, 783000)
(STARFRUIT, MARKET << US, 5070, 1, 783000)
(STARFRUIT, MARKET << US, 5070, 1, 783000)
(STARFRUIT, MARKET << US, 5070, 1, 783000)
(STARFRUIT, MARKET << US, 5070, 1, 783000)","{""AMETHYSTS"": 6, ""STARFRUIT"": 6}",5522,5067,10000
783200,25325,-59555,"(STARFRUIT, MARKET << US, 5065, 1, 783200)
(STARFRUIT, MARKET << US, 5065, 1, 783200)
(STARFRUIT, MARKET << US, 5065, 1, 783200)
(STARFRUIT, MARKET << US, 5065, 1, 783200)
(STARFRUIT, MARKET << US, 5065, 1, 783200)","{""AMETHYSTS"": 6, ""STARFRUIT"": 1}",5531,5068,10003
783300,5070,-54485,"(STARFRUIT, MARKET << US, 5070, 1, 783300)","{""AMETHYSTS"": 6, ""STARFRUIT"": 0}",5515,5071,10000
783400,9998,-44487,"(AMETHYSTS, MARKET << US, 9998, 1, 783400)","{""AMETHYSTS"": 5, ""STARFRUIT"": 0}",5498,5069,9997
783600,15219,-29268,"(STARFRUIT, MARKET << US, 5073, 1, 783600)
(STARFRUIT, MARKET << US, 5073, 1, 783600)
(STARFRUIT, MARKET << US, 5073, 1, 783600)","{""AMETHYSTS"": 5, ""STARFRUIT"": -3}",5522,5070,10000
783700,5073,-24195,"(STARFRUIT, MARKET << US, 5073, 1, 783700)","{""AMETHYSTS"": 5, ""STARFRUIT"": -4}",5529,5069,10000
783800,-30006,-54201,"(AMETHYSTS, US << MARKET, 10002, 1, 783800)
(AMETHYSTS, US << MARKET, 10002, 1, 783800)
(AMETHYSTS, US << MARKET, 10002, 1, 783800)
(AMETHYSTS, US << MARKET, 10002, 1, 783800)
(AMETHYSTS, US << MARKET, 10002, 1, 783800)
(AMETHYSTS, MARKET << US, 10002, 1, 783800)
(AMETHYSTS, MARKET << US, 10002, 1, 783800)","{""AMETHYSTS"": 8, ""STARFRUIT"": -4}",5543,5070,10003
784200,9998,-44203,"(AMETHYSTS, MARKET << US, 9998, 1, 784200)","{""AMETHYSTS"": 7, ""STARFRUIT"": -4}",5493,5069,9996
784300,99950,55747,"(AMETHYSTS, MARKET << US, 9995, 1, 784300)
(AMETHYSTS, MARKET << US, 9995, 1, 784300)
(AMETHYSTS, MARKET << US, 9995, 1, 784300)
(AMETHYSTS, MARKET << US, 9995, 1, 784300)
(AMETHYSTS, MARKET << US, 9995, 1, 784300)
(AMETHYSTS, MARKET << US, 9995, 1, 784300)
(AMETHYSTS, MARKET << US, 9995, 1, 784300)
(AMETHYSTS, MARKET << US, 9995, 1, 784300)
(AMETHYSTS, MARKET << US, 9995, 1, 784300)
(AMETHYSTS, MARKET << US, 9995, 1, 784300)","{""AMETHYSTS"": -3, ""STARFRUIT"": -4}",5471,5069,10000
784500,5070,60817,"(STARFRUIT, MARKET << US, 5070, 1, 784500)","{""AMETHYSTS"": -3, ""STARFRUIT"": -5}",5470,5070,9999
784600,-40119,20698,"(AMETHYSTS, US << MARKET, 9996, 1, 784600)
(AMETHYSTS, US << MARKET, 9996, 1, 784600)
(AMETHYSTS, US << MARKET, 9996, 1, 784600)
(AMETHYSTS, US << MARKET, 9996, 1, 784600)
(AMETHYSTS, MARKET << US, 9995, 1, 784600)
(STARFRUIT, US << MARKET, 5065, 1, 784600)
(STARFRUIT, US << MARKET, 5065, 1, 784600)","{""AMETHYSTS"": 0, ""STARFRUIT"": -3}",5494,5068,9999
785200,-10132,10566,"(STARFRUIT, US << MARKET, 5066, 1, 785200)
(STARFRUIT, US << MARKET, 5066, 1, 785200)","{""AMETHYSTS"": 0, ""STARFRUIT"": -1}",5497,5069,10000
785400,-25372,-14806,"(STARFRUIT, US << MARKET, 5073, 1, 785400)
(STARFRUIT, US << MARKET, 5073, 1, 785400)
(STARFRUIT, US << MARKET, 5073, 1, 785400)
(STARFRUIT, US << MARKET, 5073, 1, 785400)
(STARFRUIT, US << MARKET, 5073, 1, 785400)
(STARFRUIT, US << MARKET, 5073, 1, 785400)
(STARFRUIT, MARKET << US, 5066, 1, 785400)","{""AMETHYSTS"": 0, ""STARFRUIT"": 4}",5474,5070,9999
785600,20004,5198,"(AMETHYSTS, MARKET << US, 10002, 1, 785600)
(AMETHYSTS, MARKET << US, 10002, 1, 785600)","{""AMETHYSTS"": -2, ""STARFRUIT"": 4}",5480,5070,9999
785900,4786,9984,"(AMETHYSTS, MARKET << US, 9998, 1, 785900)
(AMETHYSTS, MARKET << US, 9998, 1, 785900)
(STARFRUIT, US << MARKET, 5070, 1, 785900)
(STARFRUIT, US << MARKET, 5070, 1, 785900)
(STARFRUIT, US << MARKET, 5070, 1, 785900)","{""AMETHYSTS"": -4, ""STARFRUIT"": 7}",5476,5068,9996
786200,-5069,4915,"(STARFRUIT, US << MARKET, 5069, 1, 786200)","{""AMETHYSTS"": -4, ""STARFRUIT"": 8}",5487,5071,9999
786800,-10002,-5087,"(AMETHYSTS, US << MARKET, 10002, 1, 786800)","{""AMETHYSTS"": -3, ""STARFRUIT"": 8}",5456,5069,10003
787100,30126,25039,"(AMETHYSTS, MARKET << US, 9996, 1, 787100)
(AMETHYSTS, MARKET << US, 9996, 1, 787100)
(STARFRUIT, MARKET << US, 5067, 1, 787100)
(STARFRUIT, MARKET << US, 5067, 1, 787100)","{""AMETHYSTS"": -5, ""STARFRUIT"": 6}",5459,5070,10000
787500,20276,45315,"(STARFRUIT, MARKET << US, 5069, 1, 787500)
(STARFRUIT, MARKET << US, 5069, 1, 787500)
(STARFRUIT, MARKET << US, 5069, 1, 787500)
(STARFRUIT, MARKET << US, 5069, 1, 787500)","{""AMETHYSTS"": -5, ""STARFRUIT"": 2}",5465,5070,9998
787600,-179928,-134613,"(AMETHYSTS, US << MARKET, 9996, 1, 787600)
(AMETHYSTS, US << MARKET, 9996, 1, 787600)
(AMETHYSTS, US << MARKET, 9996, 1, 787600)
(AMETHYSTS, US << MARKET, 9996, 1, 787600)
(AMETHYSTS, US << MARKET, 9996, 1, 787600)
(AMETHYSTS, US << MARKET, 9996, 1, 787600)
(AMETHYSTS, US << MARKET, 9996, 1, 787600)
(AMETHYSTS, US << MARKET, 9996, 1, 787600)
(AMETHYSTS, US << MARKET, 9996, 1, 787600)
(AMETHYSTS, US << MARKET, 9996, 1, 787600)
(AMETHYSTS, US << MARKET, 9996, 1, 787600)
(AMETHYSTS, US << MARKET, 9996, 1, 787600)
(AMETHYSTS, US << MARKET, 9996, 1, 787600)
(AMETHYSTS, US << MARKET, 9996, 1, 787600)
(AMETHYSTS, US << MARKET, 9996, 1, 787600)
(AMETHYSTS, US << MARKET, 9996, 1, 787600)
(AMETHYSTS, US << MARKET, 9996, 1, 787600)
(AMETHYSTS, US << MARKET, 9996, 1, 787600)","{""AMETHYSTS"": 13, ""STARFRUIT"": 2}",5529,5071,10000
787900,5073,-129540,"(STARFRUIT, MARKET << US, 5073, 1, 787900)","{""AMETHYSTS"": 13, ""STARFRUIT"": 1}",5560,5074,10002
788500,-20008,-149548,"(AMETHYSTS, US << MARKET, 10004, 1, 788500)
(AMETHYSTS, US << MARKET, 10004, 1, 788500)","{""AMETHYSTS"": 15, ""STARFRUIT"": 1}",5524,5072,10000
788900,-29840,-179388,"(AMETHYSTS, US << MARKET, 9995, 1, 788900)
(AMETHYSTS, US << MARKET, 9995, 1, 788900)
(AMETHYSTS, US << MARKET, 9995, 1, 788900)
(AMETHYSTS, US << MARKET, 9995, 1, 788900)
(STARFRUIT, MARKET << US, 5070, 1, 788900)
(STARFRUIT, MARKET << US, 5070, 1, 788900)","{""AMETHYSTS"": 19, ""STARFRUIT"": -1}",5501,5073,9998
789100,5076,-174312,"(STARFRUIT, MARKET << US, 5076, 1, 789100)","{""AMETHYSTS"": 19, ""STARFRUIT"": -2}",5542,5073,10000
789900,-10002,-184314,"(AMETHYSTS, US << MARKET, 10002, 1, 789900)","{""AMETHYSTS"": 20, ""STARFRUIT"": -2}",5596,5075,10003
790300,-30438,-214752,"(STARFRUIT, US << MARKET, 5073, 1, 790300)
(STARFRUIT, US << MARKET, 5073, 1, 790300)
(STARFRUIT, US << MARKET, 5073, 1, 790300)
(STARFRUIT, US << MARKET, 5073, 1, 790300)
(STARFRUIT, US << MARKET, 5073, 1, 790300)
(STARFRUIT, US << MARKET, 5073, 1, 790300)","{""AMETHYSTS"": 20, ""STARFRUIT"": 4}",5552,5076,10000
790600,-10156,-224908,"(STARFRUIT, US << MARKET, 5078, 1, 790600)
(STARFRUIT, US << MARKET, 5078, 1, 790600)","{""AMETHYSTS"": 20, ""STARFRUIT"": 6}",5536,5074,10000
791000,-20296,-245204,"(STARFRUIT, US << MARKET, 5074, 1, 791000)
(STARFRUIT, US << MARKET, 5074, 1, 791000)
(STARFRUIT, US << MARKET, 5074, 1, 791000)
(STARFRUIT, US << MARKET, 5074, 1, 791000)","{""AMETHYSTS"": 20, ""STARFRUIT"": 10}",5586,5077,10001
792100,30438,-214766,"(STARFRUIT, MARKET << US, 5073, 1, 792100)
(STARFRUIT, MARKET << US, 5073, 1, 792100)
(STARFRUIT, MARKET << US, 5073, 1, 792100)
(STARFRUIT, MARKET << US, 5073, 1, 792100)
(STARFRUIT, MARKET << US, 5073, 1, 792100)
(STARFRUIT, MARKET << US, 5073, 1, 792100)","{""AMETHYSTS"": 20, ""STARFRUIT"": 4}",5502,5072,9999
792200,0,-214766,,"{""AMETHYSTS"": 20, ""STARFRUIT"": 4}",5478,5076,9997
792400,-10158,-224924,"(STARFRUIT, US << MARKET, 5079, 1, 792400)
(STARFRUIT, US << MARKET, 5079, 1, 792400)","{""AMETHYSTS"": 20, ""STARFRUIT"": 6}",5526,5075,10000
792500,-5084,-230008,"(STARFRUIT, US << MARKET, 5078, 1, 792500)
(STARFRUIT, US << MARKET, 5078, 1, 792500)
(STARFRUIT, MARKET << US, 5072, 1, 792500)","{""AMETHYSTS"": 20, ""STARFRUIT"": 7}",5510,5074,10000
792700,-20296,-250304,"(STARFRUIT, US << MARKET, 5074, 1, 792700)
(STARFRUIT, US << MARKET, 5074, 1, 792700)
(STARFRUIT, US << MARKET, 5074, 1, 792700)
(STARFRUIT, US << MARKET, 5074, 1, 792700)","{""AMETHYSTS"": 20, ""STARFRUIT"": 11}",5479,5073,9999
792900,9996,-240308,"(AMETHYSTS, MARKET << US, 9996, 1, 792900)","{""AMETHYSTS"": 19, ""STARFRUIT"": 11}",5517,5075,10000
793000,154,-240154,"(AMETHYSTS, US << MARKET, 10004, 1, 793000)
(STARFRUIT, MARKET << US, 5079, 1, 793000)
(STARFRUIT, MARKET << US, 5079, 1, 793000)","{""AMETHYSTS"": 20, ""STARFRUIT"": 9}",5541,5075,10001
793100,10156,-229998,"(STARFRUIT, MARKET << US, 5078, 1, 793100)
(STARFRUIT, MARKET << US, 5078, 1, 793100)","{""AMETHYSTS"": 20, ""STARFRUIT"": 7}",5555,5079,10000
793600,5076,-224922,"(STARFRUIT, MARKET << US, 5076, 1, 793600)","{""AMETHYSTS"": 20, ""STARFRUIT"": 6}",5566,5078,10001
793800,10158,-214764,"(STARFRUIT, MARKET << US, 5079, 1, 793800)
(STARFRUIT, MARKET << US, 5079, 1, 793800)","{""AMETHYSTS"": 20, ""STARFRUIT"": 4}",5556,5080,10000
794100,10148,-204616,"(STARFRUIT, MARKET << US, 5074, 1, 794100)
(STARFRUIT, MARKET << US, 5074, 1, 794100)","{""AMETHYSTS"": 20, ""STARFRUIT"": 2}",5538,5077,10000
794300,40484,-164132,"(AMETHYSTS, MARKET << US, 9998, 1, 794300)
(STARFRUIT, MARKET << US, 5081, 1, 794300)
(STARFRUIT, MARKET << US, 5081, 1, 794300)
(STARFRUIT, MARKET << US, 5081, 1, 794300)
(STARFRUIT, MARKET << US, 5081, 1, 794300)
(STARFRUIT, MARKET << US, 5081, 1, 794300)
(STARFRUIT, MARKET << US, 5081, 1, 794300)","{""AMETHYSTS"": 19, ""STARFRUIT"": -4}",5484,5077,9996
794500,20004,-144128,"(AMETHYSTS, MARKET << US, 10002, 1, 794500)
(AMETHYSTS, MARKET << US, 10002, 1, 794500)","{""AMETHYSTS"": 17, ""STARFRUIT"": -4}",5619,5076,10003
794900,-10146,-154274,"(STARFRUIT, US << MARKET, 5073, 1, 794900)
(STARFRUIT, US << MARKET, 5073, 1, 794900)","{""AMETHYSTS"": 17, ""STARFRUIT"": -2}",5574,5076,10000
796000,15080,-139194,"(AMETHYSTS, MARKET << US, 9998, 1, 796000)
(STARFRUIT, MARKET << US, 5082, 1, 796000)","{""AMETHYSTS"": 16, ""STARFRUIT"": -3}",5505,5079,9996
796100,10163,-129031,"(STARFRUIT, MARKET << US, 5082, 1, 796100)
(STARFRUIT, MARKET << US, 5081, 1, 796100)","{""AMETHYSTS"": 16, ""STARFRUIT"": -5}",5559,5082,10000
796300,19684,-109347,"(AMETHYSTS, MARKET << US, 10004, 1, 796300)
(AMETHYSTS, MARKET << US, 10004, 1, 796300)
(AMETHYSTS, MARKET << US, 10004, 1, 796300)
(AMETHYSTS, MARKET << US, 10004, 1, 796300)
(STARFRUIT, US << MARKET, 5083, 1, 796300)
(STARFRUIT, US << MARKET, 5083, 1, 796300)
(STARFRUIT, US << MARKET, 5083, 1, 796300)
(STARFRUIT, US << MARKET, 5083, 1, 796300)","{""AMETHYSTS"": 12, ""STARFRUIT"": -1}",5573,5080,10000
796400,-20168,-129515,"(AMETHYSTS, US << MARKET, 10002, 1, 796400)
(STARFRUIT, US << MARKET, 5083, 1, 796400)
(STARFRUIT, US << MARKET, 5083, 1, 796400)","{""AMETHYSTS"": 13, ""STARFRUIT"": 1}",5552,5080,9999
796600,19992,-109523,"(AMETHYSTS, MARKET << US, 9996, 1, 796600)
(AMETHYSTS, MARKET << US, 9996, 1, 796600)","{""AMETHYSTS"": 11, ""STARFRUIT"": 1}",5557,5080,10000
796900,29836,-79687,"(AMETHYSTS, MARKET << US, 9998, 1, 796900)
(AMETHYSTS, MARKET << US, 9998, 1, 796900)
(AMETHYSTS, MARKET << US, 9998, 1, 796900)
(AMETHYSTS, MARKET << US, 9998, 1, 796900)
(STARFRUIT, US << MARKET, 5078, 1, 796900)
(STARFRUIT, US << MARKET, 5078, 1, 796900)","{""AMETHYSTS"": 7, ""STARFRUIT"": 3}",5532,5080,9997
797000,20312,-59375,"(STARFRUIT, MARKET << US, 5078, 1, 797000)
(STARFRUIT, MARKET << US, 5078, 1, 797000)
(STARFRUIT, MARKET << US, 5078, 1, 797000)
(STARFRUIT, MARKET << US, 5078, 1, 797000)","{""AMETHYSTS"": 7, ""STARFRUIT"": -1}",5554,5078,10001
797100,-30480,-89855,"(STARFRUIT, US << MARKET, 5080, 1, 797100)
(STARFRUIT, US << MARKET, 5080, 1, 797100)
(STARFRUIT, US << MARKET, 5080, 1, 797100)
(STARFRUIT, US << MARKET, 5080, 1, 797100)
(STARFRUIT, US << MARKET, 5080, 1, 797100)
(STARFRUIT, US << MARKET, 5080, 1, 797100)","{""AMETHYSTS"": 7, ""STARFRUIT"": 5}",5521,5078,9998
797500,-20008,-109863,"(AMETHYSTS, US << MARKET, 10004, 1, 797500)
(AMETHYSTS, US << MARKET, 10004, 1, 797500)","{""AMETHYSTS"": 9, ""STARFRUIT"": 5}",5537,5080,10000
797800,-20320,-130183,"(STARFRUIT, US << MARKET, 5080, 1, 797800)
(STARFRUIT, US << MARKET, 5080, 1, 797800)
(STARFRUIT, US << MARKET, 5080, 1, 797800)
(STARFRUIT, US << MARKET, 5080, 1, 797800)","{""AMETHYSTS"": 9, ""STARFRUIT"": 9}",5555,5081,10001
798000,-5082,-135265,"(STARFRUIT, US << MARKET, 5082, 1, 798000)","{""AMETHYSTS"": 9, ""STARFRUIT"": 10}",5564,5082,10001
798100,4919,-130346,"(AMETHYSTS, MARKET << US, 9995, 1, 798100)
(STARFRUIT, US << MARKET, 5076, 1, 798100)","{""AMETHYSTS"": 8, ""STARFRUIT"": 11}",5507,5079,9998
798400,-10002,-140348,"(AMETHYSTS, US << MARKET, 10002, 1, 798400)","{""AMETHYSTS"": 9, ""STARFRUIT"": 11}",5570,5081,10003
798500,9682,-130666,"(AMETHYSTS, MARKET << US, 9998, 1, 798500)
(AMETHYSTS, MARKET << US, 9998, 1, 798500)
(AMETHYSTS, MARKET << US, 9998, 1, 798500)
(STARFRUIT, US << MARKET, 5078, 1, 798500)
(STARFRUIT, US << MARKET, 5078, 1, 798500)
(STARFRUIT, US << MARKET, 5078, 1, 798500)
(STARFRUIT, US << MARKET, 5078, 1, 798500)","{""AMETHYSTS"": 6, ""STARFRUIT"": 15}",5465,5077,9996
798600,-19996,-150662,"(AMETHYSTS, US << MARKET, 9998, 1, 798600)
(AMETHYSTS, US << MARKET, 9998, 1, 798600)","{""AMETHYSTS"": 8, ""STARFRUIT"": 15}",5529,5081,9997
798700,-20336,-170998,"(STARFRUIT, US << MARKET, 5084, 1, 798700)
(STARFRUIT, US << MARKET, 5084, 1, 798700)
(STARFRUIT, US << MARKET, 5084, 1, 798700)
(STARFRUIT, US << MARKET, 5084, 1, 798700)","{""AMETHYSTS"": 8, ""STARFRUIT"": 19}",5576,5082,10002
798900,-5082,-176080,"(STARFRUIT, US << MARKET, 5082, 1, 798900)","{""AMETHYSTS"": 8, ""STARFRUIT"": 20}",5588,5083,10001
799000,19990,-156090,"(AMETHYSTS, MARKET << US, 9995, 1, 799000)
(AMETHYSTS, MARKET << US, 9995, 1, 799000)","{""AMETHYSTS"": 6, ""STARFRUIT"": 20}",5490,5079,10000
799500,156,-155934,"(AMETHYSTS, US << MARKET, 10002, 1, 799500)
(STARFRUIT, MARKET << US, 5079, 1, 799500)
(STARFRUIT, MARKET << US, 5079, 1, 799500)","{""AMETHYSTS"": 7, ""STARFRUIT"": 18}",5513,5080,10001
799900,5078,-150856,"(STARFRUIT, MARKET << US, 5078, 1, 799900)","{""AMETHYSTS"": 7, ""STARFRUIT"": 17}",5446,5077,9999
800000,15246,-135610,"(STARFRUIT, MARKET << US, 5082, 1, 800000)
(STARFRUIT, MARKET << US, 5082, 1, 800000)
(STARFRUIT, MARKET << US, 5082, 1, 800000)","{""AMETHYSTS"": 7, ""STARFRUIT"": 14}",5573,5083,10003
800600,-5077,-140687,"(STARFRUIT, US << MARKET, 5077, 1, 800600)","{""AMETHYSTS"": 7, ""STARFRUIT"": 15}",5513,5080,10000
801000,-5083,-145770,"(STARFRUIT, US << MARKET, 5083, 1, 801000)","{""AMETHYSTS"": 7, ""STARFRUIT"": 16}",5510,5080,10000
801600,14926,-130844,"(AMETHYSTS, MARKET << US, 10005, 1, 801600)
(AMETHYSTS, MARKET << US, 10005, 1, 801600)
(STARFRUIT, US << MARKET, 5084, 1, 801600)","{""AMETHYSTS"": 5, ""STARFRUIT"": 17}",5538,5081,10001
801700,9996,-120848,"(AMETHYSTS, MARKET << US, 9996, 1, 801700)","{""AMETHYSTS"": 4, ""STARFRUIT"": 17}",5529,5081,10000
802400,-19996,-140844,"(AMETHYSTS, US << MARKET, 9998, 1, 802400)
(AMETHYSTS, US << MARKET, 9998, 1, 802400)","{""AMETHYSTS"": 6, ""STARFRUIT"": 17}",5549,5083,9997
802700,-15249,-156093,"(STARFRUIT, US << MARKET, 5083, 1, 802700)
(STARFRUIT, US << MARKET, 5083, 1, 802700)
(STARFRUIT, US << MARKET, 5083, 1, 802700)","{""AMETHYSTS"": 6, ""STARFRUIT"": 20}",5587,5084,10000
802800,0,-156093,,"{""AMETHYSTS"": 6, ""STARFRUIT"": 20}",5553,5082,10001
802900,39984,-116109,"(AMETHYSTS, US << MARKET, 9996, 1, 802900)
(AMETHYSTS, US << MARKET, 9996, 1, 802900)
(AMETHYSTS, MARKET << US, 9996, 1, 802900)
(AMETHYSTS, MARKET << US, 9996, 1, 802900)
(AMETHYSTS, MARKET << US, 9996, 1, 802900)
(AMETHYSTS, MARKET << US, 9996, 1, 802900)
(AMETHYSTS, MARKET << US, 9996, 1, 802900)
(AMETHYSTS, MARKET << US, 9996, 1, 802900)","{""AMETHYSTS"": 2, ""STARFRUIT"": 20}",5531,5082,10000
803100,9998,-106111,"(AMETHYSTS, MARKET << US, 9998, 1, 803100)","{""AMETHYSTS"": 1, ""STARFRUIT"": 20}",5465,5079,9996
803400,0,-106111,,"{""AMETHYSTS"": 1, ""STARFRUIT"": 20}",5506,5081,9997
803700,0,-106111,,"{""AMETHYSTS"": 1, ""STARFRUIT"": 20}",5489,5080,10000
803900,5082,-101029,"(STARFRUIT, MARKET << US, 5082, 1, 803900)","{""AMETHYSTS"": 1, ""STARFRUIT"": 19}",5586,5085,10000
804100,14916,-86113,"(AMETHYSTS, MARKET << US, 10002, 1, 804100)
(AMETHYSTS, MARKET << US, 10002, 1, 804100)
(STARFRUIT, US << MARKET, 5088, 1, 804100)","{""AMETHYSTS"": -1, ""STARFRUIT"": 20}",5568,5084,9999
804300,-10002,-96115,"(AMETHYSTS, US << MARKET, 10002, 1, 804300)","{""AMETHYSTS"": 0, ""STARFRUIT"": 20}",5565,5084,10003
804500,-94898,-191013,"(AMETHYSTS, US << MARKET, 9998, 1, 804500)
(AMETHYSTS, US << MARKET, 9998, 1, 804500)
(AMETHYSTS, US << MARKET, 9998, 1, 804500)
(AMETHYSTS, US << MARKET, 9998, 1, 804500)
(AMETHYSTS, US << MARKET, 9998, 1, 804500)
(AMETHYSTS, US << MARKET, 9998, 1, 804500)
(AMETHYSTS, US << MARKET, 9998, 1, 804500)
(AMETHYSTS, US << MARKET, 9998, 1, 804500)
(AMETHYSTS, US << MARKET, 9998, 1, 804500)
(AMETHYSTS, US << MARKET, 9998, 1, 804500)
(STARFRUIT, MARKET << US, 5082, 1, 804500)","{""AMETHYSTS"": 10, ""STARFRUIT"": 19}",5612,5085,10001
804600,-25083,-216096,"(AMETHYSTS, US << MARKET, 9998, 1, 804600)
(AMETHYSTS, US << MARKET, 9998, 1, 804600)
(STARFRUIT, US << MARKET, 5087, 1, 804600)","{""AMETHYSTS"": 12, ""STARFRUIT"": 20}",5608,5087,9997
805000,5083,-211013,"(STARFRUIT, MARKET << US, 5083, 1, 805000)","{""AMETHYSTS"": 12, ""STARFRUIT"": 19}",5545,5082,10000
805100,-4915,-215928,"(AMETHYSTS, US << MARKET, 10002, 1, 805100)
(STARFRUIT, MARKET << US, 5087, 1, 805100)","{""AMETHYSTS"": 13, ""STARFRUIT"": 18}",5558,5084,9998
805400,20345,-195583,"(STARFRUIT, MARKET << US, 5087, 1, 805400)
(STARFRUIT, MARKET << US, 5086, 1, 805400)
(STARFRUIT, MARKET << US, 5086, 1, 805400)
(STARFRUIT, MARKET << US, 5086, 1, 805400)","{""AMETHYSTS"": 13, ""STARFRUIT"": 14}",5636,5088,9999
805600,20004,-175579,"(AMETHYSTS, MARKET << US, 10002, 1, 805600)
(AMETHYSTS, MARKET << US, 10002, 1, 805600)","{""AMETHYSTS"": 11, ""STARFRUIT"": 14}",5547,5082,9998
805700,-19996,-195575,"(AMETHYSTS, US << MARKET, 9998, 1, 805700)
(AMETHYSTS, US << MARKET, 9998, 1, 805700)","{""AMETHYSTS"": 13, ""STARFRUIT"": 14}",5563,5085,9996
805800,-5083,-200658,"(STARFRUIT, US << MARKET, 5083, 1, 805800)","{""AMETHYSTS"": 13, ""STARFRUIT"": 15}",5632,5086,10000
806200,-5089,-205747,"(STARFRUIT, US << MARKET, 5089, 1, 806200)","{""AMETHYSTS"": 13, ""STARFRUIT"": 16}",5706,5090,10001
806300,-10170,-215917,"(STARFRUIT, US << MARKET, 5085, 1, 806300)
(STARFRUIT, US << MARKET, 5085, 1, 806300)","{""AMETHYSTS"": 13, ""STARFRUIT"": 18}",5608,5084,10001
806600,-54941,-270858,"(AMETHYSTS, US << MARKET, 10005, 1, 806600)
(AMETHYSTS, US << MARKET, 10005, 1, 806600)
(AMETHYSTS, US << MARKET, 10005, 1, 806600)
(AMETHYSTS, US << MARKET, 10005, 1, 806600)
(AMETHYSTS, US << MARKET, 10005, 1, 806600)
(AMETHYSTS, US << MARKET, 10005, 1, 806600)
(STARFRUIT, MARKET << US, 5089, 1, 806600)","{""AMETHYSTS"": 19, ""STARFRUIT"": 17}",5672,5090,10000
806900,-15091,-285949,"(AMETHYSTS, US << MARKET, 10002, 1, 806900)
(STARFRUIT, US << MARKET, 5089, 1, 806900)","{""AMETHYSTS"": 20, ""STARFRUIT"": 18}",5731,5090,10003
807100,20004,-265945,"(AMETHYSTS, MARKET << US, 10002, 1, 807100)
(AMETHYSTS, MARKET << US, 10002, 1, 807100)","{""AMETHYSTS"": 18, ""STARFRUIT"": 18}",5675,5087,10003
807300,-10184,-276129,"(STARFRUIT, US << MARKET, 5092, 1, 807300)
(STARFRUIT, US << MARKET, 5092, 1, 807300)","{""AMETHYSTS"": 18, ""STARFRUIT"": 20}",5651,5089,10000
807700,49990,-226139,"(AMETHYSTS, MARKET << US, 9998, 1, 807700)
(AMETHYSTS, MARKET << US, 9998, 1, 807700)
(AMETHYSTS, MARKET << US, 9998, 1, 807700)
(AMETHYSTS, MARKET << US, 9998, 1, 807700)
(AMETHYSTS, MARKET << US, 9998, 1, 807700)","{""AMETHYSTS"": 13, ""STARFRUIT"": 20}",5582,5088,9997
807800,19992,-206147,"(AMETHYSTS, MARKET << US, 9996, 1, 807800)
(AMETHYSTS, MARKET << US, 9996, 1, 807800)","{""AMETHYSTS"": 11, ""STARFRUIT"": 20}",5633,5089,10000
808500,0,-206147,,"{""AMETHYSTS"": 11, ""STARFRUIT"": 20}",5633,5089,10000
808700,-20010,-226157,"(AMETHYSTS, US << MARKET, 10005, 1, 808700)
(AMETHYSTS, US << MARKET, 10005, 1, 808700)","{""AMETHYSTS"": 13, ""STARFRUIT"": 20}",5682,5090,10003
808800,5091,-221066,"(STARFRUIT, MARKET << US, 5091, 1, 808800)","{""AMETHYSTS"": 13, ""STARFRUIT"": 19}",5682,5092,10000
808900,-9822,-230888,"(AMETHYSTS, US << MARKET, 9998, 1, 808900)
(AMETHYSTS, US << MARKET, 9998, 1, 808900)
(STARFRUIT, MARKET << US, 5087, 1, 808900)
(STARFRUIT, MARKET << US, 5087, 1, 808900)","{""AMETHYSTS"": 15, ""STARFRUIT"": 17}",5529,5086,9997
809000,-5092,-235980,"(STARFRUIT, US << MARKET, 5092, 1, 809000)","{""AMETHYSTS"": 15, ""STARFRUIT"": 18}",5676,5092,10000
809100,9998,-225982,"(AMETHYSTS, MARKET << US, 9998, 1, 809100)","{""AMETHYSTS"": 14, ""STARFRUIT"": 18}",5578,5089,9997
809400,0,-225982,"(AMETHYSTS, US << MARKET, 9996, 1, 809400)
(AMETHYSTS, US << MARKET, 9996, 1, 809400)
(AMETHYSTS, MARKET << US, 9996, 1, 809400)
(AMETHYSTS, MARKET << US, 9996, 1, 809400)","{""AMETHYSTS"": 14, ""STARFRUIT"": 18}",5638,5090,10000
809500,-19996,-245978,"(AMETHYSTS, US << MARKET, 9998, 1, 809500)
(AMETHYSTS, US << MARKET, 9998, 1, 809500)","{""AMETHYSTS"": 16, ""STARFRUIT"": 18}",5596,5091,9996
809600,45801,-200177,"(STARFRUIT, MARKET << US, 5089, 1, 809600)
(STARFRUIT, MARKET << US, 5089, 1, 809600)
(STARFRUIT, MARKET << US, 5089, 1, 809600)
(STARFRUIT, MARKET << US, 5089, 1, 809600)
(STARFRUIT, MARKET << US, 5089, 1, 809600)
(STARFRUIT, MARKET << US, 5089, 1, 809600)
(STARFRUIT, MARKET << US, 5089, 1, 809600)
(STARFRUIT, MARKET << US, 5089, 1, 809600)
(STARFRUIT, MARKET << US, 5089, 1, 809600)","{""AMETHYSTS"": 16, ""STARFRUIT"": 9}",5626,5091,9999
809900,15275,-184902,"(STARFRUIT, US << MARKET, 5093, 1, 809900)
(STARFRUIT, MARKET << US, 5092, 1, 809900)
(STARFRUIT, MARKET << US, 5092, 1, 809900)
(STARFRUIT, MARKET << US, 5092, 1, 809900)
(STARFRUIT, MARKET << US, 5092, 1, 809900)","{""AMETHYSTS"": 16, ""STARFRUIT"": 6}",5672,5093,10001
810300,-19824,-204726,"(AMETHYSTS, US << MARKET, 10002, 1, 810300)
(AMETHYSTS, US << MARKET, 10005, 1, 810300)
(AMETHYSTS, US << MARKET, 10005, 1, 810300)
(STARFRUIT, MARKET << US, 5094, 1, 810300)
(STARFRUIT, MARKET << US, 5094, 1, 810300)","{""AMETHYSTS"": 19, ""STARFRUIT"": 4}",5691,5090,10003
811200,-9998,-214724,"(AMETHYSTS, US << MARKET, 9998, 1, 811200)","{""AMETHYSTS"": 20, ""STARFRUIT"": 4}",5644,5087,10001
811300,9826,-204898,"(AMETHYSTS, MARKET << US, 10005, 1, 811300)
(AMETHYSTS, MARKET << US, 10005, 1, 811300)
(STARFRUIT, US << MARKET, 5092, 1, 811300)
(STARFRUIT, US << MARKET, 5092, 1, 811300)","{""AMETHYSTS"": 18, ""STARFRUIT"": 6}",5648,5091,10000
811700,5090,-199808,"(STARFRUIT, MARKET << US, 5090, 1, 811700)","{""AMETHYSTS"": 18, ""STARFRUIT"": 5}",5647,5091,10000
812100,25445,-174363,"(STARFRUIT, MARKET << US, 5089, 1, 812100)
(STARFRUIT, MARKET << US, 5089, 1, 812100)
(STARFRUIT, MARKET << US, 5089, 1, 812100)
(STARFRUIT, MARKET << US, 5089, 1, 812100)
(STARFRUIT, MARKET << US, 5089, 1, 812100)","{""AMETHYSTS"": 18, ""STARFRUIT"": 0}",5637,5090,10000
812300,5089,-169274,"(STARFRUIT, MARKET << US, 5089, 1, 812300)","{""AMETHYSTS"": 18, ""STARFRUIT"": -1}",5637,5089,10000
813300,-10002,-179276,"(AMETHYSTS, US << MARKET, 10002, 1, 813300)","{""AMETHYSTS"": 19, ""STARFRUIT"": -1}",5620,5085,9999
813400,-10162,-189438,"(STARFRUIT, US << MARKET, 5081, 1, 813400)
(STARFRUIT, US << MARKET, 5081, 1, 813400)","{""AMETHYSTS"": 19, ""STARFRUIT"": 1}",5646,5084,10000
813500,40008,-149430,"(AMETHYSTS, MARKET << US, 10002, 1, 813500)
(AMETHYSTS, MARKET << US, 10002, 1, 813500)
(AMETHYSTS, MARKET << US, 10002, 1, 813500)
(AMETHYSTS, MARKET << US, 10002, 1, 813500)","{""AMETHYSTS"": 15, ""STARFRUIT"": 1}",5700,5085,10003
814000,-10002,-159432,"(AMETHYSTS, US << MARKET, 10002, 1, 814000)","{""AMETHYSTS"": 16, ""STARFRUIT"": 1}",5654,5086,10000
814100,-39992,-199424,"(AMETHYSTS, US << MARKET, 9998, 1, 814100)
(AMETHYSTS, US << MARKET, 9998, 1, 814100)
(AMETHYSTS, US << MARKET, 9998, 1, 814100)
(AMETHYSTS, US << MARKET, 9998, 1, 814100)","{""AMETHYSTS"": 20, ""STARFRUIT"": 1}",5580,5084,9996
814300,5081,-194343,"(STARFRUIT, MARKET << US, 5081, 1, 814300)","{""AMETHYSTS"": 20, ""STARFRUIT"": 0}",5657,5084,10000
814500,79963,-114380,"(AMETHYSTS, MARKET << US, 9998, 1, 814500)
(AMETHYSTS, MARKET << US, 9995, 1, 814500)
(AMETHYSTS, MARKET << US, 9995, 1, 814500)
(AMETHYSTS, MARKET << US, 9995, 1, 814500)
(AMETHYSTS, MARKET << US, 9995, 1, 814500)
(AMETHYSTS, MARKET << US, 9995, 1, 814500)
(AMETHYSTS, MARKET << US, 9995, 1, 814500)
(AMETHYSTS, MARKET << US, 9995, 1, 814500)","{""AMETHYSTS"": 12, ""STARFRUIT"": 0}",5572,5084,9996
814600,-168,-114548,"(AMETHYSTS, MARKET << US, 9996, 1, 814600)
(STARFRUIT, US << MARKET, 5082, 1, 814600)
(STARFRUIT, US << MARKET, 5082, 1, 814600)","{""AMETHYSTS"": 11, ""STARFRUIT"": 2}",5616,5082,10000
814700,9998,-104550,"(AMETHYSTS, MARKET << US, 9998, 1, 814700)","{""AMETHYSTS"": 10, ""STARFRUIT"": 2}",5588,5084,9997
814800,5081,-99469,"(STARFRUIT, MARKET << US, 5081, 1, 814800)","{""AMETHYSTS"": 10, ""STARFRUIT"": 1}",5614,5083,10000
814900,-10159,-109628,"(STARFRUIT, US << MARKET, 5080, 1, 814900)
(STARFRUIT, US << MARKET, 5080, 1, 814900)
(STARFRUIT, US << MARKET, 5080, 1, 814900)
(STARFRUIT, US << MARKET, 5080, 1, 814900)
(STARFRUIT, US << MARKET, 5080, 1, 814900)
(STARFRUIT, MARKET << US, 5081, 1, 814900)
(STARFRUIT, MARKET << US, 5080, 1, 814900)
(STARFRUIT, MARKET << US, 5080, 1, 814900)","{""AMETHYSTS"": 10, ""STARFRUIT"": 3}",5612,5080,10000
816100,5085,-104543,"(STARFRUIT, MARKET << US, 5085, 1, 816100)","{""AMETHYSTS"": 10, ""STARFRUIT"": 2}",5627,5085,10000
816500,-10160,-114703,"(STARFRUIT, US << MARKET, 5080, 1, 816500)
(STARFRUIT, US << MARKET, 5080, 1, 816500)","{""AMETHYSTS"": 10, ""STARFRUIT"": 4}",5629,5083,10000
816800,-4918,-119621,"(AMETHYSTS, US << MARKET, 10004, 1, 816800)
(STARFRUIT, MARKET << US, 5086, 1, 816800)","{""AMETHYSTS"": 11, ""STARFRUIT"": 3}",5628,5083,10000
816900,-4917,-124538,"(AMETHYSTS, US << MARKET, 10000, 1, 816900)
(STARFRUIT, MARKET << US, 5083, 1, 816900)","{""AMETHYSTS"": 12, ""STARFRUIT"": 2}",5656,5085,10002
817000,15243,-109295,"(STARFRUIT, MARKET << US, 5081, 1, 817000)
(STARFRUIT, MARKET << US, 5081, 1, 817000)
(STARFRUIT, MARKET << US, 5081, 1, 817000)","{""AMETHYSTS"": 12, ""STARFRUIT"": -1}",5625,5080,10000
817100,-20008,-129303,"(AMETHYSTS, US << MARKET, 10004, 1, 817100)
(AMETHYSTS, US << MARKET, 10004, 1, 817100)","{""AMETHYSTS"": 14, ""STARFRUIT"": -1}",5615,5082,10000
817300,-40008,-169311,"(AMETHYSTS, US << MARKET, 10002, 1, 817300)
(AMETHYSTS, US << MARKET, 10002, 1, 817300)
(AMETHYSTS, US << MARKET, 10002, 1, 817300)
(AMETHYSTS, US << MARKET, 10002, 1, 817300)","{""AMETHYSTS"": 18, ""STARFRUIT"": -1}",5658,5085,10003
817700,-10164,-179475,"(STARFRUIT, US << MARKET, 5082, 1, 817700)
(STARFRUIT, US << MARKET, 5082, 1, 817700)","{""AMETHYSTS"": 18, ""STARFRUIT"": 1}",5607,5082,10000
817800,-25445,-204920,"(STARFRUIT, US << MARKET, 5089, 1, 817800)
(STARFRUIT, US << MARKET, 5089, 1, 817800)
(STARFRUIT, US << MARKET, 5089, 1, 817800)
(STARFRUIT, US << MARKET, 5089, 1, 817800)
(STARFRUIT, US << MARKET, 5089, 1, 817800)","{""AMETHYSTS"": 18, ""STARFRUIT"": 6}",5596,5086,10000
817900,-20344,-225264,"(STARFRUIT, US << MARKET, 5086, 1, 817900)
(STARFRUIT, US << MARKET, 5086, 1, 817900)
(STARFRUIT, US << MARKET, 5086, 1, 817900)
(STARFRUIT, US << MARKET, 5086, 1, 817900)","{""AMETHYSTS"": 18, ""STARFRUIT"": 10}",5556,5082,10000
818000,14919,-210345,"(AMETHYSTS, MARKET << US, 10004, 1, 818000)
(AMETHYSTS, MARKET << US, 10004, 1, 818000)
(STARFRUIT, US << MARKET, 5089, 1, 818000)","{""AMETHYSTS"": 16, ""STARFRUIT"": 11}",5601,5086,10000
818200,20184,-190161,"(AMETHYSTS, US << MARKET, 10004, 1, 818200)
(AMETHYSTS, MARKET << US, 10004, 1, 818200)
(AMETHYSTS, MARKET << US, 10004, 1, 818200)
(STARFRUIT, MARKET << US, 5090, 1, 818200)
(STARFRUIT, MARKET << US, 5090, 1, 818200)","{""AMETHYSTS"": 15, ""STARFRUIT"": 9}",5613,5086,10000
818400,5089,-185072,"(STARFRUIT, MARKET << US, 5089, 1, 818400)","{""AMETHYSTS"": 15, ""STARFRUIT"": 8}",5640,5089,10000
818600,4913,-180159,"(AMETHYSTS, MARKET << US, 10000, 1, 818600)
(STARFRUIT, US << MARKET, 5087, 1, 818600)","{""AMETHYSTS"": 14, ""STARFRUIT"": 9}",5587,5086,9998
818800,-10002,-190161,"(AMETHYSTS, US << MARKET, 10002, 1, 818800)","{""AMETHYSTS"": 15, ""STARFRUIT"": 9}",5676,5088,10003
819000,20344,-169817,"(STARFRUIT, MARKET << US, 5086, 1, 819000)
(STARFRUIT, MARKET << US, 5086, 1, 819000)
(STARFRUIT, MARKET << US, 5086, 1, 819000)
(STARFRUIT, MARKET << US, 5086, 1, 819000)","{""AMETHYSTS"": 15, ""STARFRUIT"": 5}",5628,5089,10000
819900,-19996,-189813,"(AMETHYSTS, US << MARKET, 9998, 1, 819900)
(AMETHYSTS, US << MARKET, 9998, 1, 819900)","{""AMETHYSTS"": 17, ""STARFRUIT"": 5}",5576,5088,9997
820100,35453,-154360,"(AMETHYSTS, US << MARKET, 10004, 1, 820100)
(AMETHYSTS, MARKET << US, 10004, 1, 820100)
(AMETHYSTS, MARKET << US, 10004, 1, 820100)
(STARFRUIT, MARKET << US, 5091, 1, 820100)
(STARFRUIT, MARKET << US, 5091, 1, 820100)
(STARFRUIT, MARKET << US, 5089, 1, 820100)
(STARFRUIT, MARKET << US, 5089, 1, 820100)
(STARFRUIT, MARKET << US, 5089, 1, 820100)","{""AMETHYSTS"": 16, ""STARFRUIT"": 0}",5640,5090,10000
820500,9998,-144362,"(AMETHYSTS, MARKET << US, 9998, 1, 820500)","{""AMETHYSTS"": 15, ""STARFRUIT"": 0}",5578,5090,9996
820600,5087,-139275,"(STARFRUIT, MARKET << US, 5087, 1, 820600)","{""AMETHYSTS"": 15, ""STARFRUIT"": -1}",5635,5090,10000
820900,-15264,-154539,"(STARFRUIT, US << MARKET, 5088, 1, 820900)
(STARFRUIT, US << MARKET, 5088, 1, 820900)
(STARFRUIT, US << MARKET, 5088, 1, 820900)
(STARFRUIT, US << MARKET, 5088, 1, 820900)
(STARFRUIT, US << MARKET, 5088, 1, 820900)
(STARFRUIT, US << MARKET, 5088, 1, 820900)
(STARFRUIT, MARKET << US, 5088, 1, 820900)
(STARFRUIT, MARKET << US, 5088, 1, 820900)
(STARFRUIT, MARKET << US, 5088, 1, 820900)","{""AMETHYSTS"": 15, ""STARFRUIT"": 2}",5643,5091,10000
821500,-39984,-194523,"(AMETHYSTS, US << MARKET, 9996, 1, 821500)
(AMETHYSTS, US << MARKET, 9996, 1, 821500)
(AMETHYSTS, US << MARKET, 9996, 1, 821500)
(AMETHYSTS, US << MARKET, 9996, 1, 821500)
(AMETHYSTS, US << MARKET, 9996, 1, 821500)
(AMETHYSTS, MARKET << US, 9996, 1, 821500)","{""AMETHYSTS"": 19, ""STARFRUIT"": 2}",5655,5089,10000
822000,9998,-184525,"(AMETHYSTS, MARKET << US, 9998, 1, 822000)","{""AMETHYSTS"": 18, ""STARFRUIT"": 2}",5663,5085,10001
822600,80016,-104509,"(AMETHYSTS, MARKET << US, 10002, 1, 822600)
(AMETHYSTS, MARKET << US, 10002, 1, 822600)
(AMETHYSTS, MARKET << US, 10002, 1, 822600)
(AMETHYSTS, MARKET << US, 10002, 1, 822600)
(AMETHYSTS, MARKET << US, 10002, 1, 822600)
(AMETHYSTS, MARKET << US, 10002, 1, 822600)
(AMETHYSTS, MARKET << US, 10002, 1, 822600)
(AMETHYSTS, MARKET << US, 10002, 1, 822600)","{""AMETHYSTS"": 10, ""STARFRUIT"": 2}",5697,5088,10003
822700,20352,-84157,"(STARFRUIT, MARKET << US, 5088, 1, 822700)
(STARFRUIT, MARKET << US, 5088, 1, 822700)
(STARFRUIT, MARKET << US, 5088, 1, 822700)
(STARFRUIT, MARKET << US, 5088, 1, 822700)","{""AMETHYSTS"": 10, ""STARFRUIT"": -2}",5669,5087,10000
822800,-30528,-114685,"(STARFRUIT, US << MARKET, 5088, 1, 822800)
(STARFRUIT, US << MARKET, 5088, 1, 822800)
(STARFRUIT, US << MARKET, 5088, 1, 822800)
(STARFRUIT, US << MARKET, 5088, 1, 822800)
(STARFRUIT, US << MARKET, 5088, 1, 822800)
(STARFRUIT, US << MARKET, 5088, 1, 822800)","{""AMETHYSTS"": 10, ""STARFRUIT"": 4}",5639,5086,9998
823200,-10170,-124855,"(STARFRUIT, US << MARKET, 5085, 1, 823200)
(STARFRUIT, US << MARKET, 5085, 1, 823200)","{""AMETHYSTS"": 10, ""STARFRUIT"": 6}",5673,5088,10000
824100,15260,-109595,"(STARFRUIT, US << MARKET, 5085, 1, 824100)
(STARFRUIT, US << MARKET, 5085, 1, 824100)
(STARFRUIT, MARKET << US, 5086, 1, 824100)
(STARFRUIT, MARKET << US, 5086, 1, 824100)
(STARFRUIT, MARKET << US, 5086, 1, 824100)
(STARFRUIT, MARKET << US, 5086, 1, 824100)
(STARFRUIT, MARKET << US, 5086, 1, 824100)","{""AMETHYSTS"": 10, ""STARFRUIT"": 3}",5682,5089,10001
825500,-35244,-144839,"(AMETHYSTS, US << MARKET, 9996, 1, 825500)
(AMETHYSTS, US << MARKET, 9996, 1, 825500)
(STARFRUIT, US << MARKET, 5084, 1, 825500)
(STARFRUIT, US << MARKET, 5084, 1, 825500)
(STARFRUIT, US << MARKET, 5084, 1, 825500)","{""AMETHYSTS"": 12, ""STARFRUIT"": 6}",5671,5087,9999
826200,5085,-139754,"(STARFRUIT, MARKET << US, 5085, 1, 826200)","{""AMETHYSTS"": 12, ""STARFRUIT"": 5}",5686,5088,10000
827000,-10182,-149936,"(STARFRUIT, US << MARKET, 5091, 1, 827000)
(STARFRUIT, US << MARKET, 5091, 1, 827000)","{""AMETHYSTS"": 12, ""STARFRUIT"": 7}",5701,5091,10000
827100,-10180,-160116,"(STARFRUIT, US << MARKET, 5090, 1, 827100)
(STARFRUIT, US << MARKET, 5090, 1, 827100)","{""AMETHYSTS"": 12, ""STARFRUIT"": 9}",5667,5087,10000
827400,-19996,-180112,"(AMETHYSTS, US << MARKET, 9998, 1, 827400)
(AMETHYSTS, US << MARKET, 9998, 1, 827400)","{""AMETHYSTS"": 14, ""STARFRUIT"": 9}",5638,5088,9997
827600,9998,-170114,"(AMETHYSTS, MARKET << US, 9998, 1, 827600)","{""AMETHYSTS"": 13, ""STARFRUIT"": 9}",5621,5086,9997
827800,-162,-170276,"(AMETHYSTS, US << MARKET, 10004, 1, 827800)
(AMETHYSTS, MARKET << US, 10004, 1, 827800)
(AMETHYSTS, MARKET << US, 10004, 1, 827800)
(STARFRUIT, US << MARKET, 5083, 1, 827800)
(STARFRUIT, US << MARKET, 5083, 1, 827800)
(STARFRUIT, US << MARKET, 5083, 1, 827800)
(STARFRUIT, US << MARKET, 5083, 1, 827800)
(STARFRUIT, MARKET << US, 5083, 1, 827800)
(STARFRUIT, MARKET << US, 5083, 1, 827800)","{""AMETHYSTS"": 12, ""STARFRUIT"": 11}",5670,5086,10000
828200,-34898,-205174,"(AMETHYSTS, US << MARKET, 9995, 1, 828200)
(AMETHYSTS, US << MARKET, 9995, 1, 828200)
(AMETHYSTS, US << MARKET, 9995, 1, 828200)
(AMETHYSTS, US << MARKET, 9995, 1, 828200)
(STARFRUIT, US << MARKET, 5082, 1, 828200)
(STARFRUIT, MARKET << US, 5082, 1, 828200)
(STARFRUIT, MARKET << US, 5082, 1, 828200)","{""AMETHYSTS"": 16, ""STARFRUIT"": 10}",5676,5085,10000
828700,5087,-200087,"(STARFRUIT, MARKET << US, 5087, 1, 828700)","{""AMETHYSTS"": 16, ""STARFRUIT"": 9}",5705,5088,10000
829300,45810,-154277,"(STARFRUIT, MARKET << US, 5090, 1, 829300)
(STARFRUIT, MARKET << US, 5090, 1, 829300)
(STARFRUIT, MARKET << US, 5090, 1, 829300)
(STARFRUIT, MARKET << US, 5090, 1, 829300)
(STARFRUIT, MARKET << US, 5090, 1, 829300)
(STARFRUIT, MARKET << US, 5090, 1, 829300)
(STARFRUIT, MARKET << US, 5090, 1, 829300)
(STARFRUIT, MARKET << US, 5090, 1, 829300)
(STARFRUIT, MARKET << US, 5090, 1, 829300)","{""AMETHYSTS"": 16, ""STARFRUIT"": 0}",5723,5086,10000
829500,9842,-144435,"(AMETHYSTS, MARKET << US, 10004, 1, 829500)
(AMETHYSTS, MARKET << US, 10004, 1, 829500)
(STARFRUIT, US << MARKET, 5083, 1, 829500)
(STARFRUIT, US << MARKET, 5083, 1, 829500)","{""AMETHYSTS"": 14, ""STARFRUIT"": 2}",5729,5082,10000
829600,80016,-64419,"(AMETHYSTS, MARKET << US, 10002, 1, 829600)
(AMETHYSTS, MARKET << US, 10002, 1, 829600)
(AMETHYSTS, MARKET << US, 10002, 1, 829600)
(AMETHYSTS, MARKET << US, 10002, 1, 829600)
(AMETHYSTS, MARKET << US, 10002, 1, 829600)
(AMETHYSTS, MARKET << US, 10002, 1, 829600)
(AMETHYSTS, MARKET << US, 10002, 1, 829600)
(AMETHYSTS, MARKET << US, 10002, 1, 829600)","{""AMETHYSTS"": 6, ""STARFRUIT"": 2}",5769,5085,10003
830500,-19996,-84415,"(AMETHYSTS, US << MARKET, 9998, 1, 830500)
(AMETHYSTS, US << MARKET, 9998, 1, 830500)","{""AMETHYSTS"": 8, ""STARFRUIT"": 2}",5729,5084,9997
830600,80016,-4399,"(AMETHYSTS, MARKET << US, 10002, 1, 830600)
(AMETHYSTS, MARKET << US, 10002, 1, 830600)
(AMETHYSTS, MARKET << US, 10002, 1, 830600)
(AMETHYSTS, MARKET << US, 10002, 1, 830600)
(AMETHYSTS, MARKET << US, 10002, 1, 830600)
(AMETHYSTS, MARKET << US, 10002, 1, 830600)
(AMETHYSTS, MARKET << US, 10002, 1, 830600)
(AMETHYSTS, MARKET << US, 10002, 1, 830600)","{""AMETHYSTS"": 0, ""STARFRUIT"": 2}",5769,5084,10003
830900,20004,15605,"(AMETHYSTS, MARKET << US, 10002, 1, 830900)
(AMETHYSTS, MARKET << US, 10002, 1, 830900)","{""AMETHYSTS"": -2, ""STARFRUIT"": 2}",5767,5084,10003
831300,19992,35597,"(AMETHYSTS, MARKET << US, 9996, 1, 831300)
(AMETHYSTS, MARKET << US, 9996, 1, 831300)","{""AMETHYSTS"": -4, ""STARFRUIT"": 2}",5771,5085,9999
831400,-19996,15601,"(AMETHYSTS, US << MARKET, 9998, 1, 831400)
(AMETHYSTS, US << MARKET, 9998, 1, 831400)","{""AMETHYSTS"": -2, ""STARFRUIT"": 2}",5769,5086,10002
831800,9998,25599,"(AMETHYSTS, MARKET << US, 9998, 1, 831800)","{""AMETHYSTS"": -3, ""STARFRUIT"": 2}",5783,5086,9996
832100,-10180,15419,"(STARFRUIT, US << MARKET, 5090, 1, 832100)
(STARFRUIT, US << MARKET, 5090, 1, 832100)","{""AMETHYSTS"": -3, ""STARFRUIT"": 4}",5782,5090,9999
832300,15255,30674,"(STARFRUIT, MARKET << US, 5085, 1, 832300)
(STARFRUIT, MARKET << US, 5085, 1, 832300)
(STARFRUIT, MARKET << US, 5085, 1, 832300)","{""AMETHYSTS"": -3, ""STARFRUIT"": 1}",5762,5088,10000
832500,-59988,-29314,"(AMETHYSTS, US << MARKET, 9998, 1, 832500)
(AMETHYSTS, US << MARKET, 9998, 1, 832500)
(AMETHYSTS, US << MARKET, 9998, 1, 832500)
(AMETHYSTS, US << MARKET, 9998, 1, 832500)
(AMETHYSTS, US << MARKET, 9998, 1, 832500)
(AMETHYSTS, US << MARKET, 9998, 1, 832500)","{""AMETHYSTS"": 3, ""STARFRUIT"": 1}",5761,5087,9996
833000,-30006,-59320,"(AMETHYSTS, US << MARKET, 10002, 1, 833000)
(AMETHYSTS, US << MARKET, 10002, 1, 833000)
(AMETHYSTS, US << MARKET, 10002, 1, 833000)","{""AMETHYSTS"": 6, ""STARFRUIT"": 1}",5760,5086,9999
833700,-10180,-69500,"(STARFRUIT, US << MARKET, 5090, 1, 833700)
(STARFRUIT, US << MARKET, 5090, 1, 833700)","{""AMETHYSTS"": 6, ""STARFRUIT"": 3}",5770,5090,10000
834200,5090,-64410,"(STARFRUIT, MARKET << US, 5090, 1, 834200)","{""AMETHYSTS"": 6, ""STARFRUIT"": 2}",5778,5091,10001
834300,-30176,-94586,"(AMETHYSTS, US << MARKET, 9998, 1, 834300)
(AMETHYSTS, US << MARKET, 9998, 1, 834300)
(STARFRUIT, US << MARKET, 5090, 1, 834300)
(STARFRUIT, US << MARKET, 5090, 1, 834300)","{""AMETHYSTS"": 8, ""STARFRUIT"": 4}",5786,5091,10001
834400,-45241,-139827,"(AMETHYSTS, US << MARKET, 9996, 1, 834400)
(AMETHYSTS, US << MARKET, 9996, 1, 834400)
(AMETHYSTS, US << MARKET, 9996, 1, 834400)
(AMETHYSTS, US << MARKET, 9996, 1, 834400)
(AMETHYSTS, MARKET << US, 9998, 1, 834400)
(STARFRUIT, US << MARKET, 5085, 1, 834400)
(STARFRUIT, US << MARKET, 5085, 1, 834400)
(STARFRUIT, US << MARKET, 5085, 1, 834400)","{""AMETHYSTS"": 11, ""STARFRUIT"": 7}",5756,5088,9997
834500,5085,-134742,"(STARFRUIT, MARKET << US, 5085, 1, 834500)","{""AMETHYSTS"": 11, ""STARFRUIT"": 6}",5786,5088,10000
834600,5086,-129656,"(STARFRUIT, MARKET << US, 5086, 1, 834600)","{""AMETHYSTS"": 11, ""STARFRUIT"": 5}",5769,5085,10000
834700,-19992,-149648,"(AMETHYSTS, US << MARKET, 9996, 1, 834700)
(AMETHYSTS, US << MARKET, 9996, 1, 834700)","{""AMETHYSTS"": 13, ""STARFRUIT"": 5}",5779,5088,9999
834800,-10002,-159650,"(AMETHYSTS, US << MARKET, 10002, 1, 834800)","{""AMETHYSTS"": 14, ""STARFRUIT"": 5}",5832,5088,10003
834900,-174,-159824,"(AMETHYSTS, MARKET << US, 9996, 1, 834900)
(STARFRUIT, US << MARKET, 5085, 1, 834900)
(STARFRUIT, US << MARKET, 5085, 1, 834900)","{""AMETHYSTS"": 13, ""STARFRUIT"": 7}",5792,5088,10000
836100,-5084,-164908,"(STARFRUIT, US << MARKET, 5084, 1, 836100)","{""AMETHYSTS"": 13, ""STARFRUIT"": 8}",5741,5086,9997
836300,-20336,-185244,"(STARFRUIT, US << MARKET, 5084, 1, 836300)
(STARFRUIT, US << MARKET, 5084, 1, 836300)
(STARFRUIT, US << MARKET, 5084, 1, 836300)
(STARFRUIT, US << MARKET, 5084, 1, 836300)","{""AMETHYSTS"": 13, ""STARFRUIT"": 12}",5787,5087,9999
836600,20004,-165240,"(AMETHYSTS, MARKET << US, 10002, 1, 836600)
(AMETHYSTS, MARKET << US, 10002, 1, 836600)","{""AMETHYSTS"": 11, ""STARFRUIT"": 12}",5792,5086,10000
836700,-5088,-170328,"(STARFRUIT, US << MARKET, 5088, 1, 836700)","{""AMETHYSTS"": 11, ""STARFRUIT"": 13}",5827,5088,10001
836900,-5083,-175411,"(STARFRUIT, US << MARKET, 5083, 1, 836900)","{""AMETHYSTS"": 11, ""STARFRUIT"": 14}",5768,5085,9999
837600,-5084,-180495,"(STARFRUIT, US << MARKET, 5084, 1, 837600)","{""AMETHYSTS"": 11, ""STARFRUIT"": 15}",5810,5087,10000
838000,9998,-170497,"(AMETHYSTS, MARKET << US, 9998, 1, 838000)","{""AMETHYSTS"": 10, ""STARFRUIT"": 15}",5768,5085,9999
838600,30334,-140163,"(AMETHYSTS, MARKET << US, 9998, 1, 838600)
(STARFRUIT, MARKET << US, 5084, 1, 838600)
(STARFRUIT, MARKET << US, 5084, 1, 838600)
(STARFRUIT, MARKET << US, 5084, 1, 838600)
(STARFRUIT, MARKET << US, 5084, 1, 838600)","{""AMETHYSTS"": 9, ""STARFRUIT"": 11}",5714,5083,9996
838900,-20332,-160495,"(STARFRUIT, US << MARKET, 5083, 1, 838900)
(STARFRUIT, US << MARKET, 5083, 1, 838900)
(STARFRUIT, US << MARKET, 5083, 1, 838900)
(STARFRUIT, US << MARKET, 5083, 1, 838900)","{""AMETHYSTS"": 9, ""STARFRUIT"": 15}",5795,5086,10000
839300,-39984,-200479,"(AMETHYSTS, US << MARKET, 9996, 1, 839300)
(AMETHYSTS, US << MARKET, 9996, 1, 839300)
(AMETHYSTS, US << MARKET, 9996, 1, 839300)
(AMETHYSTS, US << MARKET, 9996, 1, 839300)","{""AMETHYSTS"": 13, ""STARFRUIT"": 15}",5785,5086,9998
839700,-4913,-205392,"(AMETHYSTS, US << MARKET, 10002, 1, 839700)
(STARFRUIT, MARKET << US, 5089, 1, 839700)","{""AMETHYSTS"": 14, ""STARFRUIT"": 14}",5854,5088,10001
840000,15089,-190303,"(AMETHYSTS, MARKET << US, 9998, 1, 840000)
(STARFRUIT, MARKET << US, 5091, 1, 840000)","{""AMETHYSTS"": 13, ""STARFRUIT"": 13}",5776,5087,9996
840100,5086,-185217,"(STARFRUIT, US << MARKET, 5084, 1, 840100)
(STARFRUIT, MARKET << US, 5085, 1, 840100)
(STARFRUIT, MARKET << US, 5085, 1, 840100)","{""AMETHYSTS"": 13, ""STARFRUIT"": 12}",5791,5084,10000
840600,-5084,-190301,"(STARFRUIT, US << MARKET, 5084, 1, 840600)","{""AMETHYSTS"": 13, ""STARFRUIT"": 13}",5830,5087,10000
840700,74932,-115369,"(AMETHYSTS, MARKET << US, 10002, 1, 840700)
(AMETHYSTS, MARKET << US, 10002, 1, 840700)
(AMETHYSTS, MARKET << US, 10002, 1, 840700)
(AMETHYSTS, MARKET << US, 10002, 1, 840700)
(AMETHYSTS, MARKET << US, 10002, 1, 840700)
(AMETHYSTS, MARKET << US, 10002, 1, 840700)
(AMETHYSTS, MARKET << US, 10002, 1, 840700)
(AMETHYSTS, MARKET << US, 10002, 1, 840700)
(STARFRUIT, US << MARKET, 5084, 1, 840700)","{""AMETHYSTS"": 5, ""STARFRUIT"": 14}",5808,5083,10003
840800,-19996,-135365,"(AMETHYSTS, US << MARKET, 9998, 1, 840800)
(AMETHYSTS, US << MARKET, 9998, 1, 840800)","{""AMETHYSTS"": 7, ""STARFRUIT"": 14}",5888,5089,10001
841300,-50010,-185375,"(AMETHYSTS, US << MARKET, 10002, 1, 841300)
(AMETHYSTS, US << MARKET, 10002, 1, 841300)
(AMETHYSTS, US << MARKET, 10002, 1, 841300)
(AMETHYSTS, US << MARKET, 10002, 1, 841300)
(AMETHYSTS, US << MARKET, 10002, 1, 841300)","{""AMETHYSTS"": 12, ""STARFRUIT"": 14}",5865,5086,10003
841400,5088,-180287,"(STARFRUIT, MARKET << US, 5088, 1, 841400)","{""AMETHYSTS"": 12, ""STARFRUIT"": 13}",5857,5088,10000
841500,20008,-160279,"(AMETHYSTS, MARKET << US, 10004, 1, 841500)
(AMETHYSTS, MARKET << US, 10004, 1, 841500)","{""AMETHYSTS"": 10, ""STARFRUIT"": 13}",5878,5089,10000
841800,-20360,-180639,"(STARFRUIT, US << MARKET, 5090, 1, 841800)
(STARFRUIT, US << MARKET, 5090, 1, 841800)
(STARFRUIT, US << MARKET, 5090, 1, 841800)
(STARFRUIT, US << MARKET, 5090, 1, 841800)","{""AMETHYSTS"": 10, ""STARFRUIT"": 17}",5867,5088,10001
842000,30552,-150087,"(STARFRUIT, US << MARKET, 5092, 1, 842000)
(STARFRUIT, US << MARKET, 5092, 1, 842000)
(STARFRUIT, US << MARKET, 5092, 1, 842000)
(STARFRUIT, MARKET << US, 5092, 1, 842000)
(STARFRUIT, MARKET << US, 5092, 1, 842000)
(STARFRUIT, MARKET << US, 5092, 1, 842000)
(STARFRUIT, MARKET << US, 5092, 1, 842000)
(STARFRUIT, MARKET << US, 5092, 1, 842000)
(STARFRUIT, MARKET << US, 5092, 1, 842000)
(STARFRUIT, MARKET << US, 5092, 1, 842000)
(STARFRUIT, MARKET << US, 5092, 1, 842000)
(STARFRUIT, MARKET << US, 5092, 1, 842000)","{""AMETHYSTS"": 10, ""STARFRUIT"": 11}",5881,5088,10000
842200,-20340,-170427,"(STARFRUIT, US << MARKET, 5085, 1, 842200)
(STARFRUIT, US << MARKET, 5085, 1, 842200)
(STARFRUIT, US << MARKET, 5085, 1, 842200)
(STARFRUIT, US << MARKET, 5085, 1, 842200)","{""AMETHYSTS"": 10, ""STARFRUIT"": 15}",5923,5088,10003
842300,5090,-165337,"(STARFRUIT, MARKET << US, 5090, 1, 842300)","{""AMETHYSTS"": 10, ""STARFRUIT"": 14}",5937,5091,10000
842500,690,-164647,"(AMETHYSTS, US << MARKET, 10002, 1, 842500)
(AMETHYSTS, US << MARKET, 10002, 1, 842500)
(AMETHYSTS, US << MARKET, 10002, 1, 842500)
(AMETHYSTS, US << MARKET, 10002, 1, 842500)
(STARFRUIT, MARKET << US, 5088, 1, 842500)
(STARFRUIT, MARKET << US, 5088, 1, 842500)
(STARFRUIT, MARKET << US, 5088, 1, 842500)
(STARFRUIT, MARKET << US, 5088, 1, 842500)
(STARFRUIT, MARKET << US, 5088, 1, 842500)
(STARFRUIT, MARKET << US, 5086, 1, 842500)
(STARFRUIT, MARKET << US, 5086, 1, 842500)
(STARFRUIT, MARKET << US, 5086, 1, 842500)","{""AMETHYSTS"": 14, ""STARFRUIT"": 6}",5849,5085,9999
842600,-10170,-174817,"(STARFRUIT, US << MARKET, 5085, 1, 842600)
(STARFRUIT, US << MARKET, 5085, 1, 842600)","{""AMETHYSTS"": 14, ""STARFRUIT"": 8}",5879,5087,10000
842700,-10002,-184819,"(AMETHYSTS, US << MARKET, 10002, 1, 842700)","{""AMETHYSTS"": 15, ""STARFRUIT"": 8}",5832,5087,9997
843000,19996,-164823,"(AMETHYSTS, MARKET << US, 9998, 1, 843000)
(AMETHYSTS, MARKET << US, 9998, 1, 843000)","{""AMETHYSTS"": 13, ""STARFRUIT"": 8}",5826,5086,9997
843100,-50010,-214833,"(AMETHYSTS, US << MARKET, 10002, 1, 843100)
(AMETHYSTS, US << MARKET, 10002, 1, 843100)
(AMETHYSTS, US << MARKET, 10002, 1, 843100)
(AMETHYSTS, US << MARKET, 10002, 1, 843100)
(AMETHYSTS, US << MARKET, 10002, 1, 843100)","{""AMETHYSTS"": 18, ""STARFRUIT"": 8}",5917,5087,10003
843400,-5083,-219916,"(STARFRUIT, US << MARKET, 5083, 1, 843400)","{""AMETHYSTS"": 18, ""STARFRUIT"": 9}",5786,5084,9997
843900,-10005,-229921,"(AMETHYSTS, US << MARKET, 10005, 1, 843900)
(STARFRUIT, US << MARKET, 5087, 1, 843900)
(STARFRUIT, MARKET << US, 5087, 1, 843900)","{""AMETHYSTS"": 19, ""STARFRUIT"": 9}",5835,5084,10000
844000,20004,-209917,"(AMETHYSTS, MARKET << US, 10002, 1, 844000)
(AMETHYSTS, MARKET << US, 10002, 1, 844000)","{""AMETHYSTS"": 17, ""STARFRUIT"": 9}",5908,5086,10003
844200,90014,-119903,"(AMETHYSTS, MARKET << US, 10002, 1, 844200)
(AMETHYSTS, MARKET << US, 10002, 1, 844200)
(AMETHYSTS, MARKET << US, 10002, 1, 844200)
(AMETHYSTS, MARKET << US, 10002, 1, 844200)
(AMETHYSTS, MARKET << US, 10002, 1, 844200)
(AMETHYSTS, MARKET << US, 10002, 1, 844200)
(AMETHYSTS, MARKET << US, 10002, 1, 844200)
(AMETHYSTS, MARKET << US, 10002, 1, 844200)
(AMETHYSTS, MARKET << US, 9998, 1, 844200)","{""AMETHYSTS"": 8, ""STARFRUIT"": 9}",5877,5084,10003
844400,45078,-74825,"(AMETHYSTS, MARKET << US, 9998, 1, 844400)
(AMETHYSTS, MARKET << US, 9998, 1, 844400)
(AMETHYSTS, MARKET << US, 9998, 1, 844400)
(AMETHYSTS, MARKET << US, 9998, 1, 844400)
(STARFRUIT, MARKET << US, 5086, 1, 844400)","{""AMETHYSTS"": 4, ""STARFRUIT"": 8}",5867,5086,10001
845700,-25070,-99895,"(AMETHYSTS, US << MARKET, 9995, 1, 845700)
(AMETHYSTS, US << MARKET, 9995, 1, 845700)
(STARFRUIT, US << MARKET, 5080, 1, 845700)","{""AMETHYSTS"": 6, ""STARFRUIT"": 9}",5852,5083,10000
846100,29994,-69901,"(AMETHYSTS, MARKET << US, 9998, 1, 846100)
(AMETHYSTS, MARKET << US, 9998, 1, 846100)
(AMETHYSTS, MARKET << US, 9998, 1, 846100)","{""AMETHYSTS"": 3, ""STARFRUIT"": 9}",5840,5082,10001
846300,89982,20081,"(AMETHYSTS, MARKET << US, 9998, 1, 846300)
(AMETHYSTS, MARKET << US, 9998, 1, 846300)
(AMETHYSTS, MARKET << US, 9998, 1, 846300)
(AMETHYSTS, MARKET << US, 9998, 1, 846300)
(AMETHYSTS, MARKET << US, 9998, 1, 846300)
(AMETHYSTS, MARKET << US, 9998, 1, 846300)
(AMETHYSTS, MARKET << US, 9998, 1, 846300)
(AMETHYSTS, MARKET << US, 9998, 1, 846300)
(AMETHYSTS, MARKET << US, 9998, 1, 846300)","{""AMETHYSTS"": -6, ""STARFRUIT"": 9}",5840,5085,10001
846400,-84946,-64865,"(AMETHYSTS, US << MARKET, 9995, 1, 846400)
(AMETHYSTS, US << MARKET, 9995, 1, 846400)
(AMETHYSTS, US << MARKET, 10005, 1, 846400)
(AMETHYSTS, US << MARKET, 10005, 1, 846400)
(AMETHYSTS, US << MARKET, 10005, 1, 846400)
(AMETHYSTS, US << MARKET, 10005, 1, 846400)
(AMETHYSTS, US << MARKET, 10005, 1, 846400)
(AMETHYSTS, US << MARKET, 10005, 1, 846400)
(AMETHYSTS, US << MARKET, 10005, 1, 846400)
(STARFRUIT, MARKET << US, 5079, 1, 846400)","{""AMETHYSTS"": 3, ""STARFRUIT"": 8}",5791,5082,10000
846800,-30180,-95045,"(AMETHYSTS, US << MARKET, 10005, 1, 846800)
(AMETHYSTS, US << MARKET, 10005, 1, 846800)
(STARFRUIT, US << MARKET, 5085, 1, 846800)
(STARFRUIT, US << MARKET, 5085, 1, 846800)","{""AMETHYSTS"": 5, ""STARFRUIT"": 10}",5780,5081,10003
846900,25093,-69952,"(AMETHYSTS, MARKET << US, 10004, 1, 846900)
(AMETHYSTS, MARKET << US, 10004, 1, 846900)
(STARFRUIT, MARKET << US, 5085, 1, 846900)","{""AMETHYSTS"": 3, ""STARFRUIT"": 9}",5789,5082,10001
847000,-10002,-79954,"(AMETHYSTS, US << MARKET, 10002, 1, 847000)","{""AMETHYSTS"": 4, ""STARFRUIT"": 9}",5767,5081,9998
848100,-30182,-110136,"(AMETHYSTS, US << MARKET, 10004, 1, 848100)
(AMETHYSTS, US << MARKET, 10004, 1, 848100)
(STARFRUIT, US << MARKET, 5087, 1, 848100)
(STARFRUIT, US << MARKET, 5087, 1, 848100)","{""AMETHYSTS"": 6, ""STARFRUIT"": 11}",5777,5083,10000
848600,10166,-99970,"(STARFRUIT, MARKET << US, 5083, 1, 848600)
(STARFRUIT, MARKET << US, 5083, 1, 848600)","{""AMETHYSTS"": 6, ""STARFRUIT"": 9}",5756,5082,9998
849000,9998,-89972,"(AMETHYSTS, MARKET << US, 9998, 1, 849000)","{""AMETHYSTS"": 5, ""STARFRUIT"": 9}",5746,5082,9996
849100,10478,-79494,"(AMETHYSTS, US << MARKET, 9998, 1, 849100)
(AMETHYSTS, US << MARKET, 9998, 1, 849100)
(STARFRUIT, MARKET << US, 5079, 1, 849100)
(STARFRUIT, MARKET << US, 5079, 1, 849100)
(STARFRUIT, MARKET << US, 5079, 1, 849100)
(STARFRUIT, MARKET << US, 5079, 1, 849100)
(STARFRUIT, MARKET << US, 5079, 1, 849100)
(STARFRUIT, MARKET << US, 5079, 1, 849100)","{""AMETHYSTS"": 7, ""STARFRUIT"": 3}",5724,5082,9996
849400,40008,-39486,"(AMETHYSTS, MARKET << US, 10002, 1, 849400)
(AMETHYSTS, MARKET << US, 10002, 1, 849400)
(AMETHYSTS, MARKET << US, 10002, 1, 849400)
(AMETHYSTS, MARKET << US, 10002, 1, 849400)","{""AMETHYSTS"": 3, ""STARFRUIT"": 3}",5766,5081,10003
849600,-10156,-49642,"(STARFRUIT, US << MARKET, 5078, 1, 849600)
(STARFRUIT, US << MARKET, 5078, 1, 849600)","{""AMETHYSTS"": 3, ""STARFRUIT"": 5}",5767,5080,10003
849700,9998,-39644,"(AMETHYSTS, MARKET << US, 9998, 1, 849700)","{""AMETHYSTS"": 2, ""STARFRUIT"": 5}",5763,5081,10001
849900,9998,-29646,"(AMETHYSTS, MARKET << US, 9998, 1, 849900)","{""AMETHYSTS"": 1, ""STARFRUIT"": 5}",5750,5080,9996
850500,-20320,-49966,"(STARFRUIT, US << MARKET, 5080, 1, 850500)
(STARFRUIT, US << MARKET, 5080, 1, 850500)
(STARFRUIT, US << MARKET, 5080, 1, 850500)
(STARFRUIT, US << MARKET, 5080, 1, 850500)","{""AMETHYSTS"": 1, ""STARFRUIT"": 9}",5763,5081,10000
850700,-5080,-55046,"(STARFRUIT, US << MARKET, 5080, 1, 850700)","{""AMETHYSTS"": 1, ""STARFRUIT"": 10}",5764,5081,10000
850800,-15082,-70128,"(AMETHYSTS, US << MARKET, 10002, 1, 850800)
(STARFRUIT, US << MARKET, 5080, 1, 850800)","{""AMETHYSTS"": 2, ""STARFRUIT"": 11}",5769,5081,10003
851000,15070,-55058,"(AMETHYSTS, MARKET << US, 9996, 1, 851000)
(STARFRUIT, MARKET << US, 5074, 1, 851000)","{""AMETHYSTS"": 1, ""STARFRUIT"": 10}",5712,5077,10000
851100,-80032,-135090,"(AMETHYSTS, US << MARKET, 10004, 1, 851100)
(AMETHYSTS, US << MARKET, 10004, 1, 851100)
(AMETHYSTS, US << MARKET, 10004, 1, 851100)
(AMETHYSTS, US << MARKET, 10004, 1, 851100)
(AMETHYSTS, US << MARKET, 10004, 1, 851100)
(AMETHYSTS, US << MARKET, 10004, 1, 851100)
(AMETHYSTS, US << MARKET, 10004, 1, 851100)
(AMETHYSTS, US << MARKET, 10004, 1, 851100)
(AMETHYSTS, US << MARKET, 10004, 1, 851100)
(AMETHYSTS, US << MARKET, 10004, 1, 851100)
(AMETHYSTS, MARKET << US, 10004, 1, 851100)
(AMETHYSTS, MARKET << US, 10004, 1, 851100)","{""AMETHYSTS"": 9, ""STARFRUIT"": 10}",5690,5078,10000
851400,5079,-130011,"(STARFRUIT, MARKET << US, 5079, 1, 851400)","{""AMETHYSTS"": 9, ""STARFRUIT"": 9}",5691,5077,10001
851800,-15084,-145095,"(AMETHYSTS, US << MARKET, 10004, 1, 851800)
(STARFRUIT, US << MARKET, 5080, 1, 851800)","{""AMETHYSTS"": 10, ""STARFRUIT"": 10}",5675,5076,10001
852200,20004,-125091,"(AMETHYSTS, MARKET << US, 10002, 1, 852200)
(AMETHYSTS, MARKET << US, 10002, 1, 852200)","{""AMETHYSTS"": 8, ""STARFRUIT"": 10}",5643,5075,9998
853000,10428,-114663,"(AMETHYSTS, US << MARKET, 10002, 1, 853000)
(AMETHYSTS, US << MARKET, 10002, 1, 853000)
(STARFRUIT, MARKET << US, 5072, 1, 853000)
(STARFRUIT, MARKET << US, 5072, 1, 853000)
(STARFRUIT, MARKET << US, 5072, 1, 853000)
(STARFRUIT, MARKET << US, 5072, 1, 853000)
(STARFRUIT, MARKET << US, 5072, 1, 853000)
(STARFRUIT, MARKET << US, 5072, 1, 853000)","{""AMETHYSTS"": 10, ""STARFRUIT"": 4}",5667,5075,10003
853600,9862,-104801,"(AMETHYSTS, MARKET << US, 10005, 1, 853600)
(AMETHYSTS, MARKET << US, 10005, 1, 853600)
(STARFRUIT, US << MARKET, 5074, 1, 853600)
(STARFRUIT, US << MARKET, 5074, 1, 853600)","{""AMETHYSTS"": 8, ""STARFRUIT"": 6}",5637,5073,10000
853700,-19996,-124797,"(AMETHYSTS, US << MARKET, 9998, 1, 853700)
(AMETHYSTS, US << MARKET, 9998, 1, 853700)","{""AMETHYSTS"": 10, ""STARFRUIT"": 6}",5691,5078,10002
854300,25365,-99432,"(STARFRUIT, MARKET << US, 5073, 1, 854300)
(STARFRUIT, MARKET << US, 5073, 1, 854300)
(STARFRUIT, MARKET << US, 5073, 1, 854300)
(STARFRUIT, MARKET << US, 5073, 1, 854300)
(STARFRUIT, MARKET << US, 5073, 1, 854300)","{""AMETHYSTS"": 10, ""STARFRUIT"": 1}",5644,5076,10000
854500,-25365,-124797,"(STARFRUIT, US << MARKET, 5073, 1, 854500)
(STARFRUIT, US << MARKET, 5073, 1, 854500)
(STARFRUIT, US << MARKET, 5073, 1, 854500)
(STARFRUIT, US << MARKET, 5073, 1, 854500)
(STARFRUIT, US << MARKET, 5073, 1, 854500)","{""AMETHYSTS"": 10, ""STARFRUIT"": 6}",5615,5072,9998
854800,-20308,-145105,"(STARFRUIT, US << MARKET, 5077, 1, 854800)
(STARFRUIT, US << MARKET, 5077, 1, 854800)
(STARFRUIT, US << MARKET, 5077, 1, 854800)
(STARFRUIT, US << MARKET, 5077, 1, 854800)","{""AMETHYSTS"": 10, ""STARFRUIT"": 10}",5635,5075,9999
855300,5075,-140030,"(STARFRUIT, US << MARKET, 5075, 1, 855300)
(STARFRUIT, US << MARKET, 5075, 1, 855300)
(STARFRUIT, US << MARKET, 5075, 1, 855300)
(STARFRUIT, US << MARKET, 5075, 1, 855300)
(STARFRUIT, MARKET << US, 5075, 1, 855300)
(STARFRUIT, MARKET << US, 5075, 1, 855300)
(STARFRUIT, MARKET << US, 5075, 1, 855300)
(STARFRUIT, MARKET << US, 5075, 1, 855300)
(STARFRUIT, MARKET << US, 5075, 1, 855300)","{""AMETHYSTS"": 10, ""STARFRUIT"": 9}",5646,5074,10001
855500,5074,-134956,"(STARFRUIT, MARKET << US, 5074, 1, 855500)","{""AMETHYSTS"": 10, ""STARFRUIT"": 8}",5660,5077,10000
855700,-30006,-164962,"(AMETHYSTS, US << MARKET, 10002, 1, 855700)
(AMETHYSTS, US << MARKET, 10002, 1, 855700)
(AMETHYSTS, US << MARKET, 10002, 1, 855700)","{""AMETHYSTS"": 13, ""STARFRUIT"": 8}",5693,5077,10003
856100,-20300,-185262,"(STARFRUIT, US << MARKET, 5075, 1, 856100)
(STARFRUIT, US << MARKET, 5075, 1, 856100)
(STARFRUIT, US << MARKET, 5075, 1, 856100)
(STARFRUIT, US << MARKET, 5075, 1, 856100)","{""AMETHYSTS"": 13, ""STARFRUIT"": 12}",5601,5073,9999
856300,20004,-165258,"(AMETHYSTS, MARKET << US, 10002, 1, 856300)
(AMETHYSTS, MARKET << US, 10002, 1, 856300)","{""AMETHYSTS"": 11, ""STARFRUIT"": 12}",5675,5075,10003
856400,5071,-160187,"(STARFRUIT, MARKET << US, 5071, 1, 856400)","{""AMETHYSTS"": 11, ""STARFRUIT"": 11}",5671,5076,10002
856500,5071,-155116,"(STARFRUIT, MARKET << US, 5071, 1, 856500)","{""AMETHYSTS"": 11, ""STARFRUIT"": 10}",5592,5073,9998
856600,29892,-125224,"(AMETHYSTS, MARKET << US, 10005, 1, 856600)
(AMETHYSTS, MARKET << US, 10005, 1, 856600)
(AMETHYSTS, MARKET << US, 10005, 1, 856600)
(AMETHYSTS, MARKET << US, 10005, 1, 856600)
(STARFRUIT, US << MARKET, 5071, 1, 856600)
(STARFRUIT, US << MARKET, 5071, 1, 856600)
(STARFRUIT, US << MARKET, 5071, 1, 856600)
(STARFRUIT, US << MARKET, 5071, 1, 856600)
(STARFRUIT, MARKET << US, 5078, 1, 856600)
(STARFRUIT, MARKET << US, 5078, 1, 856600)","{""AMETHYSTS"": 7, ""STARFRUIT"": 12}",5664,5074,10000
856800,-20316,-145540,"(STARFRUIT, US << MARKET, 5079, 1, 856800)
(STARFRUIT, US << MARKET, 5079, 1, 856800)
(STARFRUIT, US << MARKET, 5079, 1, 856800)
(STARFRUIT, US << MARKET, 5079, 1, 856800)","{""AMETHYSTS"": 7, ""STARFRUIT"": 16}",5676,5076,10000
856900,20308,-125232,"(STARFRUIT, MARKET << US, 5077, 1, 856900)
(STARFRUIT, MARKET << US, 5077, 1, 856900)
(STARFRUIT, MARKET << US, 5077, 1, 856900)
(STARFRUIT, MARKET << US, 5077, 1, 856900)","{""AMETHYSTS"": 7, ""STARFRUIT"": 12}",5663,5074,10001
857400,5078,-120154,"(STARFRUIT, MARKET << US, 5078, 1, 857400)","{""AMETHYSTS"": 7, ""STARFRUIT"": 11}",5671,5075,10000
857800,-15228,-135382,"(STARFRUIT, US << MARKET, 5076, 1, 857800)
(STARFRUIT, US << MARKET, 5076, 1, 857800)
(STARFRUIT, US << MARKET, 5076, 1, 857800)","{""AMETHYSTS"": 7, ""STARFRUIT"": 14}",5640,5074,9998
858000,-20312,-155694,"(STARFRUIT, US << MARKET, 5078, 1, 858000)
(STARFRUIT, US << MARKET, 5078, 1, 858000)
(STARFRUIT, US << MARKET, 5078, 1, 858000)
(STARFRUIT, US << MARKET, 5078, 1, 858000)","{""AMETHYSTS"": 7, ""STARFRUIT"": 18}",5728,5079,10000
858200,5075,-150619,"(STARFRUIT, US << MARKET, 5075, 1, 858200)
(STARFRUIT, US << MARKET, 5075, 1, 858200)
(STARFRUIT, MARKET << US, 5075, 1, 858200)
(STARFRUIT, MARKET << US, 5075, 1, 858200)
(STARFRUIT, MARKET << US, 5075, 1, 858200)","{""AMETHYSTS"": 7, ""STARFRUIT"": 17}",5683,5077,9999
858400,45675,-104944,"(STARFRUIT, MARKET << US, 5075, 1, 858400)
(STARFRUIT, MARKET << US, 5075, 1, 858400)
(STARFRUIT, MARKET << US, 5075, 1, 858400)
(STARFRUIT, MARKET << US, 5075, 1, 858400)
(STARFRUIT, MARKET << US, 5075, 1, 858400)
(STARFRUIT, MARKET << US, 5075, 1, 858400)
(STARFRUIT, MARKET << US, 5075, 1, 858400)
(STARFRUIT, MARKET << US, 5075, 1, 858400)
(STARFRUIT, MARKET << US, 5075, 1, 858400)","{""AMETHYSTS"": 7, ""STARFRUIT"": 8}",5620,5074,9996
858500,9998,-94946,"(AMETHYSTS, MARKET << US, 9998, 1, 858500)","{""AMETHYSTS"": 6, ""STARFRUIT"": 8}",5654,5078,9996
858900,-5074,-100020,"(STARFRUIT, US << MARKET, 5074, 1, 858900)","{""AMETHYSTS"": 6, ""STARFRUIT"": 9}",5637,5073,10000
859000,-20320,-120340,"(STARFRUIT, US << MARKET, 5080, 1, 859000)
(STARFRUIT, US << MARKET, 5080, 1, 859000)
(STARFRUIT, US << MARKET, 5080, 1, 859000)
(STARFRUIT, US << MARKET, 5080, 1, 859000)","{""AMETHYSTS"": 6, ""STARFRUIT"": 13}",5648,5076,10000
859500,14930,-105410,"(AMETHYSTS, MARKET << US, 10002, 1, 859500)
(AMETHYSTS, MARKET << US, 10002, 1, 859500)
(STARFRUIT, US << MARKET, 5074, 1, 859500)","{""AMETHYSTS"": 4, ""STARFRUIT"": 14}",5680,5077,10003
859600,-5074,-110484,"(STARFRUIT, US << MARKET, 5074, 1, 859600)","{""AMETHYSTS"": 4, ""STARFRUIT"": 15}",5683,5077,10003
859800,-14913,-125397,"(AMETHYSTS, US << MARKET, 9996, 1, 859800)
(AMETHYSTS, US << MARKET, 9996, 1, 859800)
(STARFRUIT, MARKET << US, 5079, 1, 859800)","{""AMETHYSTS"": 6, ""STARFRUIT"": 14}",5709,5079,10000
860300,9998,-115399,"(AMETHYSTS, MARKET << US, 9998, 1, 860300)","{""AMETHYSTS"": 5, ""STARFRUIT"": 14}",5703,5078,10002
860600,9998,-105401,"(AMETHYSTS, MARKET << US, 9998, 1, 860600)","{""AMETHYSTS"": 4, ""STARFRUIT"": 14}",5681,5077,10001
861100,49990,-55411,"(AMETHYSTS, MARKET << US, 9998, 1, 861100)
(AMETHYSTS, MARKET << US, 9998, 1, 861100)
(AMETHYSTS, MARKET << US, 9998, 1, 861100)
(AMETHYSTS, MARKET << US, 9998, 1, 861100)
(AMETHYSTS, MARKET << US, 9998, 1, 861100)","{""AMETHYSTS"": -1, ""STARFRUIT"": 14}",5670,5077,9997
861300,-20292,-75703,"(STARFRUIT, US << MARKET, 5073, 1, 861300)
(STARFRUIT, US << MARKET, 5073, 1, 861300)
(STARFRUIT, US << MARKET, 5073, 1, 861300)
(STARFRUIT, US << MARKET, 5073, 1, 861300)","{""AMETHYSTS"": -1, ""STARFRUIT"": 18}",5665,5076,10000
861600,40020,-35683,"(AMETHYSTS, MARKET << US, 10005, 1, 861600)
(AMETHYSTS, MARKET << US, 10005, 1, 861600)
(AMETHYSTS, MARKET << US, 10005, 1, 861600)
(AMETHYSTS, MARKET << US, 10005, 1, 861600)
(STARFRUIT, US << MARKET, 5079, 1, 861600)
(STARFRUIT, MARKET << US, 5079, 1, 861600)","{""AMETHYSTS"": -5, ""STARFRUIT"": 18}",5685,5076,10000
862300,-119940,-155623,"(AMETHYSTS, US << MARKET, 9995, 1, 862300)
(AMETHYSTS, US << MARKET, 9995, 1, 862300)
(AMETHYSTS, US << MARKET, 9995, 1, 862300)
(AMETHYSTS, US << MARKET, 9995, 1, 862300)
(AMETHYSTS, US << MARKET, 9995, 1, 862300)
(AMETHYSTS, US << MARKET, 9995, 1, 862300)
(AMETHYSTS, US << MARKET, 9995, 1, 862300)
(AMETHYSTS, US << MARKET, 9995, 1, 862300)
(AMETHYSTS, US << MARKET, 9995, 1, 862300)
(AMETHYSTS, US << MARKET, 9995, 1, 862300)
(AMETHYSTS, US << MARKET, 9995, 1, 862300)
(AMETHYSTS, US << MARKET, 9995, 1, 862300)","{""AMETHYSTS"": 7, ""STARFRUIT"": 18}",5749,5077,9998
862400,9998,-145625,"(AMETHYSTS, MARKET << US, 9998, 1, 862400)","{""AMETHYSTS"": 6, ""STARFRUIT"": 18}",5701,5075,9996
862900,5077,-140548,"(STARFRUIT, MARKET << US, 5077, 1, 862900)","{""AMETHYSTS"": 6, ""STARFRUIT"": 17}",5778,5078,10000
864300,-5076,-145624,"(STARFRUIT, US << MARKET, 5076, 1, 864300)","{""AMETHYSTS"": 6, ""STARFRUIT"": 18}",5744,5076,10000
864500,-5076,-150700,"(STARFRUIT, US << MARKET, 5076, 1, 864500)","{""AMETHYSTS"": 6, ""STARFRUIT"": 19}",5668,5072,10000
864600,25075,-125625,"(AMETHYSTS, MARKET << US, 10002, 1, 864600)
(AMETHYSTS, MARKET << US, 10002, 1, 864600)
(STARFRUIT, MARKET << US, 5071, 1, 864600)","{""AMETHYSTS"": 4, ""STARFRUIT"": 18}",5701,5073,10003
864800,10150,-115475,"(STARFRUIT, MARKET << US, 5075, 1, 864800)
(STARFRUIT, MARKET << US, 5075, 1, 864800)","{""AMETHYSTS"": 4, ""STARFRUIT"": 16}",5677,5072,10000
864900,25067,-90408,"(AMETHYSTS, MARKET << US, 9998, 1, 864900)
(AMETHYSTS, MARKET << US, 9998, 1, 864900)
(STARFRUIT, MARKET << US, 5071, 1, 864900)","{""AMETHYSTS"": 2, ""STARFRUIT"": 15}",5634,5070,9996
865100,55781,-34627,"(STARFRUIT, MARKET << US, 5071, 1, 865100)
(STARFRUIT, MARKET << US, 5071, 1, 865100)
(STARFRUIT, MARKET << US, 5071, 1, 865100)
(STARFRUIT, MARKET << US, 5071, 1, 865100)
(STARFRUIT, MARKET << US, 5071, 1, 865100)
(STARFRUIT, MARKET << US, 5071, 1, 865100)
(STARFRUIT, MARKET << US, 5071, 1, 865100)
(STARFRUIT, MARKET << US, 5071, 1, 865100)
(STARFRUIT, MARKET << US, 5071, 1, 865100)
(STARFRUIT, MARKET << US, 5071, 1, 865100)
(STARFRUIT, MARKET << US, 5071, 1, 865100)","{""AMETHYSTS"": 2, ""STARFRUIT"": 4}",5671,5074,10001
865200,-19996,-54623,"(AMETHYSTS, US << MARKET, 9998, 1, 865200)
(AMETHYSTS, US << MARKET, 9998, 1, 865200)","{""AMETHYSTS"": 4, ""STARFRUIT"": 4}",5673,5073,10001
865400,-10140,-64763,"(STARFRUIT, US << MARKET, 5070, 1, 865400)
(STARFRUIT, US << MARKET, 5070, 1, 865400)","{""AMETHYSTS"": 4, ""STARFRUIT"": 6}",5675,5073,10000
865500,-15222,-79985,"(STARFRUIT, US << MARKET, 5074, 1, 865500)
(STARFRUIT, US << MARKET, 5074, 1, 865500)
(STARFRUIT, US << MARKET, 5074, 1, 865500)
(STARFRUIT, US << MARKET, 5074, 1, 865500)
(STARFRUIT, MARKET << US, 5074, 1, 865500)","{""AMETHYSTS"": 4, ""STARFRUIT"": 9}",5658,5071,10001
865800,-20304,-100289,"(STARFRUIT, US << MARKET, 5076, 1, 865800)
(STARFRUIT, US << MARKET, 5076, 1, 865800)
(STARFRUIT, US << MARKET, 5076, 1, 865800)
(STARFRUIT, US << MARKET, 5076, 1, 865800)","{""AMETHYSTS"": 4, ""STARFRUIT"": 13}",5685,5074,10003
865900,-50010,-150299,"(AMETHYSTS, US << MARKET, 10002, 1, 865900)
(AMETHYSTS, US << MARKET, 10002, 1, 865900)
(AMETHYSTS, US << MARKET, 10002, 1, 865900)
(AMETHYSTS, US << MARKET, 10002, 1, 865900)
(AMETHYSTS, US << MARKET, 10002, 1, 865900)","{""AMETHYSTS"": 9, ""STARFRUIT"": 13}",5632,5073,9998
867100,-20284,-170583,"(STARFRUIT, US << MARKET, 5071, 1, 867100)
(STARFRUIT, US << MARKET, 5071, 1, 867100)
(STARFRUIT, US << MARKET, 5071, 1, 867100)
(STARFRUIT, US << MARKET, 5071, 1, 867100)","{""AMETHYSTS"": 9, ""STARFRUIT"": 17}",5572,5069,9998
867400,-19996,-190579,"(AMETHYSTS, US << MARKET, 9998, 1, 867400)
(AMETHYSTS, US << MARKET, 9998, 1, 867400)","{""AMETHYSTS"": 11, ""STARFRUIT"": 17}",5656,5072,10001
867700,45693,-144886,"(STARFRUIT, MARKET << US, 5077, 1, 867700)
(STARFRUIT, MARKET << US, 5077, 1, 867700)
(STARFRUIT, MARKET << US, 5077, 1, 867700)
(STARFRUIT, MARKET << US, 5077, 1, 867700)
(STARFRUIT, MARKET << US, 5077, 1, 867700)
(STARFRUIT, MARKET << US, 5077, 1, 867700)
(STARFRUIT, MARKET << US, 5077, 1, 867700)
(STARFRUIT, MARKET << US, 5077, 1, 867700)
(STARFRUIT, MARKET << US, 5077, 1, 867700)","{""AMETHYSTS"": 11, ""STARFRUIT"": 8}",5706,5074,10000
867800,25075,-119811,"(AMETHYSTS, MARKET << US, 10002, 1, 867800)
(AMETHYSTS, MARKET << US, 10002, 1, 867800)
(STARFRUIT, MARKET << US, 5071, 1, 867800)","{""AMETHYSTS"": 9, ""STARFRUIT"": 7}",5706,5070,10003
867900,10142,-109669,"(STARFRUIT, MARKET << US, 5071, 1, 867900)
(STARFRUIT, MARKET << US, 5071, 1, 867900)","{""AMETHYSTS"": 9, ""STARFRUIT"": 5}",5663,5070,9998
868000,9854,-99815,"(AMETHYSTS, MARKET << US, 10004, 1, 868000)
(AMETHYSTS, MARKET << US, 10004, 1, 868000)
(STARFRUIT, US << MARKET, 5077, 1, 868000)
(STARFRUIT, US << MARKET, 5077, 1, 868000)","{""AMETHYSTS"": 7, ""STARFRUIT"": 7}",5703,5073,10001
868700,20288,-79527,"(STARFRUIT, MARKET << US, 5072, 1, 868700)
(STARFRUIT, MARKET << US, 5072, 1, 868700)
(STARFRUIT, MARKET << US, 5072, 1, 868700)
(STARFRUIT, MARKET << US, 5072, 1, 868700)","{""AMETHYSTS"": 7, ""STARFRUIT"": 3}",5686,5071,10000
868800,5076,-74451,"(STARFRUIT, MARKET << US, 5076, 1, 868800)","{""AMETHYSTS"": 7, ""STARFRUIT"": 2}",5694,5076,9999
869000,-10152,-84603,"(STARFRUIT, US << MARKET, 5076, 1, 869000)
(STARFRUIT, US << MARKET, 5076, 1, 869000)","{""AMETHYSTS"": 7, ""STARFRUIT"": 4}",5705,5077,10000
869200,5070,-79533,"(STARFRUIT, MARKET << US, 5070, 1, 869200)","{""AMETHYSTS"": 7, ""STARFRUIT"": 3}",5686,5073,10000
869500,20008,-59525,"(AMETHYSTS, MARKET << US, 10004, 1, 869500)
(AMETHYSTS, MARKET << US, 10004, 1, 869500)","{""AMETHYSTS"": 5, ""STARFRUIT"": 3}",5710,5075,10002
870000,5070,-54455,"(STARFRUIT, MARKET << US, 5070, 1, 870000)","{""AMETHYSTS"": 5, ""STARFRUIT"": 2}",5691,5073,10000
870200,79960,25505,"(AMETHYSTS, MARKET << US, 9995, 1, 870200)
(AMETHYSTS, MARKET << US, 9995, 1, 870200)
(AMETHYSTS, MARKET << US, 9995, 1, 870200)
(AMETHYSTS, MARKET << US, 9995, 1, 870200)
(AMETHYSTS, MARKET << US, 9995, 1, 870200)
(AMETHYSTS, MARKET << US, 9995, 1, 870200)
(AMETHYSTS, MARKET << US, 9995, 1, 870200)
(AMETHYSTS, MARKET << US, 9995, 1, 870200)","{""AMETHYSTS"": -3, ""STARFRUIT"": 2}",5649,5072,10000
870500,-19996,5509,"(AMETHYSTS, US << MARKET, 9998, 1, 870500)
(AMETHYSTS, US << MARKET, 9998, 1, 870500)","{""AMETHYSTS"": -1, ""STARFRUIT"": 2}",5659,5073,9996
870900,25084,30593,"(AMETHYSTS, MARKET << US, 10005, 1, 870900)
(AMETHYSTS, MARKET << US, 10005, 1, 870900)
(STARFRUIT, MARKET << US, 5074, 1, 870900)","{""AMETHYSTS"": -3, ""STARFRUIT"": 1}",5664,5071,10000
871000,9998,40591,"(AMETHYSTS, MARKET << US, 9998, 1, 871000)","{""AMETHYSTS"": -4, ""STARFRUIT"": 1}",5672,5069,9997
871700,15067,55658,"(AMETHYSTS, MARKET << US, 9996, 1, 871700)
(STARFRUIT, MARKET << US, 5071, 1, 871700)","{""AMETHYSTS"": -5, ""STARFRUIT"": 0}",5663,5074,9999
872000,-30420,25238,"(STARFRUIT, US << MARKET, 5070, 1, 872000)
(STARFRUIT, US << MARKET, 5070, 1, 872000)
(STARFRUIT, US << MARKET, 5070, 1, 872000)
(STARFRUIT, US << MARKET, 5070, 1, 872000)
(STARFRUIT, US << MARKET, 5070, 1, 872000)
(STARFRUIT, US << MARKET, 5070, 1, 872000)","{""AMETHYSTS"": -5, ""STARFRUIT"": 6}",5671,5073,10001
872200,5070,30308,"(STARFRUIT, MARKET << US, 5070, 1, 872200)","{""AMETHYSTS"": -5, ""STARFRUIT"": 5}",5668,5072,10000
872500,5070,35378,"(STARFRUIT, MARKET << US, 5070, 1, 872500)","{""AMETHYSTS"": -5, ""STARFRUIT"": 4}",5665,5073,10001
872600,0,35378,"(STARFRUIT, US << MARKET, 5071, 1, 872600)
(STARFRUIT, US << MARKET, 5071, 1, 872600)
(STARFRUIT, US << MARKET, 5071, 1, 872600)
(STARFRUIT, US << MARKET, 5071, 1, 872600)
(STARFRUIT, MARKET << US, 5071, 1, 872600)
(STARFRUIT, MARKET << US, 5071, 1, 872600)
(STARFRUIT, MARKET << US, 5071, 1, 872600)
(STARFRUIT, MARKET << US, 5071, 1, 872600)","{""AMETHYSTS"": -5, ""STARFRUIT"": 4}",5675,5073,9999
872900,-10148,25230,"(STARFRUIT, US << MARKET, 5074, 1, 872900)
(STARFRUIT, US << MARKET, 5074, 1, 872900)","{""AMETHYSTS"": -5, ""STARFRUIT"": 6}",5675,5075,10001
873400,-110114,-84884,"(AMETHYSTS, US << MARKET, 9998, 1, 873400)
(AMETHYSTS, US << MARKET, 9998, 1, 873400)
(AMETHYSTS, US << MARKET, 9998, 1, 873400)
(AMETHYSTS, US << MARKET, 9998, 1, 873400)
(AMETHYSTS, US << MARKET, 9998, 1, 873400)
(AMETHYSTS, US << MARKET, 9998, 1, 873400)
(AMETHYSTS, US << MARKET, 9998, 1, 873400)
(AMETHYSTS, US << MARKET, 9998, 1, 873400)
(AMETHYSTS, US << MARKET, 9998, 1, 873400)
(AMETHYSTS, US << MARKET, 9998, 1, 873400)
(STARFRUIT, US << MARKET, 5067, 1, 873400)
(STARFRUIT, US << MARKET, 5067, 1, 873400)","{""AMETHYSTS"": 5, ""STARFRUIT"": 8}",5629,5066,9997
873500,10002,-74882,"(AMETHYSTS, US << MARKET, 10002, 1, 873500)
(AMETHYSTS, US << MARKET, 10002, 1, 873500)
(AMETHYSTS, US << MARKET, 10002, 1, 873500)
(AMETHYSTS, MARKET << US, 10002, 1, 873500)
(AMETHYSTS, MARKET << US, 10002, 1, 873500)
(AMETHYSTS, MARKET << US, 10002, 1, 873500)
(AMETHYSTS, MARKET << US, 10002, 1, 873500)
(STARFRUIT, US << MARKET, 5067, 1, 873500)
(STARFRUIT, MARKET << US, 5067, 1, 873500)","{""AMETHYSTS"": 4, ""STARFRUIT"": 8}",5690,5070,10003
873700,-20264,-95146,"(STARFRUIT, US << MARKET, 5066, 1, 873700)
(STARFRUIT, US << MARKET, 5066, 1, 873700)
(STARFRUIT, US << MARKET, 5066, 1, 873700)
(STARFRUIT, US << MARKET, 5066, 1, 873700)","{""AMETHYSTS"": 4, ""STARFRUIT"": 12}",5698,5070,10001
873800,9998,-85148,"(AMETHYSTS, MARKET << US, 9998, 1, 873800)","{""AMETHYSTS"": 3, ""STARFRUIT"": 12}",5683,5070,9997
874300,-10002,-95150,"(AMETHYSTS, US << MARKET, 10002, 1, 874300)","{""AMETHYSTS"": 4, ""STARFRUIT"": 12}",5698,5071,9999
874400,55221,-39929,"(AMETHYSTS, MARKET << US, 10002, 1, 874400)
(AMETHYSTS, MARKET << US, 10002, 1, 874400)
(AMETHYSTS, MARKET << US, 10002, 1, 874400)
(AMETHYSTS, MARKET << US, 10002, 1, 874400)
(STARFRUIT, MARKET << US, 5071, 1, 874400)
(STARFRUIT, MARKET << US, 5071, 1, 874400)
(STARFRUIT, MARKET << US, 5071, 1, 874400)","{""AMETHYSTS"": 0, ""STARFRUIT"": 9}",5719,5072,9999
874500,-80032,-119961,"(AMETHYSTS, US << MARKET, 10004, 1, 874500)
(AMETHYSTS, US << MARKET, 10004, 1, 874500)
(AMETHYSTS, US << MARKET, 10004, 1, 874500)
(AMETHYSTS, US << MARKET, 10004, 1, 874500)
(AMETHYSTS, US << MARKET, 10004, 1, 874500)
(AMETHYSTS, US << MARKET, 10004, 1, 874500)
(AMETHYSTS, US << MARKET, 10004, 1, 874500)
(AMETHYSTS, US << MARKET, 10004, 1, 874500)","{""AMETHYSTS"": 8, ""STARFRUIT"": 9}",5677,5070,10001
874600,-10136,-130097,"(STARFRUIT, US << MARKET, 5068, 1, 874600)
(STARFRUIT, US << MARKET, 5068, 1, 874600)","{""AMETHYSTS"": 8, ""STARFRUIT"": 11}",5640,5067,10000
874800,-10002,-140099,"(AMETHYSTS, US << MARKET, 10002, 1, 874800)","{""AMETHYSTS"": 9, ""STARFRUIT"": 11}",5640,5068,9999
874900,5068,-135031,"(STARFRUIT, MARKET << US, 5068, 1, 874900)","{""AMETHYSTS"": 9, ""STARFRUIT"": 10}",5679,5071,10000
875000,30450,-104581,"(STARFRUIT, MARKET << US, 5075, 1, 875000)
(STARFRUIT, MARKET << US, 5075, 1, 875000)
(STARFRUIT, MARKET << US, 5075, 1, 875000)
(STARFRUIT, MARKET << US, 5075, 1, 875000)
(STARFRUIT, MARKET << US, 5075, 1, 875000)
(STARFRUIT, MARKET << US, 5075, 1, 875000)","{""AMETHYSTS"": 9, ""STARFRUIT"": 4}",5734,5072,10003
875600,-10002,-114583,"(AMETHYSTS, US << MARKET, 10002, 1, 875600)","{""AMETHYSTS"": 10, ""STARFRUIT"": 4}",5699,5073,9999
875700,5069,-109514,"(STARFRUIT, MARKET << US, 5069, 1, 875700)","{""AMETHYSTS"": 10, ""STARFRUIT"": 3}",5669,5071,9997
875800,14668,-94846,"(AMETHYSTS, MARKET << US, 10002, 1, 875800)
(AMETHYSTS, MARKET << US, 10002, 1, 875800)
(AMETHYSTS, MARKET << US, 10002, 1, 875800)
(AMETHYSTS, MARKET << US, 10002, 1, 875800)
(STARFRUIT, US << MARKET, 5068, 1, 875800)
(STARFRUIT, US << MARKET, 5068, 1, 875800)
(STARFRUIT, US << MARKET, 5068, 1, 875800)
(STARFRUIT, US << MARKET, 5068, 1, 875800)
(STARFRUIT, US << MARKET, 5068, 1, 875800)","{""AMETHYSTS"": 6, ""STARFRUIT"": 8}",5686,5068,9998
875900,-5069,-99915,"(STARFRUIT, US << MARKET, 5069, 1, 875900)","{""AMETHYSTS"": 6, ""STARFRUIT"": 9}",5727,5072,9999
876000,80032,-19883,"(AMETHYSTS, MARKET << US, 10004, 1, 876000)
(AMETHYSTS, MARKET << US, 10004, 1, 876000)
(AMETHYSTS, MARKET << US, 10004, 1, 876000)
(AMETHYSTS, MARKET << US, 10004, 1, 876000)
(AMETHYSTS, MARKET << US, 10004, 1, 876000)
(AMETHYSTS, MARKET << US, 10004, 1, 876000)
(AMETHYSTS, MARKET << US, 10004, 1, 876000)
(AMETHYSTS, MARKET << US, 10004, 1, 876000)","{""AMETHYSTS"": -2, ""STARFRUIT"": 9}",5770,5073,10002
876600,-5067,-24950,"(STARFRUIT, US << MARKET, 5067, 1, 876600)","{""AMETHYSTS"": -2, ""STARFRUIT"": 10}",5738,5069,10001
876700,-40256,-65206,"(AMETHYSTS, US << MARKET, 9996, 1, 876700)
(AMETHYSTS, US << MARKET, 9996, 1, 876700)
(STARFRUIT, US << MARKET, 5066, 1, 876700)
(STARFRUIT, US << MARKET, 5066, 1, 876700)
(STARFRUIT, US << MARKET, 5066, 1, 876700)
(STARFRUIT, US << MARKET, 5066, 1, 876700)","{""AMETHYSTS"": 0, ""STARFRUIT"": 14}",5746,5068,10000
877100,5066,-60140,"(STARFRUIT, MARKET << US, 5066, 1, 877100)","{""AMETHYSTS"": 0, ""STARFRUIT"": 13}",5705,5065,10000
877200,29872,-30268,"(AMETHYSTS, MARKET << US, 10004, 1, 877200)
(AMETHYSTS, MARKET << US, 10004, 1, 877200)
(AMETHYSTS, MARKET << US, 10004, 1, 877200)
(AMETHYSTS, MARKET << US, 10004, 1, 877200)
(STARFRUIT, US << MARKET, 5072, 1, 877200)
(STARFRUIT, US << MARKET, 5072, 1, 877200)","{""AMETHYSTS"": -4, ""STARFRUIT"": 15}",5767,5069,10000
877300,-19996,-50264,"(AMETHYSTS, US << MARKET, 9998, 1, 877300)
(AMETHYSTS, US << MARKET, 9998, 1, 877300)","{""AMETHYSTS"": -2, ""STARFRUIT"": 15}",5749,5067,9996
877500,9998,-40266,"(AMETHYSTS, MARKET << US, 9998, 1, 877500)","{""AMETHYSTS"": -3, ""STARFRUIT"": 15}",5736,5067,10001
877700,5065,-35201,"(STARFRUIT, MARKET << US, 5065, 1, 877700)","{""AMETHYSTS"": -3, ""STARFRUIT"": 14}",5695,5064,10000
878100,5070,-30131,"(STARFRUIT, MARKET << US, 5070, 1, 878100)","{""AMETHYSTS"": -3, ""STARFRUIT"": 13}",5779,5070,10000
878300,9998,-20133,"(AMETHYSTS, MARKET << US, 9998, 1, 878300)","{""AMETHYSTS"": -4, ""STARFRUIT"": 13}",5763,5068,9997
879000,9998,-10135,"(AMETHYSTS, MARKET << US, 9998, 1, 879000)","{""AMETHYSTS"": -5, ""STARFRUIT"": 13}",5751,5067,9997
879100,5070,-5065,"(STARFRUIT, MARKET << US, 5070, 1, 879100)","{""AMETHYSTS"": -5, ""STARFRUIT"": 12}",5775,5070,10000
879200,5065,0,"(STARFRUIT, MARKET << US, 5065, 1, 879200)","{""AMETHYSTS"": -5, ""STARFRUIT"": 11}",5737,5067,10000
879900,132,132,"(AMETHYSTS, US << MARKET, 10002, 1, 879900)
(STARFRUIT, MARKET << US, 5067, 1, 879900)
(STARFRUIT, MARKET << US, 5067, 1, 879900)","{""AMETHYSTS"": -4, ""STARFRUIT"": 9}",5741,5069,10003
880000,-5067,-4935,"(STARFRUIT, US << MARKET, 5067, 1, 880000)","{""AMETHYSTS"": -4, ""STARFRUIT"": 10}",5785,5072,10000
880400,-20284,-25219,"(STARFRUIT, US << MARKET, 5071, 1, 880400)
(STARFRUIT, US << MARKET, 5071, 1, 880400)
(STARFRUIT, US << MARKET, 5071, 1, 880400)
(STARFRUIT, US << MARKET, 5071, 1, 880400)","{""AMETHYSTS"": -4, ""STARFRUIT"": 14}",5789,5072,10000
880700,-20300,-45519,"(STARFRUIT, US << MARKET, 5075, 1, 880700)
(STARFRUIT, US << MARKET, 5075, 1, 880700)
(STARFRUIT, US << MARKET, 5075, 1, 880700)
(STARFRUIT, US << MARKET, 5075, 1, 880700)","{""AMETHYSTS"": -4, ""STARFRUIT"": 18}",5759,5071,10000
881200,-10136,-55655,"(STARFRUIT, US << MARKET, 5068, 1, 881200)
(STARFRUIT, US << MARKET, 5068, 1, 881200)","{""AMETHYSTS"": -4, ""STARFRUIT"": 20}",5685,5067,10000
881300,0,-55655,,"{""AMETHYSTS"": -4, ""STARFRUIT"": 20}",5789,5072,9999
881600,-99980,-155635,"(AMETHYSTS, US << MARKET, 9998, 1, 881600)
(AMETHYSTS, US << MARKET, 9998, 1, 881600)
(AMETHYSTS, US << MARKET, 9998, 1, 881600)
(AMETHYSTS, US << MARKET, 9998, 1, 881600)
(AMETHYSTS, US << MARKET, 9998, 1, 881600)
(AMETHYSTS, US << MARKET, 9998, 1, 881600)
(AMETHYSTS, US << MARKET, 9998, 1, 881600)
(AMETHYSTS, US << MARKET, 9998, 1, 881600)
(AMETHYSTS, US << MARKET, 9998, 1, 881600)
(AMETHYSTS, US << MARKET, 9998, 1, 881600)","{""AMETHYSTS"": 6, ""STARFRUIT"": 20}",5761,5071,9996
881800,9996,-145639,"(AMETHYSTS, MARKET << US, 9996, 1, 881800)","{""AMETHYSTS"": 5, ""STARFRUIT"": 20}",5746,5070,9997
881900,20008,-125631,"(AMETHYSTS, MARKET << US, 10004, 1, 881900)
(AMETHYSTS, MARKET << US, 10004, 1, 881900)","{""AMETHYSTS"": 3, ""STARFRUIT"": 20}",5789,5071,10000
882300,30126,-95505,"(AMETHYSTS, MARKET << US, 9996, 1, 882300)
(AMETHYSTS, MARKET << US, 9996, 1, 882300)
(STARFRUIT, MARKET << US, 5067, 1, 882300)
(STARFRUIT, MARKET << US, 5067, 1, 882300)","{""AMETHYSTS"": 1, ""STARFRUIT"": 18}",5755,5070,10000
882500,5074,-90431,"(STARFRUIT, MARKET << US, 5074, 1, 882500)","{""AMETHYSTS"": 1, ""STARFRUIT"": 17}",5759,5070,10000
882800,-15222,-105653,"(STARFRUIT, US << MARKET, 5074, 1, 882800)
(STARFRUIT, US << MARKET, 5074, 1, 882800)
(STARFRUIT, US << MARKET, 5074, 1, 882800)","{""AMETHYSTS"": 1, ""STARFRUIT"": 20}",5847,5075,10000
883100,0,-105653,,"{""AMETHYSTS"": 1, ""STARFRUIT"": 20}",5807,5073,10000
883300,0,-105653,,"{""AMETHYSTS"": 1, ""STARFRUIT"": 20}",5805,5073,9998
883900,0,-105653,,"{""AMETHYSTS"": 1, ""STARFRUIT"": 20}",5826,5074,9999
884200,9998,-95655,"(AMETHYSTS, MARKET << US, 9998, 1, 884200)","{""AMETHYSTS"": 0, ""STARFRUIT"": 20}",5845,5075,9997
884300,5073,-90582,"(STARFRUIT, MARKET << US, 5073, 1, 884300)","{""AMETHYSTS"": 0, ""STARFRUIT"": 19}",5843,5075,10000
884400,-5079,-95661,"(STARFRUIT, US << MARKET, 5079, 1, 884400)","{""AMETHYSTS"": 0, ""STARFRUIT"": 20}",5919,5079,10000
884500,35511,-60150,"(STARFRUIT, MARKET << US, 5073, 1, 884500)
(STARFRUIT, MARKET << US, 5073, 1, 884500)
(STARFRUIT, MARKET << US, 5073, 1, 884500)
(STARFRUIT, MARKET << US, 5073, 1, 884500)
(STARFRUIT, MARKET << US, 5073, 1, 884500)
(STARFRUIT, MARKET << US, 5073, 1, 884500)
(STARFRUIT, MARKET << US, 5073, 1, 884500)","{""AMETHYSTS"": 0, ""STARFRUIT"": 13}",5799,5073,10001
884800,-10158,-70308,"(STARFRUIT, US << MARKET, 5079, 1, 884800)
(STARFRUIT, US << MARKET, 5079, 1, 884800)
(STARFRUIT, US << MARKET, 5079, 1, 884800)
(STARFRUIT, MARKET << US, 5079, 1, 884800)","{""AMETHYSTS"": 0, ""STARFRUIT"": 15}",5832,5076,9999
884900,-10156,-80464,"(STARFRUIT, US << MARKET, 5078, 1, 884900)
(STARFRUIT, US << MARKET, 5078, 1, 884900)","{""AMETHYSTS"": 0, ""STARFRUIT"": 17}",5811,5075,10003
885400,9998,-70466,"(AMETHYSTS, MARKET << US, 9998, 1, 885400)","{""AMETHYSTS"": -1, ""STARFRUIT"": 17}",5809,5075,10000
885600,20008,-50458,"(AMETHYSTS, MARKET << US, 10004, 1, 885600)
(AMETHYSTS, MARKET << US, 10004, 1, 885600)","{""AMETHYSTS"": -3, ""STARFRUIT"": 17}",5834,5076,10000
886100,-5074,-55532,"(STARFRUIT, US << MARKET, 5074, 1, 886100)","{""AMETHYSTS"": -3, ""STARFRUIT"": 18}",5836,5076,10000
886900,5073,-50459,"(STARFRUIT, MARKET << US, 5073, 1, 886900)","{""AMETHYSTS"": -3, ""STARFRUIT"": 17}",5816,5075,10000
887000,30148,-20311,"(AMETHYSTS, MARKET << US, 10002, 1, 887000)
(AMETHYSTS, MARKET << US, 10002, 1, 887000)
(STARFRUIT, MARKET << US, 5072, 1, 887000)
(STARFRUIT, MARKET << US, 5072, 1, 887000)","{""AMETHYSTS"": -5, ""STARFRUIT"": 15}",5799,5075,10003
887200,-5078,-25389,"(STARFRUIT, US << MARKET, 5078, 1, 887200)","{""AMETHYSTS"": -5, ""STARFRUIT"": 16}",5854,5078,10001
887300,9996,-15393,"(AMETHYSTS, MARKET << US, 9996, 1, 887300)","{""AMETHYSTS"": -6, ""STARFRUIT"": 16}",5807,5075,10000
887400,10146,-5247,"(STARFRUIT, MARKET << US, 5073, 1, 887400)
(STARFRUIT, MARKET << US, 5073, 1, 887400)","{""AMETHYSTS"": -6, ""STARFRUIT"": 14}",5773,5072,9998
887600,5077,-170,"(STARFRUIT, MARKET << US, 5077, 1, 887600)","{""AMETHYSTS"": -6, ""STARFRUIT"": 13}",5831,5077,10000
887700,9998,9828,"(AMETHYSTS, MARKET << US, 9998, 1, 887700)","{""AMETHYSTS"": -7, ""STARFRUIT"": 13}",5816,5076,10000
888100,10451,20279,"(AMETHYSTS, US << MARKET, 9996, 1, 888100)
(AMETHYSTS, US << MARKET, 9996, 1, 888100)
(AMETHYSTS, US << MARKET, 10002, 1, 888100)
(AMETHYSTS, MARKET << US, 9996, 1, 888100)
(STARFRUIT, US << MARKET, 5077, 1, 888100)
(STARFRUIT, MARKET << US, 5078, 1, 888100)
(STARFRUIT, MARKET << US, 5078, 1, 888100)
(STARFRUIT, MARKET << US, 5074, 1, 888100)
(STARFRUIT, MARKET << US, 5074, 1, 888100)
(STARFRUIT, MARKET << US, 5074, 1, 888100)
(STARFRUIT, MARKET << US, 5074, 1, 888100)
(STARFRUIT, MARKET << US, 5074, 1, 888100)","{""AMETHYSTS"": -5, ""STARFRUIT"": 7}",5793,5072,9998
888300,25375,45654,"(STARFRUIT, MARKET << US, 5075, 1, 888300)
(STARFRUIT, MARKET << US, 5075, 1, 888300)
(STARFRUIT, MARKET << US, 5075, 1, 888300)
(STARFRUIT, MARKET << US, 5075, 1, 888300)
(STARFRUIT, MARKET << US, 5075, 1, 888300)","{""AMETHYSTS"": -5, ""STARFRUIT"": 2}",5806,5076,10000
888400,10140,55794,"(STARFRUIT, US << MARKET, 5070, 1, 888400)
(STARFRUIT, US << MARKET, 5070, 1, 888400)
(STARFRUIT, MARKET << US, 5070, 1, 888400)
(STARFRUIT, MARKET << US, 5070, 1, 888400)
(STARFRUIT, MARKET << US, 5070, 1, 888400)
(STARFRUIT, MARKET << US, 5070, 1, 888400)","{""AMETHYSTS"": -5, ""STARFRUIT"": 0}",5779,5073,10003
888500,19990,75784,"(AMETHYSTS, MARKET << US, 9995, 1, 888500)
(AMETHYSTS, MARKET << US, 9995, 1, 888500)","{""AMETHYSTS"": -7, ""STARFRUIT"": 0}",5784,5072,10000
888600,-20282,55502,"(STARFRUIT, US << MARKET, 5070, 1, 888600)
(STARFRUIT, US << MARKET, 5070, 1, 888600)
(STARFRUIT, US << MARKET, 5071, 1, 888600)
(STARFRUIT, US << MARKET, 5071, 1, 888600)","{""AMETHYSTS"": -7, ""STARFRUIT"": 4}",5771,5069,10001
888900,-10138,45364,"(STARFRUIT, US << MARKET, 5069, 1, 888900)
(STARFRUIT, US << MARKET, 5069, 1, 888900)","{""AMETHYSTS"": -7, ""STARFRUIT"": 6}",5796,5072,10000
889100,-20280,25084,"(STARFRUIT, US << MARKET, 5070, 1, 889100)
(STARFRUIT, US << MARKET, 5070, 1, 889100)
(STARFRUIT, US << MARKET, 5070, 1, 889100)
(STARFRUIT, US << MARKET, 5070, 1, 889100)","{""AMETHYSTS"": -7, ""STARFRUIT"": 10}",5785,5068,9997
889200,-40264,-15180,"(AMETHYSTS, US << MARKET, 9998, 1, 889200)
(AMETHYSTS, US << MARKET, 9998, 1, 889200)
(STARFRUIT, US << MARKET, 5067, 1, 889200)
(STARFRUIT, US << MARKET, 5067, 1, 889200)
(STARFRUIT, US << MARKET, 5067, 1, 889200)
(STARFRUIT, US << MARKET, 5067, 1, 889200)","{""AMETHYSTS"": -5, ""STARFRUIT"": 14}",5744,5066,10000
889400,5072,-10108,"(STARFRUIT, MARKET << US, 5072, 1, 889400)","{""AMETHYSTS"": -5, ""STARFRUIT"": 13}",5841,5073,10000
889500,20004,9896,"(AMETHYSTS, MARKET << US, 10002, 1, 889500)
(AMETHYSTS, MARKET << US, 10002, 1, 889500)","{""AMETHYSTS"": -7, ""STARFRUIT"": 13}",5807,5069,9998
889600,-39984,-30088,"(AMETHYSTS, US << MARKET, 9996, 1, 889600)
(AMETHYSTS, US << MARKET, 9996, 1, 889600)
(AMETHYSTS, US << MARKET, 9996, 1, 889600)
(AMETHYSTS, US << MARKET, 9996, 1, 889600)","{""AMETHYSTS"": -3, ""STARFRUIT"": 13}",5809,5069,10000
890600,20138,-9950,"(AMETHYSTS, US << MARKET, 10004, 1, 890600)
(AMETHYSTS, MARKET << US, 10004, 1, 890600)
(AMETHYSTS, MARKET << US, 10004, 1, 890600)
(STARFRUIT, MARKET << US, 5067, 1, 890600)
(STARFRUIT, MARKET << US, 5067, 1, 890600)","{""AMETHYSTS"": -4, ""STARFRUIT"": 11}",5772,5066,10001
891200,49990,40040,"(AMETHYSTS, MARKET << US, 9998, 1, 891200)
(AMETHYSTS, MARKET << US, 9998, 1, 891200)
(AMETHYSTS, MARKET << US, 9998, 1, 891200)
(AMETHYSTS, MARKET << US, 9998, 1, 891200)
(AMETHYSTS, MARKET << US, 9998, 1, 891200)","{""AMETHYSTS"": -9, ""STARFRUIT"": 11}",5826,5069,9997
891700,-19996,20044,"(AMETHYSTS, US << MARKET, 9998, 1, 891700)
(AMETHYSTS, US << MARKET, 9998, 1, 891700)","{""AMETHYSTS"": -7, ""STARFRUIT"": 11}",5785,5068,10001
892000,-10002,10042,"(AMETHYSTS, US << MARKET, 10002, 1, 892000)","{""AMETHYSTS"": -6, ""STARFRUIT"": 11}",5791,5067,9998
892100,29878,39920,"(AMETHYSTS, MARKET << US, 10005, 1, 892100)
(AMETHYSTS, MARKET << US, 10005, 1, 892100)
(AMETHYSTS, MARKET << US, 10005, 1, 892100)
(AMETHYSTS, MARKET << US, 10005, 1, 892100)
(STARFRUIT, US << MARKET, 5071, 1, 892100)
(STARFRUIT, US << MARKET, 5071, 1, 892100)","{""AMETHYSTS"": -10, ""STARFRUIT"": 13}",5781,5067,10001
892600,-19996,19924,"(AMETHYSTS, US << MARKET, 9998, 1, 892600)
(AMETHYSTS, US << MARKET, 9998, 1, 892600)","{""AMETHYSTS"": -8, ""STARFRUIT"": 13}",5806,5066,9997
892700,25068,44992,"(AMETHYSTS, MARKET << US, 10002, 1, 892700)
(AMETHYSTS, MARKET << US, 10002, 1, 892700)
(STARFRUIT, MARKET << US, 5064, 1, 892700)","{""AMETHYSTS"": -10, ""STARFRUIT"": 12}",5768,5063,9998
892800,-5068,39924,"(STARFRUIT, US << MARKET, 5068, 1, 892800)","{""AMETHYSTS"": -10, ""STARFRUIT"": 13}",5769,5065,10000
893100,9998,49922,"(AMETHYSTS, MARKET << US, 9998, 1, 893100)","{""AMETHYSTS"": -11, ""STARFRUIT"": 13}",5800,5065,9997
893300,49990,99912,"(AMETHYSTS, MARKET << US, 9998, 1, 893300)
(AMETHYSTS, MARKET << US, 9998, 1, 893300)
(AMETHYSTS, MARKET << US, 9998, 1, 893300)
(AMETHYSTS, MARKET << US, 9998, 1, 893300)
(AMETHYSTS, MARKET << US, 9998, 1, 893300)","{""AMETHYSTS"": -16, ""STARFRUIT"": 13}",5715,5063,10001
893600,-20008,79904,"(AMETHYSTS, US << MARKET, 10004, 1, 893600)
(AMETHYSTS, US << MARKET, 10004, 1, 893600)","{""AMETHYSTS"": -14, ""STARFRUIT"": 13}",5749,5065,10000
894100,-5067,74837,"(STARFRUIT, US << MARKET, 5067, 1, 894100)","{""AMETHYSTS"": -14, ""STARFRUIT"": 14}",5789,5064,9996
894300,20004,94841,"(AMETHYSTS, MARKET << US, 10002, 1, 894300)
(AMETHYSTS, MARKET << US, 10002, 1, 894300)","{""AMETHYSTS"": -16, ""STARFRUIT"": 14}",5689,5064,10003
894500,-40016,54825,"(AMETHYSTS, US << MARKET, 10004, 1, 894500)
(AMETHYSTS, US << MARKET, 10004, 1, 894500)
(AMETHYSTS, US << MARKET, 10004, 1, 894500)
(AMETHYSTS, US << MARKET, 10004, 1, 894500)","{""AMETHYSTS"": -12, ""STARFRUIT"": 14}",5723,5065,10001
894600,-20252,34573,"(STARFRUIT, US << MARKET, 5063, 1, 894600)
(STARFRUIT, US << MARKET, 5063, 1, 894600)
(STARFRUIT, US << MARKET, 5063, 1, 894600)
(STARFRUIT, US << MARKET, 5063, 1, 894600)","{""AMETHYSTS"": -12, ""STARFRUIT"": 18}",5689,5062,10000
894700,-9866,24707,"(AMETHYSTS, US << MARKET, 9996, 1, 894700)
(AMETHYSTS, US << MARKET, 9996, 1, 894700)
(STARFRUIT, MARKET << US, 5063, 1, 894700)
(STARFRUIT, MARKET << US, 5063, 1, 894700)","{""AMETHYSTS"": -10, ""STARFRUIT"": 16}",5747,5065,10000
894800,5068,29775,"(STARFRUIT, MARKET << US, 5068, 1, 894800)","{""AMETHYSTS"": -10, ""STARFRUIT"": 15}",5810,5069,10000
895100,-10002,19773,"(AMETHYSTS, US << MARKET, 10002, 1, 895100)","{""AMETHYSTS"": -9, ""STARFRUIT"": 15}",5736,5066,10003
895200,-115178,-95405,"(AMETHYSTS, US << MARKET, 9998, 1, 895200)
(AMETHYSTS, US << MARKET, 9998, 1, 895200)
(AMETHYSTS, US << MARKET, 9998, 1, 895200)
(AMETHYSTS, US << MARKET, 9998, 1, 895200)
(AMETHYSTS, US << MARKET, 9998, 1, 895200)
(AMETHYSTS, US << MARKET, 9998, 1, 895200)
(AMETHYSTS, US << MARKET, 9998, 1, 895200)
(AMETHYSTS, US << MARKET, 9998, 1, 895200)
(AMETHYSTS, US << MARKET, 9998, 1, 895200)
(AMETHYSTS, US << MARKET, 9998, 1, 895200)
(STARFRUIT, US << MARKET, 5066, 1, 895200)
(STARFRUIT, US << MARKET, 5066, 1, 895200)
(STARFRUIT, US << MARKET, 5066, 1, 895200)","{""AMETHYSTS"": 1, ""STARFRUIT"": 18}",5744,5064,9997
895400,15204,-80201,"(STARFRUIT, MARKET << US, 5068, 1, 895400)
(STARFRUIT, MARKET << US, 5068, 1, 895400)
(STARFRUIT, MARKET << US, 5068, 1, 895400)","{""AMETHYSTS"": 1, ""STARFRUIT"": 15}",5834,5069,10000
895700,-5068,-85269,"(STARFRUIT, US << MARKET, 5068, 1, 895700)","{""AMETHYSTS"": 1, ""STARFRUIT"": 16}",5835,5069,10000
897100,19992,-65277,"(AMETHYSTS, MARKET << US, 9996, 1, 897100)
(AMETHYSTS, MARKET << US, 9996, 1, 897100)","{""AMETHYSTS"": -1, ""STARFRUIT"": 16}",5747,5064,10000
897300,99950,34673,"(AMETHYSTS, MARKET << US, 9995, 1, 897300)
(AMETHYSTS, MARKET << US, 9995, 1, 897300)
(AMETHYSTS, MARKET << US, 9995, 1, 897300)
(AMETHYSTS, MARKET << US, 9995, 1, 897300)
(AMETHYSTS, MARKET << US, 9995, 1, 897300)
(AMETHYSTS, MARKET << US, 9995, 1, 897300)
(AMETHYSTS, MARKET << US, 9995, 1, 897300)
(AMETHYSTS, MARKET << US, 9995, 1, 897300)
(AMETHYSTS, MARKET << US, 9995, 1, 897300)
(AMETHYSTS, MARKET << US, 9995, 1, 897300)","{""AMETHYSTS"": -11, ""STARFRUIT"": 16}",5681,5063,10000
898000,-10120,24553,"(STARFRUIT, US << MARKET, 5060, 1, 898000)
(STARFRUIT, US << MARKET, 5060, 1, 898000)","{""AMETHYSTS"": -11, ""STARFRUIT"": 18}",5687,5063,10000
898100,-10002,14551,"(AMETHYSTS, US << MARKET, 10002, 1, 898100)","{""AMETHYSTS"": -10, ""STARFRUIT"": 18}",5655,5063,10003
898300,5060,19611,"(STARFRUIT, MARKET << US, 5060, 1, 898300)","{""AMETHYSTS"": -10, ""STARFRUIT"": 17}",5665,5062,10000
898400,-15071,4540,"(AMETHYSTS, US << MARKET, 10004, 1, 898400)
(STARFRUIT, US << MARKET, 5067, 1, 898400)","{""AMETHYSTS"": -9, ""STARFRUIT"": 18}",5674,5063,10000
898700,-15064,-10524,"(AMETHYSTS, US << MARKET, 10000, 1, 898700)
(STARFRUIT, US << MARKET, 5064, 1, 898700)","{""AMETHYSTS"": -8, ""STARFRUIT"": 19}",5714,5066,10002
898900,-4943,-15467,"(AMETHYSTS, US << MARKET, 10004, 1, 898900)
(STARFRUIT, MARKET << US, 5061, 1, 898900)","{""AMETHYSTS"": -7, ""STARFRUIT"": 18}",5685,5064,10000
899400,-25077,-40544,"(AMETHYSTS, US << MARKET, 10002, 1, 899400)
(AMETHYSTS, US << MARKET, 10002, 1, 899400)
(STARFRUIT, US << MARKET, 5067, 1, 899400)
(STARFRUIT, US << MARKET, 5067, 1, 899400)
(STARFRUIT, MARKET << US, 5061, 1, 899400)","{""AMETHYSTS"": -5, ""STARFRUIT"": 19}",5677,5064,9999
899800,5065,-35479,"(STARFRUIT, MARKET << US, 5065, 1, 899800)","{""AMETHYSTS"": -5, ""STARFRUIT"": 18}",5691,5065,10000
899900,20256,-15223,"(STARFRUIT, MARKET << US, 5064, 1, 899900)
(STARFRUIT, MARKET << US, 5064, 1, 899900)
(STARFRUIT, MARKET << US, 5064, 1, 899900)
(STARFRUIT, MARKET << US, 5064, 1, 899900)","{""AMETHYSTS"": -5, ""STARFRUIT"": 14}",5682,5065,10001
900000,-9870,-25093,"(AMETHYSTS, US << MARKET, 9995, 1, 900000)
(AMETHYSTS, US << MARKET, 9995, 1, 900000)
(STARFRUIT, MARKET << US, 5060, 1, 900000)
(STARFRUIT, MARKET << US, 5060, 1, 900000)","{""AMETHYSTS"": -3, ""STARFRUIT"": 12}",5663,5063,10000
900100,40016,14923,"(AMETHYSTS, MARKET << US, 10004, 1, 900100)
(AMETHYSTS, MARKET << US, 10004, 1, 900100)
(AMETHYSTS, MARKET << US, 10004, 1, 900100)
(AMETHYSTS, MARKET << US, 10004, 1, 900100)","{""AMETHYSTS"": -7, ""STARFRUIT"": 12}",5677,5064,10002
900200,5060,19983,"(STARFRUIT, MARKET << US, 5060, 1, 900200)","{""AMETHYSTS"": -7, ""STARFRUIT"": 11}",5676,5063,10000
900500,5061,25044,"(STARFRUIT, MARKET << US, 5061, 1, 900500)","{""AMETHYSTS"": -7, ""STARFRUIT"": 10}",5684,5064,10000
900700,15063,40107,"(AMETHYSTS, MARKET << US, 10000, 1, 900700)
(STARFRUIT, MARKET << US, 5063, 1, 900700)","{""AMETHYSTS"": -8, ""STARFRUIT"": 9}",5681,5062,9998
900900,45549,85656,"(STARFRUIT, MARKET << US, 5061, 1, 900900)
(STARFRUIT, MARKET << US, 5061, 1, 900900)
(STARFRUIT, MARKET << US, 5061, 1, 900900)
(STARFRUIT, MARKET << US, 5061, 1, 900900)
(STARFRUIT, MARKET << US, 5061, 1, 900900)
(STARFRUIT, MARKET << US, 5061, 1, 900900)
(STARFRUIT, MARKET << US, 5061, 1, 900900)
(STARFRUIT, MARKET << US, 5061, 1, 900900)
(STARFRUIT, MARKET << US, 5061, 1, 900900)","{""AMETHYSTS"": -8, ""STARFRUIT"": 0}",5656,5064,10000
901100,10120,95776,"(STARFRUIT, MARKET << US, 5060, 1, 901100)
(STARFRUIT, MARKET << US, 5060, 1, 901100)","{""AMETHYSTS"": -8, ""STARFRUIT"": -2}",5650,5063,10000
901400,20260,116036,"(STARFRUIT, US << MARKET, 5065, 1, 901400)
(STARFRUIT, MARKET << US, 5065, 1, 901400)
(STARFRUIT, MARKET << US, 5065, 1, 901400)
(STARFRUIT, MARKET << US, 5065, 1, 901400)
(STARFRUIT, MARKET << US, 5065, 1, 901400)
(STARFRUIT, MARKET << US, 5065, 1, 901400)","{""AMETHYSTS"": -8, ""STARFRUIT"": -6}",5640,5066,10000
901500,-90100,25936,"(AMETHYSTS, US << MARKET, 9996, 1, 901500)
(AMETHYSTS, US << MARKET, 9996, 1, 901500)
(AMETHYSTS, US << MARKET, 9996, 1, 901500)
(AMETHYSTS, US << MARKET, 9996, 1, 901500)
(AMETHYSTS, US << MARKET, 9996, 1, 901500)
(AMETHYSTS, US << MARKET, 9996, 1, 901500)
(AMETHYSTS, US << MARKET, 9996, 1, 901500)
(AMETHYSTS, US << MARKET, 9996, 1, 901500)
(STARFRUIT, US << MARKET, 5066, 1, 901500)
(STARFRUIT, US << MARKET, 5066, 1, 901500)","{""AMETHYSTS"": 0, ""STARFRUIT"": -4}",5672,5066,10000
901900,-35427,-9491,"(STARFRUIT, US << MARKET, 5061, 1, 901900)
(STARFRUIT, US << MARKET, 5061, 1, 901900)
(STARFRUIT, US << MARKET, 5061, 1, 901900)
(STARFRUIT, US << MARKET, 5061, 1, 901900)
(STARFRUIT, US << MARKET, 5061, 1, 901900)
(STARFRUIT, US << MARKET, 5061, 1, 901900)
(STARFRUIT, US << MARKET, 5061, 1, 901900)","{""AMETHYSTS"": 0, ""STARFRUIT"": 3}",5701,5064,10003
902200,-20264,-29755,"(STARFRUIT, US << MARKET, 5066, 1, 902200)
(STARFRUIT, US << MARKET, 5066, 1, 902200)
(STARFRUIT, US << MARKET, 5066, 1, 902200)
(STARFRUIT, US << MARKET, 5066, 1, 902200)","{""AMETHYSTS"": 0, ""STARFRUIT"": 7}",5714,5067,10002
902400,9998,-19757,"(AMETHYSTS, MARKET << US, 9998, 1, 902400)","{""AMETHYSTS"": -1, ""STARFRUIT"": 7}",5710,5067,10002
902700,-5068,-24825,"(STARFRUIT, US << MARKET, 5068, 1, 902700)","{""AMETHYSTS"": -1, ""STARFRUIT"": 8}",5687,5064,10000
902900,9998,-14827,"(AMETHYSTS, MARKET << US, 9998, 1, 902900)","{""AMETHYSTS"": -2, ""STARFRUIT"": 8}",5705,5067,10002
903900,-19996,-34823,"(AMETHYSTS, US << MARKET, 9998, 1, 903900)
(AMETHYSTS, US << MARKET, 9998, 1, 903900)","{""AMETHYSTS"": 0, ""STARFRUIT"": 8}",5729,5069,10001
904100,20004,-14819,"(AMETHYSTS, MARKET << US, 10002, 1, 904100)
(AMETHYSTS, MARKET << US, 10002, 1, 904100)","{""AMETHYSTS"": -2, ""STARFRUIT"": 8}",5711,5067,10003
904300,100050,85231,"(AMETHYSTS, MARKET << US, 10005, 1, 904300)
(AMETHYSTS, MARKET << US, 10005, 1, 904300)
(AMETHYSTS, MARKET << US, 10005, 1, 904300)
(AMETHYSTS, MARKET << US, 10005, 1, 904300)
(AMETHYSTS, MARKET << US, 10005, 1, 904300)
(AMETHYSTS, MARKET << US, 10005, 1, 904300)
(AMETHYSTS, MARKET << US, 10005, 1, 904300)
(AMETHYSTS, MARKET << US, 10005, 1, 904300)
(AMETHYSTS, MARKET << US, 10005, 1, 904300)
(AMETHYSTS, MARKET << US, 10005, 1, 904300)","{""AMETHYSTS"": -12, ""STARFRUIT"": 8}",5775,5068,10000
904400,5071,90302,"(STARFRUIT, MARKET << US, 5071, 1, 904400)","{""AMETHYSTS"": -12, ""STARFRUIT"": 7}",5799,5071,10000
904600,24806,115108,"(AMETHYSTS, MARKET << US, 10004, 1, 904600)
(AMETHYSTS, MARKET << US, 10004, 1, 904600)
(AMETHYSTS, MARKET << US, 10004, 1, 904600)
(AMETHYSTS, MARKET << US, 10004, 1, 904600)
(STARFRUIT, US << MARKET, 5070, 1, 904600)
(STARFRUIT, US << MARKET, 5070, 1, 904600)
(STARFRUIT, US << MARKET, 5070, 1, 904600)","{""AMETHYSTS"": -16, ""STARFRUIT"": 10}",5778,5067,10000
904800,-10002,105106,"(AMETHYSTS, US << MARKET, 10002, 1, 904800)","{""AMETHYSTS"": -15, ""STARFRUIT"": 10}",5801,5068,9999
905000,20004,125110,"(AMETHYSTS, MARKET << US, 10002, 1, 905000)
(AMETHYSTS, MARKET << US, 10002, 1, 905000)","{""AMETHYSTS"": -17, ""STARFRUIT"": 10}",5729,5067,10003
905300,-5069,120041,"(STARFRUIT, US << MARKET, 5069, 1, 905300)","{""AMETHYSTS"": -17, ""STARFRUIT"": 11}",5800,5069,10000
905400,-19996,100045,"(AMETHYSTS, US << MARKET, 9998, 1, 905400)
(AMETHYSTS, US << MARKET, 9998, 1, 905400)","{""AMETHYSTS"": -15, ""STARFRUIT"": 11}",5827,5067,9997
905500,15065,115110,"(AMETHYSTS, MARKET << US, 9995, 1, 905500)
(STARFRUIT, MARKET << US, 5070, 1, 905500)","{""AMETHYSTS"": -16, ""STARFRUIT"": 10}",5810,5070,10000
905800,9998,125108,"(AMETHYSTS, MARKET << US, 9998, 1, 905800)","{""AMETHYSTS"": -17, ""STARFRUIT"": 10}",5829,5067,9997
906900,-20004,105104,"(AMETHYSTS, US << MARKET, 10002, 1, 906900)
(AMETHYSTS, US << MARKET, 10002, 1, 906900)","{""AMETHYSTS"": -15, ""STARFRUIT"": 10}",5719,5066,10003
907000,-39992,65112,"(AMETHYSTS, US << MARKET, 9998, 1, 907000)
(AMETHYSTS, US << MARKET, 9998, 1, 907000)
(AMETHYSTS, US << MARKET, 9998, 1, 907000)
(AMETHYSTS, US << MARKET, 9998, 1, 907000)","{""AMETHYSTS"": -11, ""STARFRUIT"": 10}",5805,5066,9997
907300,20008,85120,"(AMETHYSTS, MARKET << US, 10004, 1, 907300)
(AMETHYSTS, MARKET << US, 10004, 1, 907300)","{""AMETHYSTS"": -13, ""STARFRUIT"": 10}",5780,5066,10000
907400,25077,110197,"(AMETHYSTS, MARKET << US, 10004, 1, 907400)
(AMETHYSTS, MARKET << US, 10004, 1, 907400)
(STARFRUIT, MARKET << US, 5069, 1, 907400)","{""AMETHYSTS"": -15, ""STARFRUIT"": 9}",5782,5065,10000
907500,30372,140569,"(STARFRUIT, MARKET << US, 5062, 1, 907500)
(STARFRUIT, MARKET << US, 5062, 1, 907500)
(STARFRUIT, MARKET << US, 5062, 1, 907500)
(STARFRUIT, MARKET << US, 5062, 1, 907500)
(STARFRUIT, MARKET << US, 5062, 1, 907500)
(STARFRUIT, MARKET << US, 5062, 1, 907500)","{""AMETHYSTS"": -15, ""STARFRUIT"": 3}",5761,5064,10000
907600,-9874,130695,"(AMETHYSTS, US << MARKET, 10004, 1, 907600)
(AMETHYSTS, US << MARKET, 10004, 1, 907600)
(STARFRUIT, MARKET << US, 5067, 1, 907600)
(STARFRUIT, MARKET << US, 5067, 1, 907600)","{""AMETHYSTS"": -13, ""STARFRUIT"": 1}",5760,5065,10000
907800,60012,190707,"(AMETHYSTS, MARKET << US, 10002, 1, 907800)
(AMETHYSTS, MARKET << US, 10002, 1, 907800)
(AMETHYSTS, MARKET << US, 10002, 1, 907800)
(AMETHYSTS, MARKET << US, 10002, 1, 907800)
(AMETHYSTS, MARKET << US, 10002, 1, 907800)
(AMETHYSTS, MARKET << US, 10002, 1, 907800)","{""AMETHYSTS"": -19, ""STARFRUIT"": 1}",5716,5066,10003
908000,10002,200709,"(AMETHYSTS, MARKET << US, 10002, 1, 908000)","{""AMETHYSTS"": -20, ""STARFRUIT"": 1}",5715,5066,10003
908100,-50010,150699,"(AMETHYSTS, US << MARKET, 10002, 1, 908100)
(AMETHYSTS, US << MARKET, 10002, 1, 908100)
(AMETHYSTS, US << MARKET, 10002, 1, 908100)
(AMETHYSTS, US << MARKET, 10002, 1, 908100)
(AMETHYSTS, US << MARKET, 10002, 1, 908100)","{""AMETHYSTS"": -15, ""STARFRUIT"": 1}",5796,5067,9998
908200,-10128,140571,"(STARFRUIT, US << MARKET, 5064, 1, 908200)
(STARFRUIT, US << MARKET, 5064, 1, 908200)","{""AMETHYSTS"": -15, ""STARFRUIT"": 3}",5787,5067,9999
908300,5069,145640,"(STARFRUIT, MARKET << US, 5069, 1, 908300)","{""AMETHYSTS"": -15, ""STARFRUIT"": 2}",5808,5069,9998
908500,9998,155638,"(AMETHYSTS, MARKET << US, 9998, 1, 908500)","{""AMETHYSTS"": -16, ""STARFRUIT"": 2}",5820,5067,9997
908700,-24937,130701,"(AMETHYSTS, US << MARKET, 10002, 1, 908700)
(AMETHYSTS, US << MARKET, 10002, 1, 908700)
(AMETHYSTS, US << MARKET, 10002, 1, 908700)
(STARFRUIT, MARKET << US, 5069, 1, 908700)","{""AMETHYSTS"": -13, ""STARFRUIT"": 1}",5731,5069,10003
909500,25068,155769,"(AMETHYSTS, MARKET << US, 10002, 1, 909500)
(AMETHYSTS, MARKET << US, 10002, 1, 909500)
(STARFRUIT, MARKET << US, 5064, 1, 909500)","{""AMETHYSTS"": -15, ""STARFRUIT"": 0}",5784,5067,9999
910200,29758,185527,"(AMETHYSTS, MARKET << US, 10002, 1, 910200)
(AMETHYSTS, MARKET << US, 10002, 1, 910200)
(AMETHYSTS, MARKET << US, 10002, 1, 910200)
(AMETHYSTS, MARKET << US, 10002, 1, 910200)
(AMETHYSTS, MARKET << US, 10002, 1, 910200)
(STARFRUIT, US << MARKET, 5063, 1, 910200)
(STARFRUIT, US << MARKET, 5063, 1, 910200)
(STARFRUIT, US << MARKET, 5063, 1, 910200)
(STARFRUIT, US << MARKET, 5063, 1, 910200)","{""AMETHYSTS"": -20, ""STARFRUIT"": 4}",5731,5066,10003
910400,-9730,175797,"(AMETHYSTS, US << MARKET, 10002, 1, 910400)
(AMETHYSTS, US << MARKET, 10002, 1, 910400)
(AMETHYSTS, US << MARKET, 10002, 1, 910400)
(STARFRUIT, MARKET << US, 5069, 1, 910400)
(STARFRUIT, MARKET << US, 5069, 1, 910400)
(STARFRUIT, MARKET << US, 5069, 1, 910400)
(STARFRUIT, MARKET << US, 5069, 1, 910400)","{""AMETHYSTS"": -17, ""STARFRUIT"": 0}",5814,5065,9999
910500,-10124,165673,"(STARFRUIT, US << MARKET, 5062, 1, 910500)
(STARFRUIT, US << MARKET, 5062, 1, 910500)","{""AMETHYSTS"": -17, ""STARFRUIT"": 2}",5803,5065,10000
910900,9872,175545,"(AMETHYSTS, MARKET << US, 10005, 1, 910900)
(AMETHYSTS, MARKET << US, 10005, 1, 910900)
(STARFRUIT, US << MARKET, 5069, 1, 910900)
(STARFRUIT, US << MARKET, 5069, 1, 910900)","{""AMETHYSTS"": -19, ""STARFRUIT"": 4}",5805,5065,10000
911300,-239880,-64335,"(AMETHYSTS, US << MARKET, 9995, 1, 911300)
(AMETHYSTS, US << MARKET, 9995, 1, 911300)
(AMETHYSTS, US << MARKET, 9995, 1, 911300)
(AMETHYSTS, US << MARKET, 9995, 1, 911300)
(AMETHYSTS, US << MARKET, 9995, 1, 911300)
(AMETHYSTS, US << MARKET, 9995, 1, 911300)
(AMETHYSTS, US << MARKET, 9995, 1, 911300)
(AMETHYSTS, US << MARKET, 9995, 1, 911300)
(AMETHYSTS, US << MARKET, 9995, 1, 911300)
(AMETHYSTS, US << MARKET, 9995, 1, 911300)
(AMETHYSTS, US << MARKET, 9995, 1, 911300)
(AMETHYSTS, US << MARKET, 9995, 1, 911300)
(AMETHYSTS, US << MARKET, 9995, 1, 911300)
(AMETHYSTS, US << MARKET, 9995, 1, 911300)
(AMETHYSTS, US << MARKET, 9995, 1, 911300)
(AMETHYSTS, US << MARKET, 9995, 1, 911300)
(AMETHYSTS, US << MARKET, 9995, 1, 911300)
(AMETHYSTS, US << MARKET, 9995, 1, 911300)
(AMETHYSTS, US << MARKET, 9995, 1, 911300)
(AMETHYSTS, US << MARKET, 9995, 1, 911300)
(AMETHYSTS, US << MARKET, 9995, 1, 911300)
(AMETHYSTS, US << MARKET, 9995, 1, 911300)
(AMETHYSTS, US << MARKET, 9995, 1, 911300)
(AMETHYSTS, US << MARKET, 9995, 1, 911300)","{""AMETHYSTS"": 5, ""STARFRUIT"": 4}",5917,5063,10000
911500,40016,-24319,"(AMETHYSTS, MARKET << US, 10004, 1, 911500)
(AMETHYSTS, MARKET << US, 10004, 1, 911500)
(AMETHYSTS, MARKET << US, 10004, 1, 911500)
(AMETHYSTS, MARKET << US, 10004, 1, 911500)","{""AMETHYSTS"": 1, ""STARFRUIT"": 4}",5929,5062,10000
911800,-19996,-44315,"(AMETHYSTS, US << MARKET, 9998, 1, 911800)
(AMETHYSTS, US << MARKET, 9998, 1, 911800)","{""AMETHYSTS"": 3, ""STARFRUIT"": 4}",5925,5063,9996
912100,5060,-39255,"(STARFRUIT, MARKET << US, 5060, 1, 912100)","{""AMETHYSTS"": 3, ""STARFRUIT"": 3}",5931,5062,10000
912700,-30114,-69369,"(AMETHYSTS, US << MARKET, 9996, 1, 912700)
(AMETHYSTS, US << MARKET, 9996, 1, 912700)
(STARFRUIT, US << MARKET, 5061, 1, 912700)
(STARFRUIT, US << MARKET, 5061, 1, 912700)","{""AMETHYSTS"": 5, ""STARFRUIT"": 5}",5951,5064,10000
912800,-15198,-84567,"(STARFRUIT, US << MARKET, 5066, 1, 912800)
(STARFRUIT, US << MARKET, 5066, 1, 912800)
(STARFRUIT, US << MARKET, 5066, 1, 912800)","{""AMETHYSTS"": 5, ""STARFRUIT"": 8}",5969,5067,10000
913100,5067,-79500,"(STARFRUIT, MARKET << US, 5067, 1, 913100)","{""AMETHYSTS"": 5, ""STARFRUIT"": 7}",5974,5067,10001
913200,25310,-54190,"(STARFRUIT, MARKET << US, 5062, 1, 913200)
(STARFRUIT, MARKET << US, 5062, 1, 913200)
(STARFRUIT, MARKET << US, 5062, 1, 913200)
(STARFRUIT, MARKET << US, 5062, 1, 913200)
(STARFRUIT, MARKET << US, 5062, 1, 913200)","{""AMETHYSTS"": 5, ""STARFRUIT"": 2}",5935,5065,9999
913300,-20248,-74438,"(STARFRUIT, US << MARKET, 5062, 1, 913300)
(STARFRUIT, US << MARKET, 5062, 1, 913300)
(STARFRUIT, US << MARKET, 5062, 1, 913300)
(STARFRUIT, US << MARKET, 5062, 1, 913300)","{""AMETHYSTS"": 5, ""STARFRUIT"": 6}",5952,5065,10000
913700,-19996,-94434,"(AMETHYSTS, US << MARKET, 9998, 1, 913700)
(AMETHYSTS, US << MARKET, 9998, 1, 913700)","{""AMETHYSTS"": 7, ""STARFRUIT"": 6}",5929,5064,9997
914000,5063,-89371,"(STARFRUIT, MARKET << US, 5063, 1, 914000)","{""AMETHYSTS"": 7, ""STARFRUIT"": 5}",5954,5065,10000
914700,30140,-59231,"(AMETHYSTS, MARKET << US, 10004, 1, 914700)
(AMETHYSTS, MARKET << US, 10004, 1, 914700)
(STARFRUIT, MARKET << US, 5066, 1, 914700)
(STARFRUIT, MARKET << US, 5066, 1, 914700)","{""AMETHYSTS"": 5, ""STARFRUIT"": 3}",5955,5062,10000
914800,-39992,-99223,"(AMETHYSTS, US << MARKET, 9998, 1, 914800)
(AMETHYSTS, US << MARKET, 9998, 1, 914800)
(AMETHYSTS, US << MARKET, 9998, 1, 914800)
(AMETHYSTS, US << MARKET, 9998, 1, 914800)","{""AMETHYSTS"": 9, ""STARFRUIT"": 3}",5942,5064,9997
914900,-10120,-109343,"(STARFRUIT, US << MARKET, 5060, 1, 914900)
(STARFRUIT, US << MARKET, 5060, 1, 914900)","{""AMETHYSTS"": 9, ""STARFRUIT"": 5}",5977,5064,10000
915000,9876,-99467,"(AMETHYSTS, MARKET << US, 10004, 1, 915000)
(AMETHYSTS, MARKET << US, 10004, 1, 915000)
(STARFRUIT, US << MARKET, 5066, 1, 915000)
(STARFRUIT, US << MARKET, 5066, 1, 915000)","{""AMETHYSTS"": 7, ""STARFRUIT"": 7}",5974,5063,10000
915100,-14936,-114403,"(AMETHYSTS, US << MARKET, 9998, 1, 915100)
(AMETHYSTS, US << MARKET, 9998, 1, 915100)
(STARFRUIT, MARKET << US, 5060, 1, 915100)","{""AMETHYSTS"": 9, ""STARFRUIT"": 6}",5948,5063,9997
915200,10124,-104279,"(STARFRUIT, MARKET << US, 5062, 1, 915200)
(STARFRUIT, MARKET << US, 5062, 1, 915200)","{""AMETHYSTS"": 9, ""STARFRUIT"": 4}",5934,5060,9997
915600,-10118,-114397,"(STARFRUIT, US << MARKET, 5059, 1, 915600)
(STARFRUIT, US << MARKET, 5059, 1, 915600)","{""AMETHYSTS"": 9, ""STARFRUIT"": 6}",5975,5062,10000
916200,0,-114397,"(AMETHYSTS, US << MARKET, 9998, 1, 916200)
(AMETHYSTS, US << MARKET, 9998, 1, 916200)
(AMETHYSTS, MARKET << US, 9998, 1, 916200)
(AMETHYSTS, MARKET << US, 9998, 1, 916200)","{""AMETHYSTS"": 9, ""STARFRUIT"": 6}",5960,5058,10001
916300,-20240,-134637,"(STARFRUIT, US << MARKET, 5060, 1, 916300)
(STARFRUIT, US << MARKET, 5060, 1, 916300)
(STARFRUIT, US << MARKET, 5060, 1, 916300)
(STARFRUIT, US << MARKET, 5060, 1, 916300)","{""AMETHYSTS"": 9, ""STARFRUIT"": 10}",5925,5058,9998
916700,-15069,-149706,"(AMETHYSTS, US << MARKET, 10005, 1, 916700)
(STARFRUIT, US << MARKET, 5064, 1, 916700)","{""AMETHYSTS"": 10, ""STARFRUIT"": 11}",5954,5060,10000
916800,25295,-124411,"(STARFRUIT, MARKET << US, 5059, 1, 916800)
(STARFRUIT, MARKET << US, 5059, 1, 916800)
(STARFRUIT, MARKET << US, 5059, 1, 916800)
(STARFRUIT, MARKET << US, 5059, 1, 916800)
(STARFRUIT, MARKET << US, 5059, 1, 916800)","{""AMETHYSTS"": 10, ""STARFRUIT"": 6}",5937,5058,10000
916900,-15174,-139585,"(STARFRUIT, US << MARKET, 5058, 1, 916900)
(STARFRUIT, US << MARKET, 5058, 1, 916900)
(STARFRUIT, US << MARKET, 5058, 1, 916900)","{""AMETHYSTS"": 10, ""STARFRUIT"": 9}",5982,5063,10000
917300,-20256,-159841,"(STARFRUIT, US << MARKET, 5064, 1, 917300)
(STARFRUIT, US << MARKET, 5064, 1, 917300)
(STARFRUIT, US << MARKET, 5064, 1, 917300)
(STARFRUIT, US << MARKET, 5064, 1, 917300)","{""AMETHYSTS"": 10, ""STARFRUIT"": 13}",5952,5061,10000
917600,160016,175,"(AMETHYSTS, US << MARKET, 10004, 1, 917600)
(AMETHYSTS, US << MARKET, 10004, 1, 917600)
(AMETHYSTS, US << MARKET, 10004, 1, 917600)
(AMETHYSTS, US << MARKET, 10004, 1, 917600)
(AMETHYSTS, US << MARKET, 10004, 1, 917600)
(AMETHYSTS, US << MARKET, 10004, 1, 917600)
(AMETHYSTS, US << MARKET, 10004, 1, 917600)
(AMETHYSTS, US << MARKET, 10004, 1, 917600)
(AMETHYSTS, MARKET << US, 10002, 1, 917600)
(AMETHYSTS, MARKET << US, 10002, 1, 917600)
(AMETHYSTS, MARKET << US, 10002, 1, 917600)
(AMETHYSTS, MARKET << US, 10002, 1, 917600)
(AMETHYSTS, MARKET << US, 10002, 1, 917600)
(AMETHYSTS, MARKET << US, 10002, 1, 917600)
(AMETHYSTS, MARKET << US, 10002, 1, 917600)
(AMETHYSTS, MARKET << US, 10002, 1, 917600)
(AMETHYSTS, MARKET << US, 10002, 1, 917600)
(AMETHYSTS, MARKET << US, 10002, 1, 917600)
(AMETHYSTS, MARKET << US, 10002, 1, 917600)
(AMETHYSTS, MARKET << US, 10002, 1, 917600)
(AMETHYSTS, MARKET << US, 10002, 1, 917600)
(AMETHYSTS, MARKET << US, 10002, 1, 917600)
(AMETHYSTS, MARKET << US, 10002, 1, 917600)
(AMETHYSTS, MARKET << US, 10002, 1, 917600)
(AMETHYSTS, MARKET << US, 10002, 1, 917600)
(AMETHYSTS, MARKET << US, 10002, 1, 917600)
(AMETHYSTS, MARKET << US, 10002, 1, 917600)
(AMETHYSTS, MARKET << US, 10002, 1, 917600)
(AMETHYSTS, MARKET << US, 10002, 1, 917600)
(AMETHYSTS, MARKET << US, 10002, 1, 917600)
(AMETHYSTS, MARKET << US, 10002, 1, 917600)
(AMETHYSTS, MARKET << US, 10002, 1, 917600)","{""AMETHYSTS"": -6, ""STARFRUIT"": 13}",5937,5060,10003
917800,5058,5233,"(STARFRUIT, MARKET << US, 5058, 1, 917800)","{""AMETHYSTS"": -6, ""STARFRUIT"": 12}",5971,5061,9999
918000,-20244,-15011,"(STARFRUIT, US << MARKET, 5061, 1, 918000)
(STARFRUIT, US << MARKET, 5061, 1, 918000)
(STARFRUIT, US << MARKET, 5061, 1, 918000)
(STARFRUIT, US << MARKET, 5061, 1, 918000)","{""AMETHYSTS"": -6, ""STARFRUIT"": 16}",5999,5062,9997
918400,9998,-5013,"(AMETHYSTS, MARKET << US, 9998, 1, 918400)","{""AMETHYSTS"": -7, ""STARFRUIT"": 16}",5952,5059,9997
918800,5057,44,"(STARFRUIT, MARKET << US, 5057, 1, 918800)","{""AMETHYSTS"": -7, ""STARFRUIT"": 15}",5937,5060,10001
918900,-15180,-15136,"(STARFRUIT, US << MARKET, 5060, 1, 918900)
(STARFRUIT, US << MARKET, 5060, 1, 918900)
(STARFRUIT, US << MARKET, 5060, 1, 918900)","{""AMETHYSTS"": -7, ""STARFRUIT"": 18}",5940,5059,9998
919000,89964,74828,"(AMETHYSTS, MARKET << US, 9996, 1, 919000)
(AMETHYSTS, MARKET << US, 9996, 1, 919000)
(AMETHYSTS, MARKET << US, 9996, 1, 919000)
(AMETHYSTS, MARKET << US, 9996, 1, 919000)
(AMETHYSTS, MARKET << US, 9996, 1, 919000)
(AMETHYSTS, MARKET << US, 9996, 1, 919000)
(AMETHYSTS, MARKET << US, 9996, 1, 919000)
(AMETHYSTS, MARKET << US, 9996, 1, 919000)
(AMETHYSTS, MARKET << US, 9996, 1, 919000)","{""AMETHYSTS"": -16, ""STARFRUIT"": 18}",5908,5060,10000
919500,-94918,-20090,"(AMETHYSTS, US << MARKET, 9998, 1, 919500)
(AMETHYSTS, US << MARKET, 9998, 1, 919500)
(AMETHYSTS, US << MARKET, 9998, 1, 919500)
(AMETHYSTS, US << MARKET, 9998, 1, 919500)
(AMETHYSTS, US << MARKET, 9998, 1, 919500)
(AMETHYSTS, US << MARKET, 9998, 1, 919500)
(AMETHYSTS, US << MARKET, 9998, 1, 919500)
(AMETHYSTS, US << MARKET, 9998, 1, 919500)
(AMETHYSTS, US << MARKET, 9998, 1, 919500)
(AMETHYSTS, US << MARKET, 9998, 1, 919500)
(STARFRUIT, MARKET << US, 5062, 1, 919500)","{""AMETHYSTS"": -6, ""STARFRUIT"": 17}",5931,5059,9997
919600,-129948,-150038,"(AMETHYSTS, US << MARKET, 9996, 1, 919600)
(AMETHYSTS, US << MARKET, 9996, 1, 919600)
(AMETHYSTS, US << MARKET, 9996, 1, 919600)
(AMETHYSTS, US << MARKET, 9996, 1, 919600)
(AMETHYSTS, US << MARKET, 9996, 1, 919600)
(AMETHYSTS, US << MARKET, 9996, 1, 919600)
(AMETHYSTS, US << MARKET, 9996, 1, 919600)
(AMETHYSTS, US << MARKET, 9996, 1, 919600)
(AMETHYSTS, US << MARKET, 9996, 1, 919600)
(AMETHYSTS, US << MARKET, 9996, 1, 919600)
(AMETHYSTS, US << MARKET, 9996, 1, 919600)
(AMETHYSTS, US << MARKET, 9996, 1, 919600)
(AMETHYSTS, US << MARKET, 9996, 1, 919600)
(AMETHYSTS, US << MARKET, 9996, 1, 919600)
(AMETHYSTS, MARKET << US, 9996, 1, 919600)","{""AMETHYSTS"": 7, ""STARFRUIT"": 17}",5927,5058,9997
919800,9998,-140040,"(AMETHYSTS, MARKET << US, 9998, 1, 919800)","{""AMETHYSTS"": 6, ""STARFRUIT"": 17}",5952,5058,10001
920100,-15177,-155217,"(STARFRUIT, US << MARKET, 5059, 1, 920100)
(STARFRUIT, US << MARKET, 5059, 1, 920100)
(STARFRUIT, US << MARKET, 5059, 1, 920100)","{""AMETHYSTS"": 6, ""STARFRUIT"": 20}",5905,5057,9997
920400,-99980,-255197,"(AMETHYSTS, US << MARKET, 9998, 1, 920400)
(AMETHYSTS, US << MARKET, 9998, 1, 920400)
(AMETHYSTS, US << MARKET, 9998, 1, 920400)
(AMETHYSTS, US << MARKET, 9998, 1, 920400)
(AMETHYSTS, US << MARKET, 9998, 1, 920400)
(AMETHYSTS, US << MARKET, 9998, 1, 920400)
(AMETHYSTS, US << MARKET, 9998, 1, 920400)
(AMETHYSTS, US << MARKET, 9998, 1, 920400)
(AMETHYSTS, US << MARKET, 9998, 1, 920400)
(AMETHYSTS, US << MARKET, 9998, 1, 920400)","{""AMETHYSTS"": 16, ""STARFRUIT"": 20}",5915,5058,9997
920900,9996,-245201,"(AMETHYSTS, MARKET << US, 9996, 1, 920900)","{""AMETHYSTS"": 15, ""STARFRUIT"": 20}",5939,5057,10000
922000,0,-245201,,"{""AMETHYSTS"": 15, ""STARFRUIT"": 20}",5999,5060,10000
922400,39992,-205209,"(AMETHYSTS, MARKET << US, 9998, 1, 922400)
(AMETHYSTS, MARKET << US, 9998, 1, 922400)
(AMETHYSTS, MARKET << US, 9998, 1, 922400)
(AMETHYSTS, MARKET << US, 9998, 1, 922400)","{""AMETHYSTS"": 11, ""STARFRUIT"": 20}",5918,5058,9997
922700,5054,-200155,"(STARFRUIT, MARKET << US, 5054, 1, 922700)","{""AMETHYSTS"": 11, ""STARFRUIT"": 19}",5928,5057,10000
922800,20004,-180151,"(AMETHYSTS, MARKET << US, 10002, 1, 922800)
(AMETHYSTS, MARKET << US, 10002, 1, 922800)","{""AMETHYSTS"": 9, ""STARFRUIT"": 19}",5959,5057,10003
923300,-5061,-185212,"(STARFRUIT, US << MARKET, 5061, 1, 923300)","{""AMETHYSTS"": 9, ""STARFRUIT"": 20}",6008,5061,10000
923400,20004,-165208,"(AMETHYSTS, MARKET << US, 10002, 1, 923400)
(AMETHYSTS, MARKET << US, 10002, 1, 923400)","{""AMETHYSTS"": 7, ""STARFRUIT"": 20}",5953,5057,10003
923500,15052,-150156,"(AMETHYSTS, MARKET << US, 9996, 1, 923500)
(STARFRUIT, MARKET << US, 5056, 1, 923500)","{""AMETHYSTS"": 6, ""STARFRUIT"": 19}",5965,5059,10000
923600,-4942,-155098,"(AMETHYSTS, US << MARKET, 10005, 1, 923600)
(STARFRUIT, MARKET << US, 5063, 1, 923600)","{""AMETHYSTS"": 7, ""STARFRUIT"": 18}",5964,5059,10000
923800,-20004,-175102,"(AMETHYSTS, US << MARKET, 10002, 1, 923800)
(AMETHYSTS, US << MARKET, 10002, 1, 923800)","{""AMETHYSTS"": 9, ""STARFRUIT"": 18}",5987,5059,10003
924100,20004,-155098,"(AMETHYSTS, MARKET << US, 10002, 1, 924100)
(AMETHYSTS, MARKET << US, 10002, 1, 924100)","{""AMETHYSTS"": 7, ""STARFRUIT"": 18}",5939,5058,9999
924700,25060,-130038,"(AMETHYSTS, MARKET << US, 10002, 1, 924700)
(AMETHYSTS, MARKET << US, 10002, 1, 924700)
(STARFRUIT, MARKET << US, 5056, 1, 924700)","{""AMETHYSTS"": 5, ""STARFRUIT"": 17}",5980,5059,10003
924800,20004,-110034,"(AMETHYSTS, MARKET << US, 10002, 1, 924800)
(AMETHYSTS, MARKET << US, 10002, 1, 924800)","{""AMETHYSTS"": 3, ""STARFRUIT"": 17}",5995,5060,10003
925400,-5059,-115093,"(STARFRUIT, US << MARKET, 5059, 1, 925400)","{""AMETHYSTS"": 3, ""STARFRUIT"": 18}",6005,5061,10000
925600,15054,-100039,"(AMETHYSTS, MARKET << US, 9995, 1, 925600)
(STARFRUIT, MARKET << US, 5059, 1, 925600)","{""AMETHYSTS"": 2, ""STARFRUIT"": 17}",6015,5062,10000
926200,5062,-94977,"(STARFRUIT, MARKET << US, 5062, 1, 926200)","{""AMETHYSTS"": 2, ""STARFRUIT"": 16}",6013,5062,9999
926300,-5057,-100034,"(STARFRUIT, US << MARKET, 5057, 1, 926300)","{""AMETHYSTS"": 2, ""STARFRUIT"": 17}",5967,5059,9999
926800,20004,-80030,"(AMETHYSTS, MARKET << US, 10002, 1, 926800)
(AMETHYSTS, MARKET << US, 10002, 1, 926800)","{""AMETHYSTS"": 0, ""STARFRUIT"": 17}",6007,5061,10003
926900,5063,-74967,"(STARFRUIT, MARKET << US, 5063, 1, 926900)","{""AMETHYSTS"": 0, ""STARFRUIT"": 16}",5961,5058,9998
927600,-10118,-85085,"(STARFRUIT, US << MARKET, 5059, 1, 927600)
(STARFRUIT, US << MARKET, 5059, 1, 927600)","{""AMETHYSTS"": 0, ""STARFRUIT"": 18}",5959,5058,9998
927700,-5056,-90141,"(STARFRUIT, US << MARKET, 5056, 1, 927700)
(STARFRUIT, US << MARKET, 5056, 1, 927700)
(STARFRUIT, MARKET << US, 5056, 1, 927700)","{""AMETHYSTS"": 0, ""STARFRUIT"": 19}",5980,5059,10000
928200,9998,-80143,"(AMETHYSTS, MARKET << US, 9998, 1, 928200)","{""AMETHYSTS"": -1, ""STARFRUIT"": 19}",5977,5059,10001
928400,5062,-75081,"(STARFRUIT, MARKET << US, 5062, 1, 928400)","{""AMETHYSTS"": -1, ""STARFRUIT"": 18}",5946,5057,9999
928800,-5062,-80143,"(STARFRUIT, US << MARKET, 5062, 1, 928800)","{""AMETHYSTS"": -1, ""STARFRUIT"": 19}",5978,5059,10000
928900,-5059,-85202,"(STARFRUIT, US << MARKET, 5059, 1, 928900)","{""AMETHYSTS"": -1, ""STARFRUIT"": 20}",5940,5057,9998
929600,0,-85202,,"{""AMETHYSTS"": -1, ""STARFRUIT"": 20}",6018,5061,10000
929700,126,-85076,"(AMETHYSTS, US << MARKET, 10004, 1, 929700)
(STARFRUIT, MARKET << US, 5065, 1, 929700)
(STARFRUIT, MARKET << US, 5065, 1, 929700)","{""AMETHYSTS"": 0, ""STARFRUIT"": 18}",6022,5061,10001
930100,-119976,-205052,"(AMETHYSTS, US << MARKET, 9998, 1, 930100)
(AMETHYSTS, US << MARKET, 9998, 1, 930100)
(AMETHYSTS, US << MARKET, 9998, 1, 930100)
(AMETHYSTS, US << MARKET, 9998, 1, 930100)
(AMETHYSTS, US << MARKET, 9998, 1, 930100)
(AMETHYSTS, US << MARKET, 9998, 1, 930100)
(AMETHYSTS, US << MARKET, 9998, 1, 930100)
(AMETHYSTS, US << MARKET, 9998, 1, 930100)
(AMETHYSTS, US << MARKET, 9998, 1, 930100)
(AMETHYSTS, US << MARKET, 9998, 1, 930100)
(AMETHYSTS, US << MARKET, 9998, 1, 930100)
(AMETHYSTS, US << MARKET, 9998, 1, 930100)","{""AMETHYSTS"": 12, ""STARFRUIT"": 18}",6028,5062,9997
930200,-5059,-210111,"(STARFRUIT, US << MARKET, 5059, 1, 930200)","{""AMETHYSTS"": 12, ""STARFRUIT"": 19}",6055,5062,9999
931100,9998,-200113,"(AMETHYSTS, MARKET << US, 9998, 1, 931100)","{""AMETHYSTS"": 11, ""STARFRUIT"": 19}",6076,5062,10001
931400,25190,-174923,"(AMETHYSTS, MARKET << US, 9998, 1, 931400)
(STARFRUIT, US << MARKET, 5064, 1, 931400)
(STARFRUIT, MARKET << US, 5064, 1, 931400)
(STARFRUIT, MARKET << US, 5064, 1, 931400)
(STARFRUIT, MARKET << US, 5064, 1, 931400)
(STARFRUIT, MARKET << US, 5064, 1, 931400)","{""AMETHYSTS"": 10, ""STARFRUIT"": 16}",6023,5061,9997
931600,25042,-149881,"(AMETHYSTS, MARKET << US, 9995, 1, 931600)
(AMETHYSTS, MARKET << US, 9995, 1, 931600)
(STARFRUIT, US << MARKET, 5064, 1, 931600)
(STARFRUIT, MARKET << US, 5058, 1, 931600)
(STARFRUIT, MARKET << US, 5058, 1, 931600)","{""AMETHYSTS"": 8, ""STARFRUIT"": 15}",6034,5061,10000
931700,-19996,-169877,"(AMETHYSTS, US << MARKET, 9998, 1, 931700)
(AMETHYSTS, US << MARKET, 9998, 1, 931700)","{""AMETHYSTS"": 10, ""STARFRUIT"": 15}",6053,5062,10000
931900,10128,-159749,"(STARFRUIT, MARKET << US, 5064, 1, 931900)
(STARFRUIT, MARKET << US, 5064, 1, 931900)","{""AMETHYSTS"": 10, ""STARFRUIT"": 13}",6086,5065,9999
932200,9998,-149751,"(AMETHYSTS, MARKET << US, 9998, 1, 932200)","{""AMETHYSTS"": 9, ""STARFRUIT"": 13}",6064,5062,10001
932900,-5064,-154815,"(STARFRUIT, US << MARKET, 5064, 1, 932900)","{""AMETHYSTS"": 9, ""STARFRUIT"": 14}",6048,5061,10001
933000,9998,-144817,"(AMETHYSTS, MARKET << US, 9998, 1, 933000)","{""AMETHYSTS"": 8, ""STARFRUIT"": 14}",6013,5061,9997
933200,123,-144694,"(AMETHYSTS, US << MARKET, 9998, 1, 933200)
(AMETHYSTS, US << MARKET, 9998, 1, 933200)
(AMETHYSTS, MARKET << US, 9996, 1, 933200)
(STARFRUIT, US << MARKET, 5057, 1, 933200)
(STARFRUIT, MARKET << US, 5060, 1, 933200)
(STARFRUIT, MARKET << US, 5060, 1, 933200)
(STARFRUIT, MARKET << US, 5060, 1, 933200)","{""AMETHYSTS"": 9, ""STARFRUIT"": 12}",5975,5058,9997
933300,105079,-39615,"(AMETHYSTS, MARKET << US, 10002, 1, 933300)
(AMETHYSTS, MARKET << US, 10002, 1, 933300)
(AMETHYSTS, MARKET << US, 10002, 1, 933300)
(AMETHYSTS, MARKET << US, 10002, 1, 933300)
(AMETHYSTS, MARKET << US, 10002, 1, 933300)
(AMETHYSTS, MARKET << US, 10002, 1, 933300)
(AMETHYSTS, MARKET << US, 10002, 1, 933300)
(AMETHYSTS, MARKET << US, 10002, 1, 933300)
(AMETHYSTS, MARKET << US, 10002, 1, 933300)
(AMETHYSTS, MARKET << US, 10002, 1, 933300)
(STARFRUIT, US << MARKET, 5063, 1, 933300)
(STARFRUIT, MARKET << US, 5061, 1, 933300)
(STARFRUIT, MARKET << US, 5061, 1, 933300)","{""AMETHYSTS"": -1, ""STARFRUIT"": 11}",6031,5059,10003
933400,-20248,-59863,"(STARFRUIT, US << MARKET, 5062, 1, 933400)
(STARFRUIT, US << MARKET, 5062, 1, 933400)
(STARFRUIT, US << MARKET, 5062, 1, 933400)
(STARFRUIT, US << MARKET, 5062, 1, 933400)","{""AMETHYSTS"": -1, ""STARFRUIT"": 15}",6067,5062,10000
933500,79960,20097,"(AMETHYSTS, MARKET << US, 9995, 1, 933500)
(AMETHYSTS, MARKET << US, 9995, 1, 933500)
(AMETHYSTS, MARKET << US, 9995, 1, 933500)
(AMETHYSTS, MARKET << US, 9995, 1, 933500)
(AMETHYSTS, MARKET << US, 9995, 1, 933500)
(AMETHYSTS, MARKET << US, 9995, 1, 933500)
(AMETHYSTS, MARKET << US, 9995, 1, 933500)
(AMETHYSTS, MARKET << US, 9995, 1, 933500)","{""AMETHYSTS"": -9, ""STARFRUIT"": 15}",6027,5062,10000
933900,126,20223,"(AMETHYSTS, US << MARKET, 10004, 1, 933900)
(STARFRUIT, MARKET << US, 5065, 1, 933900)
(STARFRUIT, MARKET << US, 5065, 1, 933900)","{""AMETHYSTS"": -8, ""STARFRUIT"": 13}",6008,5061,10001
934000,10005,30228,"(AMETHYSTS, US << MARKET, 10005, 1, 934000)
(AMETHYSTS, US << MARKET, 10005, 1, 934000)
(AMETHYSTS, US << MARKET, 10005, 1, 934000)
(AMETHYSTS, US << MARKET, 10005, 1, 934000)
(AMETHYSTS, US << MARKET, 10005, 1, 934000)
(AMETHYSTS, US << MARKET, 10005, 1, 934000)
(AMETHYSTS, US << MARKET, 10005, 1, 934000)
(AMETHYSTS, US << MARKET, 10005, 1, 934000)
(AMETHYSTS, US << MARKET, 10005, 1, 934000)
(AMETHYSTS, US << MARKET, 10005, 1, 934000)
(AMETHYSTS, MARKET << US, 10005, 1, 934000)
(AMETHYSTS, MARKET << US, 10005, 1, 934000)
(AMETHYSTS, MARKET << US, 10005, 1, 934000)
(AMETHYSTS, MARKET << US, 10005, 1, 934000)
(AMETHYSTS, MARKET << US, 10005, 1, 934000)
(AMETHYSTS, MARKET << US, 10005, 1, 934000)
(AMETHYSTS, MARKET << US, 10005, 1, 934000)
(AMETHYSTS, MARKET << US, 10005, 1, 934000)
(AMETHYSTS, MARKET << US, 10005, 1, 934000)
(AMETHYSTS, MARKET << US, 10005, 1, 934000)
(AMETHYSTS, MARKET << US, 10005, 1, 934000)","{""AMETHYSTS"": -9, ""STARFRUIT"": 13}",6008,5060,10000
934300,9998,40226,"(AMETHYSTS, MARKET << US, 9998, 1, 934300)","{""AMETHYSTS"": -10, ""STARFRUIT"": 13}",6036,5060,9997
934600,-244,39982,"(AMETHYSTS, MARKET << US, 9998, 1, 934600)
(AMETHYSTS, MARKET << US, 9998, 1, 934600)
(STARFRUIT, US << MARKET, 5060, 1, 934600)
(STARFRUIT, US << MARKET, 5060, 1, 934600)
(STARFRUIT, US << MARKET, 5060, 1, 934600)
(STARFRUIT, US << MARKET, 5060, 1, 934600)","{""AMETHYSTS"": -12, ""STARFRUIT"": 17}",6021,5059,9997
934700,5058,45040,"(STARFRUIT, MARKET << US, 5058, 1, 934700)","{""AMETHYSTS"": -12, ""STARFRUIT"": 16}",5952,5057,10000
934800,-5057,39983,"(STARFRUIT, US << MARKET, 5057, 1, 934800)","{""AMETHYSTS"": -12, ""STARFRUIT"": 17}",6003,5060,10000
935100,14947,54930,"(AMETHYSTS, MARKET << US, 10004, 1, 935100)
(AMETHYSTS, MARKET << US, 10004, 1, 935100)
(STARFRUIT, US << MARKET, 5061, 1, 935100)","{""AMETHYSTS"": -14, ""STARFRUIT"": 18}",5974,5058,10000
935200,15055,69985,"(AMETHYSTS, MARKET << US, 9998, 1, 935200)
(STARFRUIT, MARKET << US, 5057, 1, 935200)","{""AMETHYSTS"": -15, ""STARFRUIT"": 17}",5997,5056,9996
935600,50148,120133,"(AMETHYSTS, MARKET << US, 10005, 1, 935600)
(AMETHYSTS, MARKET << US, 10005, 1, 935600)
(AMETHYSTS, MARKET << US, 10005, 1, 935600)
(AMETHYSTS, MARKET << US, 10005, 1, 935600)
(STARFRUIT, MARKET << US, 5064, 1, 935600)
(STARFRUIT, MARKET << US, 5064, 1, 935600)","{""AMETHYSTS"": -19, ""STARFRUIT"": 15}",6029,5061,10001
935800,-80040,40093,"(AMETHYSTS, US << MARKET, 10005, 1, 935800)
(AMETHYSTS, US << MARKET, 10005, 1, 935800)
(AMETHYSTS, US << MARKET, 10005, 1, 935800)
(AMETHYSTS, US << MARKET, 10005, 1, 935800)
(AMETHYSTS, US << MARKET, 10005, 1, 935800)
(AMETHYSTS, US << MARKET, 10005, 1, 935800)
(AMETHYSTS, US << MARKET, 10005, 1, 935800)
(AMETHYSTS, US << MARKET, 10005, 1, 935800)","{""AMETHYSTS"": -11, ""STARFRUIT"": 15}",5952,5058,10001
935900,15051,55144,"(AMETHYSTS, MARKET << US, 9995, 1, 935900)
(STARFRUIT, MARKET << US, 5056, 1, 935900)","{""AMETHYSTS"": -12, ""STARFRUIT"": 14}",5956,5058,10000
936600,5062,60206,"(STARFRUIT, MARKET << US, 5062, 1, 936600)","{""AMETHYSTS"": -12, ""STARFRUIT"": 13}",5973,5059,10000
936700,9998,70204,"(AMETHYSTS, MARKET << US, 9998, 1, 936700)","{""AMETHYSTS"": -13, ""STARFRUIT"": 13}",6010,5059,9997
937000,5062,75266,"(STARFRUIT, MARKET << US, 5062, 1, 937000)","{""AMETHYSTS"": -13, ""STARFRUIT"": 12}",6036,5062,9998
937200,-4550,70716,"(AMETHYSTS, US << MARKET, 9996, 1, 937200)
(AMETHYSTS, US << MARKET, 9996, 1, 937200)
(AMETHYSTS, US << MARKET, 9996, 1, 937200)
(AMETHYSTS, US << MARKET, 9996, 1, 937200)
(STARFRUIT, MARKET << US, 5063, 1, 937200)
(STARFRUIT, MARKET << US, 5063, 1, 937200)
(STARFRUIT, MARKET << US, 5063, 1, 937200)
(STARFRUIT, MARKET << US, 5063, 1, 937200)
(STARFRUIT, MARKET << US, 5063, 1, 937200)
(STARFRUIT, MARKET << US, 5063, 1, 937200)
(STARFRUIT, MARKET << US, 5056, 1, 937200)","{""AMETHYSTS"": -9, ""STARFRUIT"": 5}",6011,5059,10000
937300,15171,85887,"(STARFRUIT, MARKET << US, 5057, 1, 937300)
(STARFRUIT, MARKET << US, 5057, 1, 937300)
(STARFRUIT, MARKET << US, 5057, 1, 937300)","{""AMETHYSTS"": -9, ""STARFRUIT"": 2}",5999,5056,10000
937700,-236,85651,"(AMETHYSTS, MARKET << US, 9996, 1, 937700)
(AMETHYSTS, MARKET << US, 9996, 1, 937700)
(STARFRUIT, US << MARKET, 5057, 1, 937700)
(STARFRUIT, US << MARKET, 5057, 1, 937700)
(STARFRUIT, US << MARKET, 5057, 1, 937700)
(STARFRUIT, US << MARKET, 5057, 1, 937700)","{""AMETHYSTS"": -11, ""STARFRUIT"": 6}",6044,5060,9997
937800,80016,165667,"(AMETHYSTS, MARKET << US, 10002, 1, 937800)
(AMETHYSTS, MARKET << US, 10002, 1, 937800)
(AMETHYSTS, MARKET << US, 10002, 1, 937800)
(AMETHYSTS, MARKET << US, 10002, 1, 937800)
(AMETHYSTS, MARKET << US, 10002, 1, 937800)
(AMETHYSTS, MARKET << US, 10002, 1, 937800)
(AMETHYSTS, MARKET << US, 10002, 1, 937800)
(AMETHYSTS, MARKET << US, 10002, 1, 937800)","{""AMETHYSTS"": -19, ""STARFRUIT"": 6}",5952,5057,10003
937900,9996,175663,"(AMETHYSTS, MARKET << US, 9996, 1, 937900)","{""AMETHYSTS"": -20, ""STARFRUIT"": 6}",6017,5059,10000
938000,-10110,165553,"(STARFRUIT, US << MARKET, 5055, 1, 938000)
(STARFRUIT, US << MARKET, 5055, 1, 938000)","{""AMETHYSTS"": -20, ""STARFRUIT"": 8}",6017,5058,10000
938200,-4942,160611,"(AMETHYSTS, US << MARKET, 10005, 1, 938200)
(STARFRUIT, MARKET << US, 5063, 1, 938200)","{""AMETHYSTS"": -19, ""STARFRUIT"": 7}",6024,5059,10000
939100,25320,185931,"(STARFRUIT, MARKET << US, 5064, 1, 939100)
(STARFRUIT, MARKET << US, 5064, 1, 939100)
(STARFRUIT, MARKET << US, 5064, 1, 939100)
(STARFRUIT, MARKET << US, 5064, 1, 939100)
(STARFRUIT, MARKET << US, 5064, 1, 939100)","{""AMETHYSTS"": -19, ""STARFRUIT"": 2}",6032,5060,10001
939200,-9876,176055,"(AMETHYSTS, US << MARKET, 9996, 1, 939200)
(AMETHYSTS, US << MARKET, 9996, 1, 939200)
(STARFRUIT, MARKET << US, 5058, 1, 939200)
(STARFRUIT, MARKET << US, 5058, 1, 939200)","{""AMETHYSTS"": -17, ""STARFRUIT"": 0}",6072,5061,9999
939600,20004,196059,"(AMETHYSTS, MARKET << US, 10002, 1, 939600)
(AMETHYSTS, MARKET << US, 10002, 1, 939600)","{""AMETHYSTS"": -19, ""STARFRUIT"": 0}",6002,5060,10003
939700,0,196059,"(AMETHYSTS, US << MARKET, 10002, 1, 939700)
(AMETHYSTS, MARKET << US, 10002, 1, 939700)","{""AMETHYSTS"": -19, ""STARFRUIT"": 0}",6002,5060,10003
939800,5061,201120,"(STARFRUIT, MARKET << US, 5061, 1, 939800)","{""AMETHYSTS"": -19, ""STARFRUIT"": -1}",6063,5057,10000
940000,5055,206175,"(STARFRUIT, MARKET << US, 5055, 1, 940000)","{""AMETHYSTS"": -19, ""STARFRUIT"": -2}",6059,5058,10000
940500,-4940,201235,"(AMETHYSTS, US << MARKET, 10002, 1, 940500)
(STARFRUIT, MARKET << US, 5062, 1, 940500)","{""AMETHYSTS"": -18, ""STARFRUIT"": -3}",5995,5062,10003
940800,20004,221239,"(AMETHYSTS, MARKET << US, 10002, 1, 940800)
(AMETHYSTS, MARKET << US, 10002, 1, 940800)","{""AMETHYSTS"": -20, ""STARFRUIT"": -3}",6082,5059,9999
940900,0,221239,"(STARFRUIT, US << MARKET, 5062, 1, 940900)
(STARFRUIT, US << MARKET, 5062, 1, 940900)
(STARFRUIT, MARKET << US, 5062, 1, 940900)
(STARFRUIT, MARKET << US, 5062, 1, 940900)","{""AMETHYSTS"": -20, ""STARFRUIT"": -3}",6082,5059,9999
941100,10112,231351,"(STARFRUIT, MARKET << US, 5056, 1, 941100)
(STARFRUIT, MARKET << US, 5056, 1, 941100)","{""AMETHYSTS"": -20, ""STARFRUIT"": -5}",6116,5059,9997
941200,0,231351,,"{""AMETHYSTS"": -20, ""STARFRUIT"": -5}",6056,5059,10000
941300,5059,236410,"(STARFRUIT, MARKET << US, 5059, 1, 941300)","{""AMETHYSTS"": -20, ""STARFRUIT"": -6}",6102,5058,9998
941700,-35392,201018,"(STARFRUIT, US << MARKET, 5056, 1, 941700)
(STARFRUIT, US << MARKET, 5056, 1, 941700)
(STARFRUIT, US << MARKET, 5056, 1, 941700)
(STARFRUIT, US << MARKET, 5056, 1, 941700)
(STARFRUIT, US << MARKET, 5056, 1, 941700)
(STARFRUIT, US << MARKET, 5056, 1, 941700)
(STARFRUIT, US << MARKET, 5056, 1, 941700)
(STARFRUIT, US << MARKET, 5056, 1, 941700)
(STARFRUIT, MARKET << US, 5056, 1, 941700)","{""AMETHYSTS"": -20, ""STARFRUIT"": 1}",6093,5055,9999
942100,-10120,190898,"(STARFRUIT, US << MARKET, 5060, 1, 942100)
(STARFRUIT, US << MARKET, 5060, 1, 942100)","{""AMETHYSTS"": -20, ""STARFRUIT"": 3}",6129,5057,9997
942600,-35194,155704,"(AMETHYSTS, US << MARKET, 10004, 1, 942600)
(AMETHYSTS, US << MARKET, 10004, 1, 942600)
(STARFRUIT, US << MARKET, 5062, 1, 942600)
(STARFRUIT, US << MARKET, 5062, 1, 942600)
(STARFRUIT, US << MARKET, 5062, 1, 942600)","{""AMETHYSTS"": -18, ""STARFRUIT"": 6}",6034,5058,10001
942700,9998,165702,"(AMETHYSTS, MARKET << US, 9998, 1, 942700)","{""AMETHYSTS"": -19, ""STARFRUIT"": 6}",6031,5058,10001
942800,25275,190977,"(STARFRUIT, MARKET << US, 5055, 1, 942800)
(STARFRUIT, MARKET << US, 5055, 1, 942800)
(STARFRUIT, MARKET << US, 5055, 1, 942800)
(STARFRUIT, MARKET << US, 5055, 1, 942800)
(STARFRUIT, MARKET << US, 5055, 1, 942800)","{""AMETHYSTS"": -19, ""STARFRUIT"": 1}",6034,5057,10000
943400,-20240,170737,"(STARFRUIT, US << MARKET, 5060, 1, 943400)
(STARFRUIT, US << MARKET, 5060, 1, 943400)
(STARFRUIT, US << MARKET, 5060, 1, 943400)
(STARFRUIT, US << MARKET, 5060, 1, 943400)","{""AMETHYSTS"": -19, ""STARFRUIT"": 5}",6042,5061,10000
943500,9998,180735,"(AMETHYSTS, MARKET << US, 9998, 1, 943500)","{""AMETHYSTS"": -20, ""STARFRUIT"": 5}",6025,5058,10000
943800,-10122,170613,"(STARFRUIT, US << MARKET, 5061, 1, 943800)
(STARFRUIT, US << MARKET, 5061, 1, 943800)","{""AMETHYSTS"": -20, ""STARFRUIT"": 7}",6080,5061,9998
943900,5056,175669,"(STARFRUIT, MARKET << US, 5056, 1, 943900)","{""AMETHYSTS"": -20, ""STARFRUIT"": 6}",6023,5059,10000
944000,-10112,165557,"(STARFRUIT, US << MARKET, 5056, 1, 944000)
(STARFRUIT, US << MARKET, 5056, 1, 944000)","{""AMETHYSTS"": -20, ""STARFRUIT"": 8}",6029,5059,10000
944700,30336,195893,"(STARFRUIT, MARKET << US, 5056, 1, 944700)
(STARFRUIT, MARKET << US, 5056, 1, 944700)
(STARFRUIT, MARKET << US, 5056, 1, 944700)
(STARFRUIT, MARKET << US, 5056, 1, 944700)
(STARFRUIT, MARKET << US, 5056, 1, 944700)
(STARFRUIT, MARKET << US, 5056, 1, 944700)","{""AMETHYSTS"": -20, ""STARFRUIT"": 2}",6009,5058,10000
945000,-9886,186007,"(AMETHYSTS, US << MARKET, 10005, 1, 945000)
(AMETHYSTS, US << MARKET, 10005, 1, 945000)
(STARFRUIT, MARKET << US, 5062, 1, 945000)
(STARFRUIT, MARKET << US, 5062, 1, 945000)","{""AMETHYSTS"": -18, ""STARFRUIT"": 0}",6007,5058,10000
945100,-10002,176005,"(AMETHYSTS, US << MARKET, 10002, 1, 945100)","{""AMETHYSTS"": -17, ""STARFRUIT"": 0}",5954,5058,10003
945400,20004,196009,"(AMETHYSTS, MARKET << US, 10002, 1, 945400)
(AMETHYSTS, MARKET << US, 10002, 1, 945400)","{""AMETHYSTS"": -19, ""STARFRUIT"": 0}",5952,5059,10003
945900,-84928,111081,"(AMETHYSTS, US << MARKET, 9998, 1, 945900)
(AMETHYSTS, US << MARKET, 9998, 1, 945900)
(AMETHYSTS, US << MARKET, 9998, 1, 945900)
(AMETHYSTS, US << MARKET, 9998, 1, 945900)
(AMETHYSTS, US << MARKET, 9998, 1, 945900)
(AMETHYSTS, US << MARKET, 9998, 1, 945900)
(AMETHYSTS, US << MARKET, 9998, 1, 945900)
(AMETHYSTS, US << MARKET, 9998, 1, 945900)
(AMETHYSTS, US << MARKET, 9998, 1, 945900)
(AMETHYSTS, US << MARKET, 9998, 1, 945900)
(AMETHYSTS, MARKET << US, 9996, 1, 945900)
(STARFRUIT, MARKET << US, 5056, 1, 945900)","{""AMETHYSTS"": -10, ""STARFRUIT"": -1}",6052,5059,9997
946200,5057,116138,"(STARFRUIT, MARKET << US, 5057, 1, 946200)","{""AMETHYSTS"": -10, ""STARFRUIT"": -2}",6026,5056,10000
946300,10114,126252,"(STARFRUIT, MARKET << US, 5057, 1, 946300)
(STARFRUIT, MARKET << US, 5057, 1, 946300)","{""AMETHYSTS"": -10, ""STARFRUIT"": -4}",6012,5060,10000
946900,10126,136378,"(STARFRUIT, MARKET << US, 5063, 1, 946900)
(STARFRUIT, MARKET << US, 5063, 1, 946900)","{""AMETHYSTS"": -10, ""STARFRUIT"": -6}",6024,5059,10000
947100,40242,176620,"(AMETHYSTS, MARKET << US, 10005, 1, 947100)
(AMETHYSTS, MARKET << US, 10005, 1, 947100)
(STARFRUIT, MARKET << US, 5058, 1, 947100)
(STARFRUIT, MARKET << US, 5058, 1, 947100)
(STARFRUIT, MARKET << US, 5058, 1, 947100)
(STARFRUIT, MARKET << US, 5058, 1, 947100)","{""AMETHYSTS"": -12, ""STARFRUIT"": -10}",6050,5057,10000
947400,5057,181677,"(STARFRUIT, MARKET << US, 5057, 1, 947400)","{""AMETHYSTS"": -12, ""STARFRUIT"": -11}",6017,5060,10000
947600,25072,206749,"(AMETHYSTS, MARKET << US, 10004, 1, 947600)
(AMETHYSTS, MARKET << US, 10004, 1, 947600)
(STARFRUIT, MARKET << US, 5064, 1, 947600)","{""AMETHYSTS"": -14, ""STARFRUIT"": -12}",6029,5060,10000
947900,29994,236743,"(AMETHYSTS, MARKET << US, 9998, 1, 947900)
(AMETHYSTS, MARKET << US, 9998, 1, 947900)
(AMETHYSTS, MARKET << US, 9998, 1, 947900)","{""AMETHYSTS"": -17, ""STARFRUIT"": -12}",6006,5060,10001
948200,30012,266755,"(AMETHYSTS, MARKET << US, 10004, 1, 948200)
(AMETHYSTS, MARKET << US, 10004, 1, 948200)
(AMETHYSTS, MARKET << US, 10004, 1, 948200)","{""AMETHYSTS"": -20, ""STARFRUIT"": -12}",6035,5060,10000
948400,0,266755,,"{""AMETHYSTS"": -20, ""STARFRUIT"": -12}",6107,5059,9997
948500,-50560,216195,"(STARFRUIT, US << MARKET, 5056, 1, 948500)
(STARFRUIT, US << MARKET, 5056, 1, 948500)
(STARFRUIT, US << MARKET, 5056, 1, 948500)
(STARFRUIT, US << MARKET, 5056, 1, 948500)
(STARFRUIT, US << MARKET, 5056, 1, 948500)
(STARFRUIT, US << MARKET, 5056, 1, 948500)
(STARFRUIT, US << MARKET, 5056, 1, 948500)
(STARFRUIT, US << MARKET, 5056, 1, 948500)
(STARFRUIT, US << MARKET, 5056, 1, 948500)
(STARFRUIT, US << MARKET, 5056, 1, 948500)","{""AMETHYSTS"": -20, ""STARFRUIT"": -2}",6059,5058,10001
948900,10114,226309,"(STARFRUIT, MARKET << US, 5057, 1, 948900)
(STARFRUIT, MARKET << US, 5057, 1, 948900)","{""AMETHYSTS"": -20, ""STARFRUIT"": -4}",6085,5056,10000
949300,-20256,206053,"(STARFRUIT, US << MARKET, 5064, 1, 949300)
(STARFRUIT, US << MARKET, 5064, 1, 949300)
(STARFRUIT, US << MARKET, 5064, 1, 949300)
(STARFRUIT, US << MARKET, 5064, 1, 949300)","{""AMETHYSTS"": -20, ""STARFRUIT"": 0}",6053,5063,10000
949800,-25072,180981,"(AMETHYSTS, US << MARKET, 10004, 1, 949800)
(AMETHYSTS, US << MARKET, 10004, 1, 949800)
(STARFRUIT, US << MARKET, 5064, 1, 949800)
(STARFRUIT, US << MARKET, 5064, 1, 949800)
(STARFRUIT, MARKET << US, 5064, 1, 949800)","{""AMETHYSTS"": -18, ""STARFRUIT"": 1}",6024,5061,10001
950100,-248,180733,"(AMETHYSTS, MARKET << US, 10004, 1, 950100)
(AMETHYSTS, MARKET << US, 10004, 1, 950100)
(STARFRUIT, US << MARKET, 5064, 1, 950100)
(STARFRUIT, US << MARKET, 5064, 1, 950100)
(STARFRUIT, US << MARKET, 5064, 1, 950100)
(STARFRUIT, US << MARKET, 5064, 1, 950100)","{""AMETHYSTS"": -20, ""STARFRUIT"": 5}",6038,5061,10000
950500,-20128,160605,"(AMETHYSTS, US << MARKET, 10004, 1, 950500)
(STARFRUIT, US << MARKET, 5062, 1, 950500)
(STARFRUIT, US << MARKET, 5062, 1, 950500)","{""AMETHYSTS"": -19, ""STARFRUIT"": 7}",6039,5062,10000
950700,4936,165541,"(AMETHYSTS, MARKET << US, 9998, 1, 950700)
(STARFRUIT, US << MARKET, 5062, 1, 950700)","{""AMETHYSTS"": -20, ""STARFRUIT"": 8}",6013,5059,10000
951200,-110092,55449,"(AMETHYSTS, US << MARKET, 9998, 1, 951200)
(AMETHYSTS, US << MARKET, 9998, 1, 951200)
(AMETHYSTS, US << MARKET, 9998, 1, 951200)
(AMETHYSTS, US << MARKET, 9998, 1, 951200)
(AMETHYSTS, US << MARKET, 9998, 1, 951200)
(AMETHYSTS, US << MARKET, 9998, 1, 951200)
(AMETHYSTS, US << MARKET, 9998, 1, 951200)
(AMETHYSTS, US << MARKET, 9998, 1, 951200)
(AMETHYSTS, US << MARKET, 9998, 1, 951200)
(AMETHYSTS, US << MARKET, 9998, 1, 951200)
(STARFRUIT, US << MARKET, 5056, 1, 951200)
(STARFRUIT, US << MARKET, 5056, 1, 951200)","{""AMETHYSTS"": -10, ""STARFRUIT"": 10}",6069,5059,9997
951700,-10002,45447,"(AMETHYSTS, US << MARKET, 10002, 1, 951700)","{""AMETHYSTS"": -9, ""STARFRUIT"": 10}",6025,5056,9998
951800,25070,70517,"(AMETHYSTS, MARKET << US, 10005, 1, 951800)
(AMETHYSTS, MARKET << US, 10005, 1, 951800)
(STARFRUIT, MARKET << US, 5060, 1, 951800)","{""AMETHYSTS"": -11, ""STARFRUIT"": 9}",6021,5056,10000
951900,0,70517,"(STARFRUIT, US << MARKET, 5055, 1, 951900)
(STARFRUIT, MARKET << US, 5055, 1, 951900)","{""AMETHYSTS"": -11, ""STARFRUIT"": 9}",6003,5054,10000
952000,-5059,65458,"(STARFRUIT, US << MARKET, 5059, 1, 952000)","{""AMETHYSTS"": -11, ""STARFRUIT"": 10}",6037,5059,10001
952600,5058,70516,"(STARFRUIT, MARKET << US, 5058, 1, 952600)","{""AMETHYSTS"": -11, ""STARFRUIT"": 9}",6024,5054,9998
952800,-5054,65462,"(STARFRUIT, US << MARKET, 5054, 1, 952800)","{""AMETHYSTS"": -11, ""STARFRUIT"": 10}",5992,5053,10000
953000,-10002,55460,"(AMETHYSTS, US << MARKET, 10002, 1, 953000)","{""AMETHYSTS"": -10, ""STARFRUIT"": 10}",5980,5055,10003
953100,5058,60518,"(STARFRUIT, MARKET << US, 5058, 1, 953100)","{""AMETHYSTS"": -10, ""STARFRUIT"": 9}",6013,5055,10000
953300,5053,65571,"(STARFRUIT, MARKET << US, 5053, 1, 953300)","{""AMETHYSTS"": -10, ""STARFRUIT"": 8}",5987,5052,10000
953400,-20008,45563,"(AMETHYSTS, US << MARKET, 10004, 1, 953400)
(AMETHYSTS, US << MARKET, 10004, 1, 953400)","{""AMETHYSTS"": -8, ""STARFRUIT"": 8}",6011,5056,10000
953500,30230,75793,"(AMETHYSTS, MARKET << US, 9998, 1, 953500)
(STARFRUIT, MARKET << US, 5058, 1, 953500)
(STARFRUIT, MARKET << US, 5058, 1, 953500)
(STARFRUIT, MARKET << US, 5058, 1, 953500)
(STARFRUIT, MARKET << US, 5058, 1, 953500)","{""AMETHYSTS"": -9, ""STARFRUIT"": 4}",6056,5059,9997
953600,-19996,55797,"(AMETHYSTS, US << MARKET, 9998, 1, 953600)
(AMETHYSTS, US << MARKET, 9998, 1, 953600)","{""AMETHYSTS"": -7, ""STARFRUIT"": 4}",6014,5056,10001
953800,-15162,40635,"(STARFRUIT, US << MARKET, 5054, 1, 953800)
(STARFRUIT, US << MARKET, 5054, 1, 953800)
(STARFRUIT, US << MARKET, 5054, 1, 953800)","{""AMETHYSTS"": -7, ""STARFRUIT"": 7}",6034,5057,10000
953900,-29876,10759,"(AMETHYSTS, US << MARKET, 9995, 1, 953900)
(AMETHYSTS, US << MARKET, 9995, 1, 953900)
(AMETHYSTS, US << MARKET, 9995, 1, 953900)
(AMETHYSTS, US << MARKET, 9995, 1, 953900)
(STARFRUIT, MARKET << US, 5052, 1, 953900)
(STARFRUIT, MARKET << US, 5052, 1, 953900)","{""AMETHYSTS"": -3, ""STARFRUIT"": 5}",6040,5055,9998
954300,25063,35822,"(AMETHYSTS, MARKET << US, 10002, 1, 954300)
(AMETHYSTS, MARKET << US, 10002, 1, 954300)
(STARFRUIT, MARKET << US, 5059, 1, 954300)","{""AMETHYSTS"": -5, ""STARFRUIT"": 4}",6043,5059,10003
955200,-20228,15594,"(STARFRUIT, US << MARKET, 5057, 1, 955200)
(STARFRUIT, US << MARKET, 5057, 1, 955200)
(STARFRUIT, US << MARKET, 5057, 1, 955200)
(STARFRUIT, US << MARKET, 5057, 1, 955200)","{""AMETHYSTS"": -5, ""STARFRUIT"": 8}",6068,5058,9998
955600,10114,25708,"(STARFRUIT, MARKET << US, 5057, 1, 955600)
(STARFRUIT, MARKET << US, 5057, 1, 955600)","{""AMETHYSTS"": -5, ""STARFRUIT"": 6}",6043,5055,9999
955800,-10120,15588,"(STARFRUIT, US << MARKET, 5060, 1, 955800)
(STARFRUIT, US << MARKET, 5060, 1, 955800)","{""AMETHYSTS"": -5, ""STARFRUIT"": 8}",6068,5060,10000
956100,10116,25704,"(STARFRUIT, MARKET << US, 5058, 1, 956100)
(STARFRUIT, MARKET << US, 5058, 1, 956100)","{""AMETHYSTS"": -5, ""STARFRUIT"": 6}",6058,5059,10000
956500,25063,50767,"(AMETHYSTS, MARKET << US, 10002, 1, 956500)
(AMETHYSTS, MARKET << US, 10002, 1, 956500)
(STARFRUIT, MARKET << US, 5059, 1, 956500)","{""AMETHYSTS"": -7, ""STARFRUIT"": 5}",6056,5055,9998
956700,19996,70763,"(AMETHYSTS, MARKET << US, 9998, 1, 956700)
(AMETHYSTS, MARKET << US, 9998, 1, 956700)","{""AMETHYSTS"": -9, ""STARFRUIT"": 5}",6065,5055,9997
957600,-118,70645,"(AMETHYSTS, MARKET << US, 9998, 1, 957600)
(STARFRUIT, US << MARKET, 5058, 1, 957600)
(STARFRUIT, US << MARKET, 5058, 1, 957600)","{""AMETHYSTS"": -10, ""STARFRUIT"": 7}",6091,5058,9996
957800,40008,110653,"(AMETHYSTS, MARKET << US, 10002, 1, 957800)
(AMETHYSTS, MARKET << US, 10002, 1, 957800)
(AMETHYSTS, MARKET << US, 10002, 1, 957800)
(AMETHYSTS, MARKET << US, 10002, 1, 957800)","{""AMETHYSTS"": -14, ""STARFRUIT"": 7}",6045,5054,9999
958000,4946,115599,"(AMETHYSTS, MARKET << US, 9998, 1, 958000)
(STARFRUIT, US << MARKET, 5052, 1, 958000)","{""AMETHYSTS"": -15, ""STARFRUIT"": 8}",6024,5055,10001
958100,30354,145953,"(STARFRUIT, MARKET << US, 5059, 1, 958100)
(STARFRUIT, MARKET << US, 5059, 1, 958100)
(STARFRUIT, MARKET << US, 5059, 1, 958100)
(STARFRUIT, MARKET << US, 5059, 1, 958100)
(STARFRUIT, MARKET << US, 5059, 1, 958100)
(STARFRUIT, MARKET << US, 5059, 1, 958100)","{""AMETHYSTS"": -15, ""STARFRUIT"": 2}",6052,5057,10001
958400,-118,145835,"(AMETHYSTS, MARKET << US, 9998, 1, 958400)
(STARFRUIT, US << MARKET, 5058, 1, 958400)
(STARFRUIT, US << MARKET, 5058, 1, 958400)","{""AMETHYSTS"": -16, ""STARFRUIT"": 4}",6103,5055,9997
958500,15049,160884,"(AMETHYSTS, MARKET << US, 9996, 1, 958500)
(STARFRUIT, MARKET << US, 5053, 1, 958500)","{""AMETHYSTS"": -17, ""STARFRUIT"": 3}",6052,5056,10000
958700,-20124,140760,"(AMETHYSTS, US << MARKET, 10004, 1, 958700)
(STARFRUIT, US << MARKET, 5060, 1, 958700)
(STARFRUIT, US << MARKET, 5060, 1, 958700)","{""AMETHYSTS"": -16, ""STARFRUIT"": 5}",6024,5056,10001
959300,9902,150662,"(AMETHYSTS, MARKET << US, 10004, 1, 959300)
(AMETHYSTS, MARKET << US, 10004, 1, 959300)
(STARFRUIT, US << MARKET, 5053, 1, 959300)
(STARFRUIT, US << MARKET, 5053, 1, 959300)","{""AMETHYSTS"": -18, ""STARFRUIT"": 7}",6029,5055,10001
960100,-5059,145603,"(STARFRUIT, US << MARKET, 5059, 1, 960100)","{""AMETHYSTS"": -18, ""STARFRUIT"": 8}",6075,5059,10000
960200,-20232,125371,"(STARFRUIT, US << MARKET, 5058, 1, 960200)
(STARFRUIT, US << MARKET, 5058, 1, 960200)
(STARFRUIT, US << MARKET, 5058, 1, 960200)
(STARFRUIT, US << MARKET, 5058, 1, 960200)","{""AMETHYSTS"": -18, ""STARFRUIT"": 12}",6085,5055,9997
960400,-10002,115369,"(AMETHYSTS, US << MARKET, 10002, 1, 960400)","{""AMETHYSTS"": -17, ""STARFRUIT"": 12}",6014,5058,10003
960600,45192,160561,"(AMETHYSTS, MARKET << US, 10005, 1, 960600)
(AMETHYSTS, MARKET << US, 10005, 1, 960600)
(AMETHYSTS, MARKET << US, 10005, 1, 960600)
(STARFRUIT, MARKET << US, 5059, 1, 960600)
(STARFRUIT, MARKET << US, 5059, 1, 960600)
(STARFRUIT, MARKET << US, 5059, 1, 960600)","{""AMETHYSTS"": -20, ""STARFRUIT"": 9}",6065,5056,10000
961000,-20220,140341,"(STARFRUIT, US << MARKET, 5055, 1, 961000)
(STARFRUIT, US << MARKET, 5055, 1, 961000)
(STARFRUIT, US << MARKET, 5055, 1, 961000)
(STARFRUIT, US << MARKET, 5055, 1, 961000)","{""AMETHYSTS"": -20, ""STARFRUIT"": 13}",6095,5058,10000
961100,-130058,10283,"(AMETHYSTS, US << MARKET, 9995, 1, 961100)
(AMETHYSTS, US << MARKET, 9995, 1, 961100)
(AMETHYSTS, US << MARKET, 9995, 1, 961100)
(AMETHYSTS, US << MARKET, 9995, 1, 961100)
(AMETHYSTS, US << MARKET, 9995, 1, 961100)
(AMETHYSTS, US << MARKET, 9995, 1, 961100)
(AMETHYSTS, US << MARKET, 9995, 1, 961100)
(AMETHYSTS, US << MARKET, 9995, 1, 961100)
(AMETHYSTS, US << MARKET, 9995, 1, 961100)
(AMETHYSTS, US << MARKET, 9995, 1, 961100)
(AMETHYSTS, US << MARKET, 9995, 1, 961100)
(AMETHYSTS, US << MARKET, 9995, 1, 961100)
(STARFRUIT, US << MARKET, 5059, 1, 961100)
(STARFRUIT, US << MARKET, 5059, 1, 961100)","{""AMETHYSTS"": -8, ""STARFRUIT"": 15}",6155,5056,9996
961400,110049,120332,"(AMETHYSTS, MARKET << US, 10005, 1, 961400)
(AMETHYSTS, MARKET << US, 10005, 1, 961400)
(AMETHYSTS, MARKET << US, 10005, 1, 961400)
(AMETHYSTS, MARKET << US, 10005, 1, 961400)
(AMETHYSTS, MARKET << US, 10005, 1, 961400)
(AMETHYSTS, MARKET << US, 10005, 1, 961400)
(AMETHYSTS, MARKET << US, 10002, 1, 961400)
(AMETHYSTS, MARKET << US, 10005, 1, 961400)
(AMETHYSTS, MARKET << US, 10005, 1, 961400)
(AMETHYSTS, MARKET << US, 10005, 1, 961400)
(AMETHYSTS, MARKET << US, 10002, 1, 961400)","{""AMETHYSTS"": -19, ""STARFRUIT"": 15}",6100,5055,10003
961500,4943,125275,"(AMETHYSTS, MARKET << US, 10002, 1, 961500)
(STARFRUIT, US << MARKET, 5059, 1, 961500)","{""AMETHYSTS"": -20, ""STARFRUIT"": 16}",6159,5059,10003
961600,-5059,120216,"(STARFRUIT, US << MARKET, 5059, 1, 961600)","{""AMETHYSTS"": -20, ""STARFRUIT"": 17}",6279,5059,9997
961700,0,120216,,"{""AMETHYSTS"": -20, ""STARFRUIT"": 17}",6231,5055,9996
962300,-15177,105039,"(STARFRUIT, US << MARKET, 5059, 1, 962300)
(STARFRUIT, US << MARKET, 5059, 1, 962300)
(STARFRUIT, US << MARKET, 5059, 1, 962300)","{""AMETHYSTS"": -20, ""STARFRUIT"": 20}",6139,5056,10001
962600,-10005,95034,"(AMETHYSTS, US << MARKET, 10005, 1, 962600)","{""AMETHYSTS"": -19, ""STARFRUIT"": 20}",6154,5056,10000
962800,-19992,75042,"(AMETHYSTS, US << MARKET, 9996, 1, 962800)
(AMETHYSTS, US << MARKET, 9996, 1, 962800)","{""AMETHYSTS"": -17, ""STARFRUIT"": 20}",6142,5055,10000
962900,-49886,25156,"(AMETHYSTS, US << MARKET, 9998, 1, 962900)
(AMETHYSTS, US << MARKET, 9998, 1, 962900)
(AMETHYSTS, US << MARKET, 9998, 1, 962900)
(AMETHYSTS, US << MARKET, 9998, 1, 962900)
(AMETHYSTS, US << MARKET, 9998, 1, 962900)
(AMETHYSTS, US << MARKET, 9998, 1, 962900)
(AMETHYSTS, US << MARKET, 9998, 1, 962900)
(AMETHYSTS, US << MARKET, 9998, 1, 962900)
(AMETHYSTS, MARKET << US, 9998, 1, 962900)
(AMETHYSTS, MARKET << US, 9996, 1, 962900)
(STARFRUIT, MARKET << US, 5052, 1, 962900)
(STARFRUIT, MARKET << US, 5052, 1, 962900)","{""AMETHYSTS"": -11, ""STARFRUIT"": 18}",6179,5055,9997
963300,10112,35268,"(STARFRUIT, MARKET << US, 5056, 1, 963300)
(STARFRUIT, MARKET << US, 5056, 1, 963300)","{""AMETHYSTS"": -11, ""STARFRUIT"": 16}",6165,5054,9997
963400,19996,55264,"(AMETHYSTS, MARKET << US, 9998, 1, 963400)
(AMETHYSTS, MARKET << US, 9998, 1, 963400)","{""AMETHYSTS"": -13, ""STARFRUIT"": 16}",6163,5057,10001
964500,-5060,50204,"(STARFRUIT, US << MARKET, 5060, 1, 964500)","{""AMETHYSTS"": -13, ""STARFRUIT"": 17}",6156,5056,10000
964800,-30006,20198,"(AMETHYSTS, US << MARKET, 10002, 1, 964800)
(AMETHYSTS, US << MARKET, 10002, 1, 964800)
(AMETHYSTS, US << MARKET, 10002, 1, 964800)","{""AMETHYSTS"": -10, ""STARFRUIT"": 17}",6170,5056,9998
965800,39992,60190,"(AMETHYSTS, MARKET << US, 9998, 1, 965800)
(AMETHYSTS, MARKET << US, 9998, 1, 965800)
(AMETHYSTS, MARKET << US, 9998, 1, 965800)
(AMETHYSTS, MARKET << US, 9998, 1, 965800)","{""AMETHYSTS"": -14, ""STARFRUIT"": 17}",6145,5057,10001
966100,20004,80194,"(AMETHYSTS, MARKET << US, 10002, 1, 966100)
(AMETHYSTS, MARKET << US, 10002, 1, 966100)","{""AMETHYSTS"": -16, ""STARFRUIT"": 17}",6149,5059,10003
966300,20004,100198,"(AMETHYSTS, MARKET << US, 10002, 1, 966300)
(AMETHYSTS, MARKET << US, 10002, 1, 966300)","{""AMETHYSTS"": -18, ""STARFRUIT"": 17}",6113,5057,10003
966900,9998,110196,"(AMETHYSTS, MARKET << US, 9998, 1, 966900)","{""AMETHYSTS"": -19, ""STARFRUIT"": 17}",6222,5057,9997
967000,-5059,105137,"(STARFRUIT, US << MARKET, 5059, 1, 967000)","{""AMETHYSTS"": -19, ""STARFRUIT"": 18}",6255,5060,9998
967500,-5061,100076,"(STARFRUIT, US << MARKET, 5061, 1, 967500)","{""AMETHYSTS"": -19, ""STARFRUIT"": 19}",6235,5061,10000
967700,-10004,90072,"(AMETHYSTS, US << MARKET, 10004, 1, 967700)","{""AMETHYSTS"": -18, ""STARFRUIT"": 19}",6155,5057,10000
967900,-5056,85016,"(STARFRUIT, US << MARKET, 5056, 1, 967900)","{""AMETHYSTS"": -18, ""STARFRUIT"": 20}",6116,5055,10000
968100,10120,95136,"(STARFRUIT, MARKET << US, 5060, 1, 968100)
(STARFRUIT, MARKET << US, 5060, 1, 968100)","{""AMETHYSTS"": -18, ""STARFRUIT"": 18}",6234,5061,10000
968400,-5061,90075,"(STARFRUIT, US << MARKET, 5061, 1, 968400)","{""AMETHYSTS"": -18, ""STARFRUIT"": 19}",6234,5061,10000
968500,14946,105021,"(AMETHYSTS, MARKET << US, 10004, 1, 968500)
(AMETHYSTS, MARKET << US, 10004, 1, 968500)
(STARFRUIT, US << MARKET, 5062, 1, 968500)","{""AMETHYSTS"": -20, ""STARFRUIT"": 20}",6181,5059,10001
968600,0,105021,,"{""AMETHYSTS"": -20, ""STARFRUIT"": 20}",6181,5059,10001
968900,0,105021,,"{""AMETHYSTS"": -20, ""STARFRUIT"": 20}",6261,5058,9996
969000,-19992,85029,"(AMETHYSTS, US << MARKET, 9996, 1, 969000)
(AMETHYSTS, US << MARKET, 9996, 1, 969000)","{""AMETHYSTS"": -18, ""STARFRUIT"": 20}",6189,5058,10000
969300,-10004,75025,"(AMETHYSTS, US << MARKET, 10004, 1, 969300)","{""AMETHYSTS"": -17, ""STARFRUIT"": 20}",6185,5058,10000
969500,-59988,15037,"(AMETHYSTS, US << MARKET, 9998, 1, 969500)
(AMETHYSTS, US << MARKET, 9998, 1, 969500)
(AMETHYSTS, US << MARKET, 9998, 1, 969500)
(AMETHYSTS, US << MARKET, 9998, 1, 969500)
(AMETHYSTS, US << MARKET, 9998, 1, 969500)
(AMETHYSTS, US << MARKET, 9998, 1, 969500)","{""AMETHYSTS"": -11, ""STARFRUIT"": 20}",6230,5058,9997
969700,95096,110133,"(AMETHYSTS, MARKET << US, 10004, 1, 969700)
(AMETHYSTS, MARKET << US, 10004, 1, 969700)
(AMETHYSTS, MARKET << US, 10004, 1, 969700)
(AMETHYSTS, MARKET << US, 10004, 1, 969700)
(AMETHYSTS, MARKET << US, 10004, 1, 969700)
(AMETHYSTS, MARKET << US, 10004, 1, 969700)
(AMETHYSTS, MARKET << US, 10004, 1, 969700)
(AMETHYSTS, MARKET << US, 10004, 1, 969700)
(AMETHYSTS, MARKET << US, 10004, 1, 969700)
(STARFRUIT, MARKET << US, 5060, 1, 969700)","{""AMETHYSTS"": -20, ""STARFRUIT"": 19}",6273,5060,10000
970300,-5056,105077,"(STARFRUIT, US << MARKET, 5056, 1, 970300)","{""AMETHYSTS"": -20, ""STARFRUIT"": 20}",6177,5055,10000
970400,5056,110133,"(STARFRUIT, MARKET << US, 5056, 1, 970400)","{""AMETHYSTS"": -20, ""STARFRUIT"": 19}",6254,5059,10000
971100,-20008,90125,"(AMETHYSTS, US << MARKET, 10004, 1, 971100)
(AMETHYSTS, US << MARKET, 10004, 1, 971100)","{""AMETHYSTS"": -18, ""STARFRUIT"": 19}",6229,5060,10002
971500,-5061,85064,"(STARFRUIT, US << MARKET, 5061, 1, 971500)","{""AMETHYSTS"": -18, ""STARFRUIT"": 20}",6304,5062,10000
971600,20010,105074,"(AMETHYSTS, MARKET << US, 10005, 1, 971600)
(AMETHYSTS, MARKET << US, 10005, 1, 971600)","{""AMETHYSTS"": -20, ""STARFRUIT"": 20}",6194,5059,10003
972200,0,105074,,"{""AMETHYSTS"": -20, ""STARFRUIT"": 20}",6294,5061,10000
972300,10126,115200,"(STARFRUIT, MARKET << US, 5063, 1, 972300)
(STARFRUIT, MARKET << US, 5063, 1, 972300)","{""AMETHYSTS"": -20, ""STARFRUIT"": 18}",6220,5060,10003
972900,0,115200,,"{""AMETHYSTS"": -20, ""STARFRUIT"": 18}",6278,5061,10001
973100,15171,130371,"(STARFRUIT, US << MARKET, 5057, 1, 973100)
(STARFRUIT, US << MARKET, 5057, 1, 973100)
(STARFRUIT, MARKET << US, 5057, 1, 973100)
(STARFRUIT, MARKET << US, 5057, 1, 973100)
(STARFRUIT, MARKET << US, 5057, 1, 973100)
(STARFRUIT, MARKET << US, 5057, 1, 973100)
(STARFRUIT, MARKET << US, 5057, 1, 973100)","{""AMETHYSTS"": -20, ""STARFRUIT"": 15}",6211,5056,10000
973900,-5055,125316,"(STARFRUIT, US << MARKET, 5055, 1, 973900)","{""AMETHYSTS"": -20, ""STARFRUIT"": 16}",6288,5057,9997
974000,-50090,75226,"(AMETHYSTS, US << MARKET, 9995, 1, 974000)
(AMETHYSTS, US << MARKET, 9995, 1, 974000)
(AMETHYSTS, US << MARKET, 9995, 1, 974000)
(AMETHYSTS, US << MARKET, 9995, 1, 974000)
(STARFRUIT, US << MARKET, 5055, 1, 974000)
(STARFRUIT, US << MARKET, 5055, 1, 974000)","{""AMETHYSTS"": -16, ""STARFRUIT"": 18}",6270,5058,10000
974400,-5054,70172,"(STARFRUIT, US << MARKET, 5054, 1, 974400)","{""AMETHYSTS"": -16, ""STARFRUIT"": 19}",6255,5057,10000
974500,5059,75231,"(STARFRUIT, MARKET << US, 5059, 1, 974500)","{""AMETHYSTS"": -16, ""STARFRUIT"": 18}",6295,5060,10001
974700,-85043,-9812,"(AMETHYSTS, US << MARKET, 9998, 1, 974700)
(AMETHYSTS, US << MARKET, 9998, 1, 974700)
(AMETHYSTS, US << MARKET, 9998, 1, 974700)
(AMETHYSTS, US << MARKET, 9998, 1, 974700)
(AMETHYSTS, US << MARKET, 9998, 1, 974700)
(AMETHYSTS, US << MARKET, 9998, 1, 974700)
(AMETHYSTS, US << MARKET, 9998, 1, 974700)
(AMETHYSTS, US << MARKET, 9998, 1, 974700)
(STARFRUIT, US << MARKET, 5059, 1, 974700)","{""AMETHYSTS"": -8, ""STARFRUIT"": 19}",6333,5059,9997
974800,-30006,-39818,"(AMETHYSTS, US << MARKET, 10002, 1, 974800)
(AMETHYSTS, US << MARKET, 10002, 1, 974800)
(AMETHYSTS, US << MARKET, 10002, 1, 974800)","{""AMETHYSTS"": -5, ""STARFRUIT"": 19}",6250,5057,10003
975000,-5054,-44872,"(STARFRUIT, US << MARKET, 5054, 1, 975000)","{""AMETHYSTS"": -5, ""STARFRUIT"": 20}",6248,5056,10000
975100,-40008,-84880,"(AMETHYSTS, US << MARKET, 10002, 1, 975100)
(AMETHYSTS, US << MARKET, 10002, 1, 975100)
(AMETHYSTS, US << MARKET, 10002, 1, 975100)
(AMETHYSTS, US << MARKET, 10002, 1, 975100)","{""AMETHYSTS"": -1, ""STARFRUIT"": 20}",6257,5057,10003
975300,-84952,-169832,"(AMETHYSTS, US << MARKET, 9996, 1, 975300)
(AMETHYSTS, US << MARKET, 9996, 1, 975300)
(AMETHYSTS, US << MARKET, 10002, 1, 975300)
(AMETHYSTS, US << MARKET, 10002, 1, 975300)
(AMETHYSTS, US << MARKET, 10002, 1, 975300)
(AMETHYSTS, US << MARKET, 10002, 1, 975300)
(AMETHYSTS, US << MARKET, 10002, 1, 975300)
(AMETHYSTS, US << MARKET, 10002, 1, 975300)
(AMETHYSTS, US << MARKET, 10002, 1, 975300)
(STARFRUIT, MARKET << US, 5054, 1, 975300)","{""AMETHYSTS"": 8, ""STARFRUIT"": 19}",6243,5057,9999
975400,5059,-164773,"(STARFRUIT, MARKET << US, 5059, 1, 975400)","{""AMETHYSTS"": 8, ""STARFRUIT"": 18}",6281,5059,9999
975900,5055,-159718,"(STARFRUIT, MARKET << US, 5055, 1, 975900)","{""AMETHYSTS"": 8, ""STARFRUIT"": 17}",6252,5058,9998
976200,-15165,-174883,"(STARFRUIT, US << MARKET, 5055, 1, 976200)
(STARFRUIT, US << MARKET, 5055, 1, 976200)
(STARFRUIT, US << MARKET, 5055, 1, 976200)","{""AMETHYSTS"": 8, ""STARFRUIT"": 20}",6301,5058,10003
976500,-10002,-184885,"(AMETHYSTS, US << MARKET, 10002, 1, 976500)","{""AMETHYSTS"": 9, ""STARFRUIT"": 20}",6302,5058,10003
976700,5059,-179826,"(STARFRUIT, MARKET << US, 5059, 1, 976700)","{""AMETHYSTS"": 9, ""STARFRUIT"": 19}",6286,5059,9999
976900,-5056,-184882,"(STARFRUIT, US << MARKET, 5056, 1, 976900)","{""AMETHYSTS"": 9, ""STARFRUIT"": 20}",6180,5054,9998
977100,-34933,-219815,"(AMETHYSTS, US << MARKET, 9998, 1, 977100)
(AMETHYSTS, US << MARKET, 9998, 1, 977100)
(AMETHYSTS, US << MARKET, 9998, 1, 977100)
(AMETHYSTS, US << MARKET, 9998, 1, 977100)
(STARFRUIT, MARKET << US, 5059, 1, 977100)","{""AMETHYSTS"": 13, ""STARFRUIT"": 19}",6243,5055,10001
977500,5053,-214762,"(STARFRUIT, MARKET << US, 5053, 1, 977500)","{""AMETHYSTS"": 13, ""STARFRUIT"": 18}",6246,5056,10000
977900,-118,-214880,"(AMETHYSTS, MARKET << US, 9998, 1, 977900)
(STARFRUIT, US << MARKET, 5058, 1, 977900)
(STARFRUIT, US << MARKET, 5058, 1, 977900)","{""AMETHYSTS"": 12, ""STARFRUIT"": 20}",6232,5055,10001
978100,5056,-209824,"(STARFRUIT, MARKET << US, 5056, 1, 978100)","{""AMETHYSTS"": 12, ""STARFRUIT"": 19}",6247,5057,9999
978200,5051,-204773,"(STARFRUIT, MARKET << US, 5051, 1, 978200)","{""AMETHYSTS"": 12, ""STARFRUIT"": 18}",6199,5054,10000
978700,-4951,-209724,"(AMETHYSTS, US << MARKET, 10002, 1, 978700)
(STARFRUIT, MARKET << US, 5051, 1, 978700)","{""AMETHYSTS"": 13, ""STARFRUIT"": 17}",6165,5050,10003
979200,-15153,-224877,"(STARFRUIT, US << MARKET, 5051, 1, 979200)
(STARFRUIT, US << MARKET, 5051, 1, 979200)
(STARFRUIT, US << MARKET, 5051, 1, 979200)","{""AMETHYSTS"": 13, ""STARFRUIT"": 20}",6177,5054,9998
979700,20004,-204873,"(AMETHYSTS, MARKET << US, 10002, 1, 979700)
(AMETHYSTS, MARKET << US, 10002, 1, 979700)","{""AMETHYSTS"": 11, ""STARFRUIT"": 20}",6220,5053,10003
979800,-4946,-209819,"(AMETHYSTS, US << MARKET, 10004, 1, 979800)
(STARFRUIT, MARKET << US, 5058, 1, 979800)","{""AMETHYSTS"": 12, ""STARFRUIT"": 19}",6226,5055,10000
979900,-5057,-214876,"(STARFRUIT, US << MARKET, 5057, 1, 979900)","{""AMETHYSTS"": 12, ""STARFRUIT"": 20}",6264,5057,10000
980000,-70035,-284911,"(AMETHYSTS, US << MARKET, 10005, 1, 980000)
(AMETHYSTS, US << MARKET, 10005, 1, 980000)
(AMETHYSTS, US << MARKET, 10005, 1, 980000)
(AMETHYSTS, US << MARKET, 10005, 1, 980000)
(AMETHYSTS, US << MARKET, 10005, 1, 980000)
(AMETHYSTS, US << MARKET, 10005, 1, 980000)
(AMETHYSTS, US << MARKET, 10005, 1, 980000)","{""AMETHYSTS"": 19, ""STARFRUIT"": 20}",6169,5054,10000
980500,20212,-264699,"(STARFRUIT, MARKET << US, 5053, 1, 980500)
(STARFRUIT, MARKET << US, 5053, 1, 980500)
(STARFRUIT, MARKET << US, 5053, 1, 980500)
(STARFRUIT, MARKET << US, 5053, 1, 980500)","{""AMETHYSTS"": 19, ""STARFRUIT"": 16}",6114,5052,9999
980800,-15046,-279745,"(AMETHYSTS, US << MARKET, 9996, 1, 980800)
(STARFRUIT, US << MARKET, 5050, 1, 980800)","{""AMETHYSTS"": 20, ""STARFRUIT"": 17}",6139,5052,10000
980900,5050,-274695,"(STARFRUIT, MARKET << US, 5050, 1, 980900)","{""AMETHYSTS"": 20, ""STARFRUIT"": 16}",6069,5049,9999
981000,7,-274688,"(STARFRUIT, US << MARKET, 5050, 1, 981000)
(STARFRUIT, MARKET << US, 5057, 1, 981000)","{""AMETHYSTS"": 20, ""STARFRUIT"": 16}",6180,5053,10001
982100,0,-274688,,"{""AMETHYSTS"": 20, ""STARFRUIT"": 16}",6064,5052,9996
982300,20004,-254684,"(AMETHYSTS, MARKET << US, 10002, 1, 982300)
(AMETHYSTS, MARKET << US, 10002, 1, 982300)","{""AMETHYSTS"": 18, ""STARFRUIT"": 16}",6218,5053,10003
982600,5051,-249633,"(STARFRUIT, MARKET << US, 5051, 1, 982600)","{""AMETHYSTS"": 18, ""STARFRUIT"": 15}",6177,5054,10000
983400,40400,-209233,"(STARFRUIT, MARKET << US, 5050, 1, 983400)
(STARFRUIT, MARKET << US, 5050, 1, 983400)
(STARFRUIT, MARKET << US, 5050, 1, 983400)
(STARFRUIT, MARKET << US, 5050, 1, 983400)
(STARFRUIT, MARKET << US, 5050, 1, 983400)
(STARFRUIT, MARKET << US, 5050, 1, 983400)
(STARFRUIT, MARKET << US, 5050, 1, 983400)
(STARFRUIT, MARKET << US, 5050, 1, 983400)","{""AMETHYSTS"": 18, ""STARFRUIT"": 7}",6131,5052,10000
983700,-5051,-214284,"(STARFRUIT, US << MARKET, 5051, 1, 983700)","{""AMETHYSTS"": 18, ""STARFRUIT"": 8}",6148,5054,10000
983900,-20208,-234492,"(STARFRUIT, US << MARKET, 5052, 1, 983900)
(STARFRUIT, US << MARKET, 5052, 1, 983900)
(STARFRUIT, US << MARKET, 5052, 1, 983900)
(STARFRUIT, US << MARKET, 5052, 1, 983900)","{""AMETHYSTS"": 18, ""STARFRUIT"": 12}",6156,5054,10000
984200,14947,-219545,"(AMETHYSTS, MARKET << US, 10002, 1, 984200)
(AMETHYSTS, MARKET << US, 10002, 1, 984200)
(STARFRUIT, US << MARKET, 5057, 1, 984200)","{""AMETHYSTS"": 16, ""STARFRUIT"": 13}",6141,5054,9999
984300,55354,-164191,"(AMETHYSTS, MARKET << US, 10002, 1, 984300)
(AMETHYSTS, MARKET << US, 10002, 1, 984300)
(STARFRUIT, MARKET << US, 5050, 1, 984300)
(STARFRUIT, MARKET << US, 5050, 1, 984300)
(STARFRUIT, MARKET << US, 5050, 1, 984300)
(STARFRUIT, MARKET << US, 5050, 1, 984300)
(STARFRUIT, MARKET << US, 5050, 1, 984300)
(STARFRUIT, MARKET << US, 5050, 1, 984300)
(STARFRUIT, MARKET << US, 5050, 1, 984300)","{""AMETHYSTS"": 14, ""STARFRUIT"": 6}",6169,5053,10003
984500,-19996,-184187,"(AMETHYSTS, US << MARKET, 9998, 1, 984500)
(AMETHYSTS, US << MARKET, 9998, 1, 984500)","{""AMETHYSTS"": 16, ""STARFRUIT"": 6}",6095,5055,9997
984600,-9896,-194083,"(AMETHYSTS, US << MARKET, 10000, 1, 984600)
(AMETHYSTS, US << MARKET, 10000, 1, 984600)
(STARFRUIT, MARKET << US, 5052, 1, 984600)
(STARFRUIT, MARKET << US, 5052, 1, 984600)","{""AMETHYSTS"": 18, ""STARFRUIT"": 4}",6085,5051,9998
985300,-10002,-204085,"(AMETHYSTS, US << MARKET, 10002, 1, 985300)","{""AMETHYSTS"": 19, ""STARFRUIT"": 4}",6188,5054,10003
985400,170034,-34051,"(AMETHYSTS, US << MARKET, 10002, 1, 985400)
(AMETHYSTS, MARKET << US, 10002, 1, 985400)
(AMETHYSTS, MARKET << US, 10002, 1, 985400)
(AMETHYSTS, MARKET << US, 10002, 1, 985400)
(AMETHYSTS, MARKET << US, 10002, 1, 985400)
(AMETHYSTS, MARKET << US, 10002, 1, 985400)
(AMETHYSTS, MARKET << US, 10002, 1, 985400)
(AMETHYSTS, MARKET << US, 10002, 1, 985400)
(AMETHYSTS, MARKET << US, 10002, 1, 985400)
(AMETHYSTS, MARKET << US, 10002, 1, 985400)
(AMETHYSTS, MARKET << US, 10002, 1, 985400)
(AMETHYSTS, MARKET << US, 10002, 1, 985400)
(AMETHYSTS, MARKET << US, 10002, 1, 985400)
(AMETHYSTS, MARKET << US, 10002, 1, 985400)
(AMETHYSTS, MARKET << US, 10002, 1, 985400)
(AMETHYSTS, MARKET << US, 10002, 1, 985400)
(AMETHYSTS, MARKET << US, 10002, 1, 985400)
(AMETHYSTS, MARKET << US, 10002, 1, 985400)
(AMETHYSTS, MARKET << US, 10002, 1, 985400)","{""AMETHYSTS"": 2, ""STARFRUIT"": 4}",6171,5054,10003
985700,5051,-29000,"(STARFRUIT, MARKET << US, 5051, 1, 985700)","{""AMETHYSTS"": 2, ""STARFRUIT"": 3}",6162,5054,10000
985800,5056,-23944,"(STARFRUIT, MARKET << US, 5056, 1, 985800)","{""AMETHYSTS"": 2, ""STARFRUIT"": 2}",6164,5054,10000
986000,-4946,-28890,"(AMETHYSTS, US << MARKET, 10000, 1, 986000)
(STARFRUIT, MARKET << US, 5054, 1, 986000)","{""AMETHYSTS"": 3, ""STARFRUIT"": 1}",6169,5056,10001
986200,20096,-8794,"(AMETHYSTS, MARKET << US, 9996, 1, 986200)
(STARFRUIT, MARKET << US, 5050, 1, 986200)
(STARFRUIT, MARKET << US, 5050, 1, 986200)","{""AMETHYSTS"": 2, ""STARFRUIT"": -1}",6151,5053,9999
986400,-60180,-68974,"(AMETHYSTS, US << MARKET, 9995, 1, 986400)
(AMETHYSTS, US << MARKET, 9995, 1, 986400)
(AMETHYSTS, US << MARKET, 9995, 1, 986400)
(AMETHYSTS, US << MARKET, 9995, 1, 986400)
(STARFRUIT, US << MARKET, 5050, 1, 986400)
(STARFRUIT, US << MARKET, 5050, 1, 986400)
(STARFRUIT, US << MARKET, 5050, 1, 986400)
(STARFRUIT, US << MARKET, 5050, 1, 986400)","{""AMETHYSTS"": 6, ""STARFRUIT"": 3}",6173,5053,9998
986600,20004,-48970,"(AMETHYSTS, MARKET << US, 10002, 1, 986600)
(AMETHYSTS, MARKET << US, 10002, 1, 986600)","{""AMETHYSTS"": 4, ""STARFRUIT"": 3}",6198,5052,10003
986700,5049,-43921,"(STARFRUIT, MARKET << US, 5049, 1, 986700)","{""AMETHYSTS"": 4, ""STARFRUIT"": 2}",6183,5052,10000
986800,20224,-23697,"(STARFRUIT, MARKET << US, 5056, 1, 986800)
(STARFRUIT, MARKET << US, 5056, 1, 986800)
(STARFRUIT, MARKET << US, 5056, 1, 986800)
(STARFRUIT, MARKET << US, 5056, 1, 986800)","{""AMETHYSTS"": 4, ""STARFRUIT"": -2}",6199,5052,10000
987000,20004,-3693,"(AMETHYSTS, MARKET << US, 10002, 1, 987000)
(AMETHYSTS, MARKET << US, 10002, 1, 987000)","{""AMETHYSTS"": 2, ""STARFRUIT"": -2}",6201,5052,9999
987300,-99980,-103673,"(AMETHYSTS, US << MARKET, 9998, 1, 987300)
(AMETHYSTS, US << MARKET, 9998, 1, 987300)
(AMETHYSTS, US << MARKET, 9998, 1, 987300)
(AMETHYSTS, US << MARKET, 9998, 1, 987300)
(AMETHYSTS, US << MARKET, 9998, 1, 987300)
(AMETHYSTS, US << MARKET, 9998, 1, 987300)
(AMETHYSTS, US << MARKET, 9998, 1, 987300)
(AMETHYSTS, US << MARKET, 9998, 1, 987300)
(AMETHYSTS, US << MARKET, 9998, 1, 987300)
(AMETHYSTS, US << MARKET, 9998, 1, 987300)","{""AMETHYSTS"": 12, ""STARFRUIT"": -2}",6235,5052,10001
987600,-10100,-113773,"(STARFRUIT, US << MARKET, 5050, 1, 987600)
(STARFRUIT, US << MARKET, 5050, 1, 987600)","{""AMETHYSTS"": 12, ""STARFRUIT"": 0}",6227,5053,10000
988000,34963,-78810,"(AMETHYSTS, MARKET << US, 10004, 1, 988000)
(AMETHYSTS, MARKET << US, 10004, 1, 988000)
(AMETHYSTS, MARKET << US, 10004, 1, 988000)
(AMETHYSTS, MARKET << US, 10004, 1, 988000)
(STARFRUIT, US << MARKET, 5053, 1, 988000)
(STARFRUIT, US << MARKET, 5053, 1, 988000)
(STARFRUIT, MARKET << US, 5053, 1, 988000)","{""AMETHYSTS"": 8, ""STARFRUIT"": 1}",6241,5051,10000
988200,-10108,-88918,"(STARFRUIT, US << MARKET, 5054, 1, 988200)
(STARFRUIT, US << MARKET, 5054, 1, 988200)","{""AMETHYSTS"": 8, ""STARFRUIT"": 3}",6244,5054,10000
988400,-120043,-208961,"(AMETHYSTS, US << MARKET, 9995, 1, 988400)
(AMETHYSTS, US << MARKET, 9995, 1, 988400)
(AMETHYSTS, US << MARKET, 9995, 1, 988400)
(AMETHYSTS, US << MARKET, 9995, 1, 988400)
(AMETHYSTS, US << MARKET, 9995, 1, 988400)
(AMETHYSTS, US << MARKET, 9995, 1, 988400)
(AMETHYSTS, US << MARKET, 9995, 1, 988400)
(AMETHYSTS, US << MARKET, 9995, 1, 988400)
(AMETHYSTS, US << MARKET, 9995, 1, 988400)
(AMETHYSTS, US << MARKET, 9995, 1, 988400)
(AMETHYSTS, US << MARKET, 9995, 1, 988400)
(STARFRUIT, US << MARKET, 5049, 1, 988400)
(STARFRUIT, US << MARKET, 5049, 1, 988400)","{""AMETHYSTS"": 19, ""STARFRUIT"": 5}",6299,5052,10000
988900,5049,-203912,"(STARFRUIT, MARKET << US, 5049, 1, 988900)","{""AMETHYSTS"": 19, ""STARFRUIT"": 4}",6353,5052,10003
989000,20004,-183908,"(AMETHYSTS, MARKET << US, 10002, 1, 989000)
(AMETHYSTS, MARKET << US, 10002, 1, 989000)","{""AMETHYSTS"": 17, ""STARFRUIT"": 4}",6351,5052,10003
989100,-10098,-194006,"(STARFRUIT, US << MARKET, 5049, 1, 989100)
(STARFRUIT, US << MARKET, 5049, 1, 989100)","{""AMETHYSTS"": 17, ""STARFRUIT"": 6}",6266,5051,9998
989900,-20004,-214010,"(AMETHYSTS, US << MARKET, 10002, 1, 989900)
(AMETHYSTS, US << MARKET, 10002, 1, 989900)","{""AMETHYSTS"": 19, ""STARFRUIT"": 6}",6359,5052,10003
990100,5050,-208960,"(STARFRUIT, MARKET << US, 5050, 1, 990100)","{""AMETHYSTS"": 19, ""STARFRUIT"": 5}",6300,5052,10000
990900,-20116,-229076,"(AMETHYSTS, US << MARKET, 10002, 1, 990900)
(STARFRUIT, US << MARKET, 5057, 1, 990900)
(STARFRUIT, US << MARKET, 5057, 1, 990900)","{""AMETHYSTS"": 20, ""STARFRUIT"": 7}",6362,5054,10003
991000,-5058,-234134,"(STARFRUIT, US << MARKET, 5058, 1, 991000)","{""AMETHYSTS"": 20, ""STARFRUIT"": 8}",6330,5058,10000
991200,-20224,-254358,"(STARFRUIT, US << MARKET, 5056, 1, 991200)
(STARFRUIT, US << MARKET, 5056, 1, 991200)
(STARFRUIT, US << MARKET, 5056, 1, 991200)
(STARFRUIT, US << MARKET, 5056, 1, 991200)","{""AMETHYSTS"": 20, ""STARFRUIT"": 12}",6326,5057,10000
991600,19996,-234362,"(AMETHYSTS, MARKET << US, 9998, 1, 991600)
(AMETHYSTS, MARKET << US, 9998, 1, 991600)","{""AMETHYSTS"": 18, ""STARFRUIT"": 12}",6256,5056,9997
992000,-20240,-254602,"(STARFRUIT, US << MARKET, 5060, 1, 992000)
(STARFRUIT, US << MARKET, 5060, 1, 992000)
(STARFRUIT, US << MARKET, 5060, 1, 992000)
(STARFRUIT, US << MARKET, 5060, 1, 992000)","{""AMETHYSTS"": 18, ""STARFRUIT"": 16}",6294,5056,10000
992200,-10002,-264604,"(AMETHYSTS, US << MARKET, 10002, 1, 992200)","{""AMETHYSTS"": 19, ""STARFRUIT"": 16}",6349,5056,10003
992500,40416,-224188,"(STARFRUIT, MARKET << US, 5052, 1, 992500)
(STARFRUIT, MARKET << US, 5052, 1, 992500)
(STARFRUIT, MARKET << US, 5052, 1, 992500)
(STARFRUIT, MARKET << US, 5052, 1, 992500)
(STARFRUIT, MARKET << US, 5052, 1, 992500)
(STARFRUIT, MARKET << US, 5052, 1, 992500)
(STARFRUIT, MARKET << US, 5052, 1, 992500)
(STARFRUIT, MARKET << US, 5052, 1, 992500)","{""AMETHYSTS"": 19, ""STARFRUIT"": 8}",6252,5055,10000
992800,70026,-154162,"(AMETHYSTS, US << MARKET, 10004, 1, 992800)
(AMETHYSTS, MARKET << US, 10004, 1, 992800)
(AMETHYSTS, MARKET << US, 10004, 1, 992800)
(AMETHYSTS, MARKET << US, 10004, 1, 992800)
(AMETHYSTS, MARKET << US, 10004, 1, 992800)
(AMETHYSTS, MARKET << US, 10004, 1, 992800)
(AMETHYSTS, MARKET << US, 10004, 1, 992800)
(AMETHYSTS, MARKET << US, 10004, 1, 992800)
(AMETHYSTS, MARKET << US, 10002, 1, 992800)","{""AMETHYSTS"": 12, ""STARFRUIT"": 8}",6306,5054,10003
993000,14953,-139209,"(AMETHYSTS, MARKET << US, 10005, 1, 993000)
(AMETHYSTS, MARKET << US, 10005, 1, 993000)
(STARFRUIT, US << MARKET, 5057, 1, 993000)","{""AMETHYSTS"": 10, ""STARFRUIT"": 9}",6286,5055,10000
993400,25174,-114035,"(AMETHYSTS, MARKET << US, 9996, 1, 993400)
(STARFRUIT, US << MARKET, 5050, 1, 993400)
(STARFRUIT, MARKET << US, 5057, 1, 993400)
(STARFRUIT, MARKET << US, 5057, 1, 993400)
(STARFRUIT, MARKET << US, 5057, 1, 993400)
(STARFRUIT, MARKET << US, 5057, 1, 993400)","{""AMETHYSTS"": 9, ""STARFRUIT"": 6}",6274,5053,9999
993800,-5050,-119085,"(STARFRUIT, US << MARKET, 5051, 1, 993800)
(STARFRUIT, US << MARKET, 5051, 1, 993800)
(STARFRUIT, MARKET << US, 5052, 1, 993800)","{""AMETHYSTS"": 9, ""STARFRUIT"": 7}",6300,5055,10000
993900,-5056,-124141,"(STARFRUIT, US << MARKET, 5056, 1, 993900)","{""AMETHYSTS"": 9, ""STARFRUIT"": 8}",6292,5053,10001
994000,9996,-114145,"(AMETHYSTS, US << MARKET, 9996, 1, 994000)
(AMETHYSTS, US << MARKET, 9996, 1, 994000)
(AMETHYSTS, MARKET << US, 9996, 1, 994000)
(AMETHYSTS, MARKET << US, 9996, 1, 994000)
(AMETHYSTS, MARKET << US, 9996, 1, 994000)","{""AMETHYSTS"": 8, ""STARFRUIT"": 8}",6287,5054,10000
994100,15051,-99094,"(AMETHYSTS, MARKET << US, 9995, 1, 994100)
(STARFRUIT, MARKET << US, 5056, 1, 994100)","{""AMETHYSTS"": 7, ""STARFRUIT"": 7}",6298,5056,10000
994400,5052,-94042,"(STARFRUIT, MARKET << US, 5052, 1, 994400)","{""AMETHYSTS"": 7, ""STARFRUIT"": 6}",6295,5055,10001
994700,5052,-88990,"(STARFRUIT, MARKET << US, 5052, 1, 994700)","{""AMETHYSTS"": 7, ""STARFRUIT"": 5}",6291,5052,10003
994900,25157,-63833,"(AMETHYSTS, MARKET << US, 9998, 1, 994900)
(STARFRUIT, US << MARKET, 5053, 1, 994900)
(STARFRUIT, MARKET << US, 5053, 1, 994900)
(STARFRUIT, MARKET << US, 5053, 1, 994900)
(STARFRUIT, MARKET << US, 5053, 1, 994900)
(STARFRUIT, MARKET << US, 5053, 1, 994900)","{""AMETHYSTS"": 6, ""STARFRUIT"": 2}",6255,5056,9996
995000,30318,-33515,"(STARFRUIT, MARKET << US, 5053, 1, 995000)
(STARFRUIT, MARKET << US, 5053, 1, 995000)
(STARFRUIT, MARKET << US, 5053, 1, 995000)
(STARFRUIT, MARKET << US, 5053, 1, 995000)
(STARFRUIT, MARKET << US, 5053, 1, 995000)
(STARFRUIT, MARKET << US, 5053, 1, 995000)","{""AMETHYSTS"": 6, ""STARFRUIT"": -4}",6277,5052,10000
995500,10116,-23399,"(STARFRUIT, MARKET << US, 5058, 1, 995500)
(STARFRUIT, MARKET << US, 5058, 1, 995500)","{""AMETHYSTS"": 6, ""STARFRUIT"": -6}",6271,5056,10001
995700,-10114,-33513,"(STARFRUIT, US << MARKET, 5057, 1, 995700)
(STARFRUIT, US << MARKET, 5057, 1, 995700)","{""AMETHYSTS"": 6, ""STARFRUIT"": -4}",6249,5058,9999
996200,9998,-23515,"(AMETHYSTS, MARKET << US, 9998, 1, 996200)","{""AMETHYSTS"": 5, ""STARFRUIT"": -4}",6270,5055,10001
996300,-19992,-43507,"(AMETHYSTS, US << MARKET, 9996, 1, 996300)
(AMETHYSTS, US << MARKET, 9996, 1, 996300)","{""AMETHYSTS"": 7, ""STARFRUIT"": -4}",6270,5054,9999
996500,-30012,-73519,"(AMETHYSTS, US << MARKET, 10004, 1, 996500)
(AMETHYSTS, US << MARKET, 10004, 1, 996500)
(AMETHYSTS, US << MARKET, 10004, 1, 996500)","{""AMETHYSTS"": 10, ""STARFRUIT"": -4}",6261,5055,10000
996600,-10238,-83757,"(AMETHYSTS, MARKET << US, 9998, 1, 996600)
(STARFRUIT, US << MARKET, 5059, 1, 996600)
(STARFRUIT, US << MARKET, 5059, 1, 996600)
(STARFRUIT, US << MARKET, 5059, 1, 996600)
(STARFRUIT, US << MARKET, 5059, 1, 996600)","{""AMETHYSTS"": 9, ""STARFRUIT"": 0}",6216,5056,9997
996700,-35169,-118926,"(AMETHYSTS, US << MARKET, 10005, 1, 996700)
(AMETHYSTS, US << MARKET, 10005, 1, 996700)
(STARFRUIT, US << MARKET, 5053, 1, 996700)
(STARFRUIT, US << MARKET, 5053, 1, 996700)
(STARFRUIT, US << MARKET, 5053, 1, 996700)
(STARFRUIT, US << MARKET, 5053, 1, 996700)
(STARFRUIT, US << MARKET, 5053, 1, 996700)
(STARFRUIT, US << MARKET, 5053, 1, 996700)
(STARFRUIT, MARKET << US, 5053, 1, 996700)
(STARFRUIT, MARKET << US, 5053, 1, 996700)
(STARFRUIT, MARKET << US, 5053, 1, 996700)","{""AMETHYSTS"": 11, ""STARFRUIT"": 3}",6275,5056,10003
996900,-14945,-133871,"(AMETHYSTS, US << MARKET, 9998, 1, 996900)
(AMETHYSTS, US << MARKET, 9998, 1, 996900)
(STARFRUIT, MARKET << US, 5051, 1, 996900)","{""AMETHYSTS"": 13, ""STARFRUIT"": 2}",6198,5054,9997
997000,-25280,-159151,"(STARFRUIT, US << MARKET, 5056, 1, 997000)
(STARFRUIT, US << MARKET, 5056, 1, 997000)
(STARFRUIT, US << MARKET, 5056, 1, 997000)
(STARFRUIT, US << MARKET, 5056, 1, 997000)
(STARFRUIT, US << MARKET, 5056, 1, 997000)","{""AMETHYSTS"": 13, ""STARFRUIT"": 7}",6248,5057,10000
997100,-25048,-184199,"(AMETHYSTS, US << MARKET, 9996, 1, 997100)
(AMETHYSTS, US << MARKET, 9996, 1, 997100)
(STARFRUIT, US << MARKET, 5056, 1, 997100)","{""AMETHYSTS"": 15, ""STARFRUIT"": 8}",6249,5056,10000
997500,9998,-174201,"(AMETHYSTS, MARKET << US, 9998, 1, 997500)","{""AMETHYSTS"": 14, ""STARFRUIT"": 8}",6221,5051,10001
997600,80016,-94185,"(AMETHYSTS, MARKET << US, 10002, 1, 997600)
(AMETHYSTS, MARKET << US, 10002, 1, 997600)
(AMETHYSTS, MARKET << US, 10002, 1, 997600)
(AMETHYSTS, MARKET << US, 10002, 1, 997600)
(AMETHYSTS, MARKET << US, 10002, 1, 997600)
(AMETHYSTS, MARKET << US, 10002, 1, 997600)
(AMETHYSTS, MARKET << US, 10002, 1, 997600)
(AMETHYSTS, MARKET << US, 10002, 1, 997600)","{""AMETHYSTS"": 6, ""STARFRUIT"": 8}",6241,5051,10003
997700,20004,-74181,"(AMETHYSTS, MARKET << US, 10002, 1, 997700)
(AMETHYSTS, MARKET << US, 10002, 1, 997700)","{""AMETHYSTS"": 4, ""STARFRUIT"": 8}",6207,5050,9997
998000,-5050,-79231,"(STARFRUIT, US << MARKET, 5050, 1, 998000)","{""AMETHYSTS"": 4, ""STARFRUIT"": 9}",6214,5049,10001
998400,-40008,-119239,"(AMETHYSTS, US << MARKET, 10002, 1, 998400)
(AMETHYSTS, US << MARKET, 10002, 1, 998400)
(AMETHYSTS, US << MARKET, 10002, 1, 998400)
(AMETHYSTS, US << MARKET, 10002, 1, 998400)","{""AMETHYSTS"": 8, ""STARFRUIT"": 9}",6253,5052,10003
998500,-15150,-134389,"(STARFRUIT, US << MARKET, 5050, 1, 998500)
(STARFRUIT, US << MARKET, 5050, 1, 998500)
(STARFRUIT, US << MARKET, 5050, 1, 998500)","{""AMETHYSTS"": 8, ""STARFRUIT"": 12}",6239,5053,9999
998700,5055,-129334,"(STARFRUIT, MARKET << US, 5055, 1, 998700)","{""AMETHYSTS"": 8, ""STARFRUIT"": 11}",6238,5052,10000
998800,-4952,-134286,"(AMETHYSTS, US << MARKET, 10002, 1, 998800)
(STARFRUIT, MARKET << US, 5050, 1, 998800)","{""AMETHYSTS"": 9, ""STARFRUIT"": 10}",6271,5053,10003
999500,-50078,-184364,"(AMETHYSTS, US << MARKET, 9995, 1, 999500)
(AMETHYSTS, US << MARKET, 9995, 1, 999500)
(AMETHYSTS, US << MARKET, 9995, 1, 999500)
(AMETHYSTS, US << MARKET, 9995, 1, 999500)
(STARFRUIT, US << MARKET, 5049, 1, 999500)
(STARFRUIT, US << MARKET, 5049, 1, 999500)","{""AMETHYSTS"": 13, ""STARFRUIT"": 12}",6234,5052,9998
999600,5048,-179316,"(STARFRUIT, MARKET << US, 5048, 1, 999600)","{""AMETHYSTS"": 13, ""STARFRUIT"": 11}",6232,5051,9999
