timestamp,marginal_profit,pnl,trades,position,actual_pnl,starfruit_price,amethyst_price
100,-40248,-40248,"(AMETHYSTS, US << MARKET, 10002, 1, 100)
(STARFRUIT, US << MARKET, 5041, 1, 100)
(STARFRUIT, US << MARKET, 5041, 1, 100)
(STARFRUIT, US << MARKET, 5041, 1, 100)
(STARFRUIT, US << MARKET, 5041, 1, 100)
(STARFRUIT, US << MARKET, 5041, 1, 100)
(STARFRUIT, US << MARKET, 5041, 1, 100)","{""AMETHYSTS"": 1, ""STARFRUIT"": 6}",3,5042,9999
300,-34803,-75051,"(AMETHYSTS, US << MARKET, 9998, 1, 300)
(AMETHYSTS, US << MARKET, 9998, 1, 300)
(AMETHYSTS, US << MARKET, 9998, 1, 300)
(AMETHYSTS, US << MARKET, 9998, 1, 300)
(AMETHYSTS, US << MARKET, 9998, 1, 300)
(AMETHYSTS, US << MARKET, 9998, 1, 300)
(STARFRUIT, MARKET << US, 5037, 1, 300)
(STARFRUIT, MARKET << US, 5037, 1, 300)
(STARFRUIT, MARKET << US, 5037, 1, 300)
(STARFRUIT, MARKET << US, 5037, 1, 300)
(STARFRUIT, MARKET << US, 5037, 1, 300)","{""AMETHYSTS"": 7, ""STARFRUIT"": 1}",-32,5040,9997
500,15044,-60007,"(AMETHYSTS, US << MARKET, 10004, 1, 500)
(AMETHYSTS, MARKET << US, 10002, 1, 500)
(AMETHYSTS, MARKET << US, 10002, 1, 500)
(STARFRUIT, MARKET << US, 5044, 1, 500)","{""AMETHYSTS"": 6, ""STARFRUIT"": 0}",11,5040,10003
1300,10080,-49927,"(STARFRUIT, MARKET << US, 5040, 1, 1300)
(STARFRUIT, MARKET << US, 5040, 1, 1300)","{""AMETHYSTS"": 6, ""STARFRUIT"": -2}",1,5036,10000
1400,-10072,-59999,"(STARFRUIT, US << MARKET, 5036, 1, 1400)
(STARFRUIT, US << MARKET, 5036, 1, 1400)","{""AMETHYSTS"": 6, ""STARFRUIT"": 0}",1,5039,10000
1500,25045,-34954,"(AMETHYSTS, MARKET << US, 10002, 1, 1500)
(AMETHYSTS, MARKET << US, 10002, 1, 1500)
(STARFRUIT, MARKET << US, 5041, 1, 1500)","{""AMETHYSTS"": 4, ""STARFRUIT"": -1}",16,5042,10003
1700,-60030,-94984,"(AMETHYSTS, US << MARKET, 10005, 1, 1700)
(AMETHYSTS, US << MARKET, 10005, 1, 1700)
(AMETHYSTS, US << MARKET, 10005, 1, 1700)
(AMETHYSTS, US << MARKET, 10005, 1, 1700)
(AMETHYSTS, US << MARKET, 10005, 1, 1700)
(AMETHYSTS, US << MARKET, 10005, 1, 1700)","{""AMETHYSTS"": 10, ""STARFRUIT"": -1}",-22,5038,10000
2400,15126,-79858,"(STARFRUIT, MARKET << US, 5042, 1, 2400)
(STARFRUIT, MARKET << US, 5042, 1, 2400)
(STARFRUIT, MARKET << US, 5042, 1, 2400)","{""AMETHYSTS"": 10, ""STARFRUIT"": -4}",-16,5042,10001
2700,-89982,-169840,"(AMETHYSTS, US << MARKET, 9998, 1, 2700)
(AMETHYSTS, US << MARKET, 9998, 1, 2700)
(AMETHYSTS, US << MARKET, 9998, 1, 2700)
(AMETHYSTS, US << MARKET, 9998, 1, 2700)
(AMETHYSTS, US << MARKET, 9998, 1, 2700)
(AMETHYSTS, US << MARKET, 9998, 1, 2700)
(AMETHYSTS, US << MARKET, 9998, 1, 2700)
(AMETHYSTS, US << MARKET, 9998, 1, 2700)
(AMETHYSTS, US << MARKET, 9998, 1, 2700)","{""AMETHYSTS"": 19, ""STARFRUIT"": -4}",31,5037,10001
2800,5041,-164799,"(STARFRUIT, MARKET << US, 5041, 1, 2800)","{""AMETHYSTS"": 19, ""STARFRUIT"": -5}",15,5041,10001
2900,9998,-154801,"(AMETHYSTS, MARKET << US, 9998, 1, 2900)","{""AMETHYSTS"": 18, ""STARFRUIT"": -5}",63,5038,10003
3100,5035,-149766,"(STARFRUIT, MARKET << US, 5035, 1, 3100)","{""AMETHYSTS"": 18, ""STARFRUIT"": -6}",6,5038,10000
3300,0,-149766,"(AMETHYSTS, US << MARKET, 9996, 1, 3300)
(AMETHYSTS, US << MARKET, 9996, 1, 3300)
(AMETHYSTS, MARKET << US, 9996, 1, 3300)
(AMETHYSTS, MARKET << US, 9996, 1, 3300)","{""AMETHYSTS"": 18, ""STARFRUIT"": -6}",12,5037,10000
3700,-40296,-190062,"(STARFRUIT, US << MARKET, 5037, 1, 3700)
(STARFRUIT, US << MARKET, 5037, 1, 3700)
(STARFRUIT, US << MARKET, 5037, 1, 3700)
(STARFRUIT, US << MARKET, 5037, 1, 3700)
(STARFRUIT, US << MARKET, 5037, 1, 3700)
(STARFRUIT, US << MARKET, 5037, 1, 3700)
(STARFRUIT, US << MARKET, 5037, 1, 3700)
(STARFRUIT, US << MARKET, 5037, 1, 3700)","{""AMETHYSTS"": 18, ""STARFRUIT"": 2}",-26,5036,9998
3800,20136,-169926,"(STARFRUIT, MARKET << US, 5034, 1, 3800)
(STARFRUIT, MARKET << US, 5034, 1, 3800)
(STARFRUIT, MARKET << US, 5034, 1, 3800)
(STARFRUIT, MARKET << US, 5034, 1, 3800)","{""AMETHYSTS"": 18, ""STARFRUIT"": -2}",56,5036,10003
4200,10070,-159856,"(STARFRUIT, MARKET << US, 5035, 1, 4200)
(STARFRUIT, MARKET << US, 5035, 1, 4200)","{""AMETHYSTS"": 18, ""STARFRUIT"": -4}",-8,5038,10000
4300,-10071,-169927,"(AMETHYSTS, US << MARKET, 9996, 1, 4300)
(AMETHYSTS, US << MARKET, 9996, 1, 4300)
(AMETHYSTS, MARKET << US, 9996, 1, 4300)
(AMETHYSTS, MARKET << US, 9995, 1, 4300)
(STARFRUIT, US << MARKET, 5035, 1, 4300)
(STARFRUIT, US << MARKET, 5035, 1, 4300)","{""AMETHYSTS"": 18, ""STARFRUIT"": -2}",-3,5038,10000
4400,-72,-169999,"(AMETHYSTS, MARKET << US, 9998, 1, 4400)
(STARFRUIT, US << MARKET, 5035, 1, 4400)
(STARFRUIT, US << MARKET, 5035, 1, 4400)","{""AMETHYSTS"": 17, ""STARFRUIT"": 0}",-50,5039,9997
4800,-30082,-200081,"(AMETHYSTS, US << MARKET, 10002, 1, 4800)
(AMETHYSTS, US << MARKET, 10002, 1, 4800)
(STARFRUIT, US << MARKET, 5039, 1, 4800)
(STARFRUIT, US << MARKET, 5039, 1, 4800)","{""AMETHYSTS"": 19, ""STARFRUIT"": 2}",48,5036,10003
4900,-9998,-210079,"(AMETHYSTS, US << MARKET, 9998, 1, 4900)","{""AMETHYSTS"": 20, ""STARFRUIT"": 2}",-87,5036,9996
5400,-25175,-235254,"(STARFRUIT, US << MARKET, 5035, 1, 5400)
(STARFRUIT, US << MARKET, 5035, 1, 5400)
(STARFRUIT, US << MARKET, 5035, 1, 5400)
(STARFRUIT, US << MARKET, 5035, 1, 5400)
(STARFRUIT, US << MARKET, 5035, 1, 5400)","{""AMETHYSTS"": 20, ""STARFRUIT"": 7}",-83,5033,9997
6700,0,-235254,,"{""AMETHYSTS"": 20, ""STARFRUIT"": 7}",37,5033,10003
6800,30054,-205200,"(AMETHYSTS, MARKET << US, 9998, 1, 6800)
(AMETHYSTS, MARKET << US, 9996, 1, 6800)
(STARFRUIT, MARKET << US, 5030, 1, 6800)
(STARFRUIT, MARKET << US, 5030, 1, 6800)","{""AMETHYSTS"": 18, ""STARFRUIT"": 5}",-17,5033,10001
6900,5035,-200165,"(STARFRUIT, MARKET << US, 5035, 1, 6900)","{""AMETHYSTS"": 18, ""STARFRUIT"": 4}",-37,5032,10000
7200,-20076,-220241,"(AMETHYSTS, US << MARKET, 10004, 1, 7200)
(STARFRUIT, US << MARKET, 5036, 1, 7200)
(STARFRUIT, US << MARKET, 5036, 1, 7200)","{""AMETHYSTS"": 19, ""STARFRUIT"": 6}",-43,5033,10000
7300,25150,-195091,"(STARFRUIT, MARKET << US, 5030, 1, 7300)
(STARFRUIT, MARKET << US, 5030, 1, 7300)
(STARFRUIT, MARKET << US, 5030, 1, 7300)
(STARFRUIT, MARKET << US, 5030, 1, 7300)
(STARFRUIT, MARKET << US, 5030, 1, 7300)","{""AMETHYSTS"": 19, ""STARFRUIT"": 1}",-77,5033,9999
7400,-10002,-205093,"(AMETHYSTS, US << MARKET, 10002, 1, 7400)","{""AMETHYSTS"": 20, ""STARFRUIT"": 1}",-1,5032,10003
7700,10071,-195022,"(STARFRUIT, MARKET << US, 5036, 1, 7700)
(STARFRUIT, MARKET << US, 5035, 1, 7700)","{""AMETHYSTS"": 20, ""STARFRUIT"": -1}",-54,5032,10000
7800,5036,-189986,"(STARFRUIT, MARKET << US, 5036, 1, 7800)","{""AMETHYSTS"": 20, ""STARFRUIT"": -2}",-58,5036,10000
7900,9934,-180052,"(AMETHYSTS, MARKET << US, 10002, 1, 7900)
(AMETHYSTS, MARKET << US, 10002, 1, 7900)
(STARFRUIT, US << MARKET, 5035, 1, 7900)
(STARFRUIT, US << MARKET, 5035, 1, 7900)","{""AMETHYSTS"": 18, ""STARFRUIT"": 0}",-70,5036,9999
8100,-30222,-210274,"(STARFRUIT, US << MARKET, 5037, 1, 8100)
(STARFRUIT, US << MARKET, 5037, 1, 8100)
(STARFRUIT, US << MARKET, 5037, 1, 8100)
(STARFRUIT, US << MARKET, 5037, 1, 8100)
(STARFRUIT, US << MARKET, 5037, 1, 8100)
(STARFRUIT, US << MARKET, 5037, 1, 8100)","{""AMETHYSTS"": 18, ""STARFRUIT"": 6}",-70,5034,10000
8200,-19996,-230270,"(AMETHYSTS, US << MARKET, 9998, 1, 8200)
(AMETHYSTS, US << MARKET, 9998, 1, 8200)","{""AMETHYSTS"": 20, ""STARFRUIT"": 6}",-158,5032,9996
8300,-20148,-250418,"(STARFRUIT, US << MARKET, 5037, 1, 8300)
(STARFRUIT, US << MARKET, 5037, 1, 8300)
(STARFRUIT, US << MARKET, 5037, 1, 8300)
(STARFRUIT, US << MARKET, 5037, 1, 8300)","{""AMETHYSTS"": 20, ""STARFRUIT"": 10}",-18,5034,10003
8900,100020,-150398,"(AMETHYSTS, MARKET << US, 10002, 1, 8900)
(AMETHYSTS, MARKET << US, 10002, 1, 8900)
(AMETHYSTS, MARKET << US, 10002, 1, 8900)
(AMETHYSTS, MARKET << US, 10002, 1, 8900)
(AMETHYSTS, MARKET << US, 10002, 1, 8900)
(AMETHYSTS, MARKET << US, 10002, 1, 8900)
(AMETHYSTS, MARKET << US, 10002, 1, 8900)
(AMETHYSTS, MARKET << US, 10002, 1, 8900)
(AMETHYSTS, MARKET << US, 10002, 1, 8900)
(AMETHYSTS, MARKET << US, 10002, 1, 8900)","{""AMETHYSTS"": 10, ""STARFRUIT"": 10}",-38,5033,10003
9300,-20136,-170534,"(STARFRUIT, US << MARKET, 5034, 1, 9300)
(STARFRUIT, US << MARKET, 5034, 1, 9300)
(STARFRUIT, US << MARKET, 5034, 1, 9300)
(STARFRUIT, US << MARKET, 5034, 1, 9300)","{""AMETHYSTS"": 10, ""STARFRUIT"": 14}",-44,5035,10000
9600,10068,-160466,"(STARFRUIT, MARKET << US, 5034, 1, 9600)
(STARFRUIT, MARKET << US, 5034, 1, 9600)","{""AMETHYSTS"": 10, ""STARFRUIT"": 12}",-118,5029,10000
10100,-20132,-180598,"(STARFRUIT, US << MARKET, 5033, 1, 10100)
(STARFRUIT, US << MARKET, 5033, 1, 10100)
(STARFRUIT, US << MARKET, 5033, 1, 10100)
(STARFRUIT, US << MARKET, 5033, 1, 10100)","{""AMETHYSTS"": 10, ""STARFRUIT"": 16}",-54,5034,10000
10300,-9938,-190536,"(AMETHYSTS, US << MARKET, 10004, 1, 10300)
(AMETHYSTS, US << MARKET, 10004, 1, 10300)
(STARFRUIT, MARKET << US, 5035, 1, 10300)
(STARFRUIT, MARKET << US, 5035, 1, 10300)","{""AMETHYSTS"": 12, ""STARFRUIT"": 14}",-88,5032,10000
10600,19996,-170540,"(AMETHYSTS, MARKET << US, 9998, 1, 10600)
(AMETHYSTS, MARKET << US, 9998, 1, 10600)","{""AMETHYSTS"": 10, ""STARFRUIT"": 14}",-146,5031,9996
10700,-20116,-190656,"(STARFRUIT, US << MARKET, 5029, 1, 10700)
(STARFRUIT, US << MARKET, 5029, 1, 10700)
(STARFRUIT, US << MARKET, 5029, 1, 10700)
(STARFRUIT, US << MARKET, 5029, 1, 10700)","{""AMETHYSTS"": 10, ""STARFRUIT"": 18}",-70,5032,10001
10800,-4973,-195629,"(AMETHYSTS, US << MARKET, 10002, 1, 10800)
(STARFRUIT, MARKET << US, 5029, 1, 10800)","{""AMETHYSTS"": 11, ""STARFRUIT"": 17}",-52,5032,10003
11100,19992,-175637,"(AMETHYSTS, MARKET << US, 9996, 1, 11100)
(AMETHYSTS, MARKET << US, 9996, 1, 11100)","{""AMETHYSTS"": 9, ""STARFRUIT"": 17}",-119,5031,9999
11300,30204,-145433,"(STARFRUIT, MARKET << US, 5034, 1, 11300)
(STARFRUIT, MARKET << US, 5034, 1, 11300)
(STARFRUIT, MARKET << US, 5034, 1, 11300)
(STARFRUIT, MARKET << US, 5034, 1, 11300)
(STARFRUIT, MARKET << US, 5034, 1, 11300)
(STARFRUIT, MARKET << US, 5034, 1, 11300)","{""AMETHYSTS"": 9, ""STARFRUIT"": 11}",-103,5030,10000
11400,9998,-135435,"(AMETHYSTS, MARKET << US, 9998, 1, 11400)","{""AMETHYSTS"": 8, ""STARFRUIT"": 11}",-97,5030,10001
12000,-20128,-155563,"(STARFRUIT, US << MARKET, 5032, 1, 12000)
(STARFRUIT, US << MARKET, 5032, 1, 12000)
(STARFRUIT, US << MARKET, 5032, 1, 12000)
(STARFRUIT, US << MARKET, 5032, 1, 12000)","{""AMETHYSTS"": 8, ""STARFRUIT"": 15}",-143,5028,10000
12100,30056,-125507,"(AMETHYSTS, MARKET << US, 10002, 1, 12100)
(AMETHYSTS, MARKET << US, 10002, 1, 12100)
(STARFRUIT, MARKET << US, 5026, 1, 12100)
(STARFRUIT, MARKET << US, 5026, 1, 12100)","{""AMETHYSTS"": 6, ""STARFRUIT"": 13}",-136,5029,9999
12300,-10002,-135509,"(AMETHYSTS, US << MARKET, 10002, 1, 12300)","{""AMETHYSTS"": 7, ""STARFRUIT"": 13}",-172,5027,9998
12500,-50010,-185519,"(AMETHYSTS, US << MARKET, 10002, 1, 12500)
(AMETHYSTS, US << MARKET, 10002, 1, 12500)
(AMETHYSTS, US << MARKET, 10002, 1, 12500)
(AMETHYSTS, US << MARKET, 10002, 1, 12500)
(AMETHYSTS, US << MARKET, 10002, 1, 12500)","{""AMETHYSTS"": 12, ""STARFRUIT"": 13}",-119,5028,10003
13300,-5034,-190553,"(STARFRUIT, US << MARKET, 5034, 1, 13300)","{""AMETHYSTS"": 12, ""STARFRUIT"": 14}",-133,5030,10000
13600,25165,-165388,"(STARFRUIT, MARKET << US, 5033, 1, 13600)
(STARFRUIT, MARKET << US, 5033, 1, 13600)
(STARFRUIT, MARKET << US, 5033, 1, 13600)
(STARFRUIT, MARKET << US, 5033, 1, 13600)
(STARFRUIT, MARKET << US, 5033, 1, 13600)","{""AMETHYSTS"": 12, ""STARFRUIT"": 9}",-82,5034,10000
13700,9998,-155390,"(AMETHYSTS, MARKET << US, 9998, 1, 13700)","{""AMETHYSTS"": 11, ""STARFRUIT"": 9}",-82,5033,10001
14000,4961,-150429,"(AMETHYSTS, MARKET << US, 9996, 1, 14000)
(STARFRUIT, US << MARKET, 5035, 1, 14000)","{""AMETHYSTS"": 10, ""STARFRUIT"": 10}",-79,5035,10000
14300,5029,-145400,"(STARFRUIT, MARKET << US, 5029, 1, 14300)","{""AMETHYSTS"": 10, ""STARFRUIT"": 9}",-112,5032,10000
14500,-5035,-150435,"(STARFRUIT, US << MARKET, 5032, 1, 14500)
(STARFRUIT, US << MARKET, 5032, 1, 14500)
(STARFRUIT, MARKET << US, 5029, 1, 14500)","{""AMETHYSTS"": 10, ""STARFRUIT"": 10}",-155,5030,9998
14800,5029,-145406,"(STARFRUIT, MARKET << US, 5029, 1, 14800)","{""AMETHYSTS"": 10, ""STARFRUIT"": 9}",-127,5031,10000
15000,10058,-135348,"(STARFRUIT, MARKET << US, 5029, 1, 15000)
(STARFRUIT, MARKET << US, 5029, 1, 15000)","{""AMETHYSTS"": 10, ""STARFRUIT"": 7}",-131,5031,10000
15100,30070,-105278,"(AMETHYSTS, MARKET << US, 10002, 1, 15100)
(AMETHYSTS, MARKET << US, 10002, 1, 15100)
(STARFRUIT, MARKET << US, 5033, 1, 15100)
(STARFRUIT, MARKET << US, 5033, 1, 15100)","{""AMETHYSTS"": 8, ""STARFRUIT"": 5}",-84,5034,10003
15200,-20116,-125394,"(STARFRUIT, US << MARKET, 5029, 1, 15200)
(STARFRUIT, US << MARKET, 5029, 1, 15200)
(STARFRUIT, US << MARKET, 5029, 1, 15200)
(STARFRUIT, US << MARKET, 5029, 1, 15200)","{""AMETHYSTS"": 8, ""STARFRUIT"": 9}",-132,5030,9999
15400,-4969,-130363,"(AMETHYSTS, US << MARKET, 10002, 1, 15400)
(STARFRUIT, MARKET << US, 5033, 1, 15400)","{""AMETHYSTS"": 9, ""STARFRUIT"": 8}",-132,5030,9999
15500,-15079,-145442,"(STARFRUIT, US << MARKET, 5028, 1, 15500)
(STARFRUIT, US << MARKET, 5028, 1, 15500)
(STARFRUIT, US << MARKET, 5028, 1, 15500)
(STARFRUIT, US << MARKET, 5028, 1, 15500)
(STARFRUIT, MARKET << US, 5033, 1, 15500)","{""AMETHYSTS"": 9, ""STARFRUIT"": 11}",-103,5030,10001
15800,75188,-70254,"(AMETHYSTS, MARKET << US, 9998, 1, 15800)
(AMETHYSTS, MARKET << US, 9998, 1, 15800)
(AMETHYSTS, MARKET << US, 9998, 1, 15800)
(AMETHYSTS, MARKET << US, 9998, 1, 15800)
(STARFRUIT, MARKET << US, 5028, 1, 15800)
(STARFRUIT, MARKET << US, 5028, 1, 15800)
(STARFRUIT, MARKET << US, 5028, 1, 15800)
(STARFRUIT, MARKET << US, 5028, 1, 15800)
(STARFRUIT, MARKET << US, 5028, 1, 15800)
(STARFRUIT, MARKET << US, 5028, 1, 15800)
(STARFRUIT, MARKET << US, 5028, 1, 15800)","{""AMETHYSTS"": 5, ""STARFRUIT"": 4}",-129,5030,10001
16200,10066,-60188,"(STARFRUIT, MARKET << US, 5033, 1, 16200)
(STARFRUIT, MARKET << US, 5033, 1, 16200)","{""AMETHYSTS"": 5, ""STARFRUIT"": 2}",-122,5033,10000
16700,-10056,-70244,"(STARFRUIT, US << MARKET, 5028, 1, 16700)
(STARFRUIT, US << MARKET, 5028, 1, 16700)","{""AMETHYSTS"": 5, ""STARFRUIT"": 4}",-105,5031,10003
16800,-35109,-105353,"(AMETHYSTS, US << MARKET, 10002, 1, 16800)
(AMETHYSTS, US << MARKET, 10002, 1, 16800)
(STARFRUIT, US << MARKET, 5035, 1, 16800)
(STARFRUIT, US << MARKET, 5035, 1, 16800)
(STARFRUIT, US << MARKET, 5035, 1, 16800)","{""AMETHYSTS"": 7, ""STARFRUIT"": 7}",-143,5031,9999
17100,-5028,-110381,"(STARFRUIT, US << MARKET, 5028, 1, 17100)","{""AMETHYSTS"": 7, ""STARFRUIT"": 8}",-134,5030,10001
17300,-19996,-130377,"(AMETHYSTS, US << MARKET, 9998, 1, 17300)
(AMETHYSTS, US << MARKET, 9998, 1, 17300)","{""AMETHYSTS"": 9, ""STARFRUIT"": 8}",-189,5028,9996
18000,25150,-105227,"(STARFRUIT, MARKET << US, 5030, 1, 18000)
(STARFRUIT, MARKET << US, 5030, 1, 18000)
(STARFRUIT, MARKET << US, 5030, 1, 18000)
(STARFRUIT, MARKET << US, 5030, 1, 18000)
(STARFRUIT, MARKET << US, 5030, 1, 18000)","{""AMETHYSTS"": 9, ""STARFRUIT"": 3}",-125,5031,10001
18200,-10066,-115293,"(STARFRUIT, US << MARKET, 5033, 1, 18200)
(STARFRUIT, US << MARKET, 5033, 1, 18200)","{""AMETHYSTS"": 9, ""STARFRUIT"": 5}",-133,5032,10000
18600,-10002,-125295,"(AMETHYSTS, US << MARKET, 10002, 1, 18600)","{""AMETHYSTS"": 10, ""STARFRUIT"": 5}",-155,5030,9999
18700,25165,-100130,"(STARFRUIT, MARKET << US, 5033, 1, 18700)
(STARFRUIT, MARKET << US, 5033, 1, 18700)
(STARFRUIT, MARKET << US, 5033, 1, 18700)
(STARFRUIT, MARKET << US, 5033, 1, 18700)
(STARFRUIT, MARKET << US, 5033, 1, 18700)","{""AMETHYSTS"": 10, ""STARFRUIT"": 0}",-100,5031,10003
18900,-136,-100266,"(AMETHYSTS, MARKET << US, 10004, 1, 18900)
(AMETHYSTS, MARKET << US, 10004, 1, 18900)
(STARFRUIT, US << MARKET, 5036, 1, 18900)
(STARFRUIT, US << MARKET, 5036, 1, 18900)
(STARFRUIT, US << MARKET, 5036, 1, 18900)
(STARFRUIT, US << MARKET, 5036, 1, 18900)","{""AMETHYSTS"": 8, ""STARFRUIT"": 4}",-134,5033,10000
19000,8,-100258,"(STARFRUIT, US << MARKET, 5030, 1, 19000)
(STARFRUIT, US << MARKET, 5030, 1, 19000)
(STARFRUIT, MARKET << US, 5034, 1, 19000)
(STARFRUIT, MARKET << US, 5034, 1, 19000)","{""AMETHYSTS"": 8, ""STARFRUIT"": 4}",-134,5035,9998
20100,-30074,-130332,"(AMETHYSTS, US << MARKET, 9998, 1, 20100)
(AMETHYSTS, US << MARKET, 9998, 1, 20100)
(STARFRUIT, US << MARKET, 5039, 1, 20100)
(STARFRUIT, US << MARKET, 5039, 1, 20100)
(STARFRUIT, US << MARKET, 5039, 1, 20100)
(STARFRUIT, US << MARKET, 5039, 1, 20100)
(STARFRUIT, MARKET << US, 5039, 1, 20100)
(STARFRUIT, MARKET << US, 5039, 1, 20100)","{""AMETHYSTS"": 10, ""STARFRUIT"": 6}",-106,5036,10001
20500,-20148,-150480,"(STARFRUIT, US << MARKET, 5037, 1, 20500)
(STARFRUIT, US << MARKET, 5037, 1, 20500)
(STARFRUIT, US << MARKET, 5037, 1, 20500)
(STARFRUIT, US << MARKET, 5037, 1, 20500)","{""AMETHYSTS"": 10, ""STARFRUIT"": 10}",-100,5038,10000
20600,-4964,-155444,"(AMETHYSTS, US << MARKET, 10004, 1, 20600)
(STARFRUIT, MARKET << US, 5040, 1, 20600)","{""AMETHYSTS"": 11, ""STARFRUIT"": 9}",-120,5036,10000
20800,5039,-150405,"(STARFRUIT, MARKET << US, 5039, 1, 20800)","{""AMETHYSTS"": 11, ""STARFRUIT"": 8}",-93,5039,10000
20900,-10004,-160409,"(AMETHYSTS, US << MARKET, 10004, 1, 20900)","{""AMETHYSTS"": 12, ""STARFRUIT"": 8}",-113,5037,10000
21100,70,-160339,"(AMETHYSTS, US << MARKET, 9998, 1, 21100)
(AMETHYSTS, US << MARKET, 9998, 1, 21100)
(AMETHYSTS, MARKET << US, 9998, 1, 21100)
(STARFRUIT, MARKET << US, 5034, 1, 21100)
(STARFRUIT, MARKET << US, 5034, 1, 21100)","{""AMETHYSTS"": 13, ""STARFRUIT"": 6}",-104,5037,10001
21600,-4967,-165306,"(AMETHYSTS, US << MARKET, 10002, 1, 21600)
(STARFRUIT, MARKET << US, 5035, 1, 21600)","{""AMETHYSTS"": 14, ""STARFRUIT"": 5}",-74,5038,10003
21900,-76,-165382,"(AMETHYSTS, MARKET << US, 9996, 1, 21900)
(STARFRUIT, US << MARKET, 5036, 1, 21900)
(STARFRUIT, US << MARKET, 5036, 1, 21900)","{""AMETHYSTS"": 13, ""STARFRUIT"": 7}",-109,5039,10000
22000,-25040,-190422,"(AMETHYSTS, US << MARKET, 10000, 1, 22000)
(AMETHYSTS, US << MARKET, 10000, 1, 22000)
(STARFRUIT, US << MARKET, 5038, 1, 22000)
(STARFRUIT, US << MARKET, 5038, 1, 22000)
(STARFRUIT, MARKET << US, 5036, 1, 22000)","{""AMETHYSTS"": 15, ""STARFRUIT"": 8}",-156,5037,9998
22100,15031,-175391,"(AMETHYSTS, MARKET << US, 9996, 1, 22100)
(STARFRUIT, MARKET << US, 5035, 1, 22100)","{""AMETHYSTS"": 14, ""STARFRUIT"": 7}",-125,5038,10000
22400,-30006,-205397,"(AMETHYSTS, US << MARKET, 10002, 1, 22400)
(AMETHYSTS, US << MARKET, 10002, 1, 22400)
(AMETHYSTS, US << MARKET, 10002, 1, 22400)","{""AMETHYSTS"": 17, ""STARFRUIT"": 7}",-73,5039,10003
22500,-20004,-225401,"(AMETHYSTS, US << MARKET, 10002, 1, 22500)
(AMETHYSTS, US << MARKET, 10002, 1, 22500)","{""AMETHYSTS"": 19, ""STARFRUIT"": 7}",-71,5039,10003
22700,-20172,-245573,"(STARFRUIT, US << MARKET, 5043, 1, 22700)
(STARFRUIT, US << MARKET, 5043, 1, 22700)
(STARFRUIT, US << MARKET, 5043, 1, 22700)
(STARFRUIT, US << MARKET, 5043, 1, 22700)","{""AMETHYSTS"": 19, ""STARFRUIT"": 11}",-144,5039,10000
23200,-9998,-255571,"(AMETHYSTS, US << MARKET, 9998, 1, 23200)","{""AMETHYSTS"": 20, ""STARFRUIT"": 11}",-222,5039,9996
23300,-10082,-265653,"(STARFRUIT, US << MARKET, 5041, 1, 23300)
(STARFRUIT, US << MARKET, 5041, 1, 23300)","{""AMETHYSTS"": 20, ""STARFRUIT"": 13}",-159,5038,10000
23700,-20176,-285829,"(STARFRUIT, US << MARKET, 5044, 1, 23700)
(STARFRUIT, US << MARKET, 5044, 1, 23700)
(STARFRUIT, US << MARKET, 5044, 1, 23700)
(STARFRUIT, US << MARKET, 5044, 1, 23700)","{""AMETHYSTS"": 20, ""STARFRUIT"": 17}",-149,5040,10000
23900,5042,-280787,"(STARFRUIT, MARKET << US, 5042, 1, 23900)","{""AMETHYSTS"": 20, ""STARFRUIT"": 16}",-99,5043,10000
24200,0,-280787,,"{""AMETHYSTS"": 20, ""STARFRUIT"": 16}",-79,5043,10001
24300,100020,-180767,"(AMETHYSTS, MARKET << US, 10002, 1, 24300)
(AMETHYSTS, MARKET << US, 10002, 1, 24300)
(AMETHYSTS, MARKET << US, 10002, 1, 24300)
(AMETHYSTS, MARKET << US, 10002, 1, 24300)
(AMETHYSTS, MARKET << US, 10002, 1, 24300)
(AMETHYSTS, MARKET << US, 10002, 1, 24300)
(AMETHYSTS, MARKET << US, 10002, 1, 24300)
(AMETHYSTS, MARKET << US, 10002, 1, 24300)
(AMETHYSTS, MARKET << US, 10002, 1, 24300)
(AMETHYSTS, MARKET << US, 10002, 1, 24300)","{""AMETHYSTS"": 10, ""STARFRUIT"": 16}",-81,5041,10003
24500,-4961,-185728,"(AMETHYSTS, US << MARKET, 9998, 1, 24500)
(AMETHYSTS, US << MARKET, 9998, 1, 24500)
(AMETHYSTS, MARKET << US, 9998, 1, 24500)
(STARFRUIT, MARKET << US, 5037, 1, 24500)","{""AMETHYSTS"": 11, ""STARFRUIT"": 15}",-157,5041,9996
24700,-15048,-200776,"(AMETHYSTS, US << MARKET, 10004, 1, 24700)
(STARFRUIT, US << MARKET, 5044, 1, 24700)","{""AMETHYSTS"": 12, ""STARFRUIT"": 16}",-136,5040,10000
25100,-9924,-210700,"(AMETHYSTS, US << MARKET, 10005, 1, 25100)
(AMETHYSTS, US << MARKET, 10005, 1, 25100)
(STARFRUIT, MARKET << US, 5043, 1, 25100)
(STARFRUIT, MARKET << US, 5043, 1, 25100)","{""AMETHYSTS"": 14, ""STARFRUIT"": 14}",-154,5039,10000
25300,-14956,-225656,"(AMETHYSTS, US << MARKET, 9996, 1, 25300)
(AMETHYSTS, US << MARKET, 9996, 1, 25300)
(STARFRUIT, MARKET << US, 5036, 1, 25300)","{""AMETHYSTS"": 16, ""STARFRUIT"": 13}",-165,5039,9999
25400,25050,-200606,"(AMETHYSTS, MARKET << US, 10004, 1, 25400)
(AMETHYSTS, MARKET << US, 10004, 1, 25400)
(STARFRUIT, MARKET << US, 5042, 1, 25400)","{""AMETHYSTS"": 14, ""STARFRUIT"": 12}",-136,5038,10001
26500,50096,-150510,"(AMETHYSTS, MARKET << US, 10002, 1, 26500)
(AMETHYSTS, MARKET << US, 10002, 1, 26500)
(AMETHYSTS, MARKET << US, 10002, 1, 26500)
(AMETHYSTS, MARKET << US, 10002, 1, 26500)
(STARFRUIT, MARKET << US, 5044, 1, 26500)
(STARFRUIT, MARKET << US, 5044, 1, 26500)","{""AMETHYSTS"": 10, ""STARFRUIT"": 10}",-90,5043,9999
26600,60012,-90498,"(AMETHYSTS, MARKET << US, 10002, 1, 26600)
(AMETHYSTS, MARKET << US, 10002, 1, 26600)
(AMETHYSTS, MARKET << US, 10002, 1, 26600)
(AMETHYSTS, MARKET << US, 10002, 1, 26600)
(AMETHYSTS, MARKET << US, 10002, 1, 26600)
(AMETHYSTS, MARKET << US, 10002, 1, 26600)","{""AMETHYSTS"": 4, ""STARFRUIT"": 10}",-86,5040,10003
26700,10082,-80416,"(STARFRUIT, MARKET << US, 5041, 1, 26700)
(STARFRUIT, MARKET << US, 5041, 1, 26700)","{""AMETHYSTS"": 4, ""STARFRUIT"": 8}",-124,5038,9997
26900,-19996,-100412,"(AMETHYSTS, US << MARKET, 9998, 1, 26900)
(AMETHYSTS, US << MARKET, 9998, 1, 26900)","{""AMETHYSTS"": 6, ""STARFRUIT"": 8}",-116,5040,9996
27400,20008,-80404,"(AMETHYSTS, MARKET << US, 10004, 1, 27400)
(AMETHYSTS, MARKET << US, 10004, 1, 27400)","{""AMETHYSTS"": 4, ""STARFRUIT"": 8}",-92,5039,10000
27600,9998,-70406,"(AMETHYSTS, MARKET << US, 9998, 1, 27600)","{""AMETHYSTS"": 3, ""STARFRUIT"": 8}",-87,5041,9997
27700,-15126,-85532,"(AMETHYSTS, US << MARKET, 9996, 1, 27700)
(AMETHYSTS, US << MARKET, 9996, 1, 27700)
(AMETHYSTS, US << MARKET, 9996, 1, 27700)
(AMETHYSTS, US << MARKET, 9996, 1, 27700)
(AMETHYSTS, MARKET << US, 9996, 1, 27700)
(AMETHYSTS, MARKET << US, 9996, 1, 27700)
(AMETHYSTS, MARKET << US, 9996, 1, 27700)
(AMETHYSTS, MARKET << US, 9996, 1, 27700)
(STARFRUIT, US << MARKET, 5042, 1, 27700)
(STARFRUIT, US << MARKET, 5042, 1, 27700)
(STARFRUIT, US << MARKET, 5042, 1, 27700)","{""AMETHYSTS"": 3, ""STARFRUIT"": 11}",-59,5043,10000
27900,39992,-45540,"(AMETHYSTS, MARKET << US, 9998, 1, 27900)
(AMETHYSTS, MARKET << US, 9998, 1, 27900)
(AMETHYSTS, MARKET << US, 9998, 1, 27900)
(AMETHYSTS, MARKET << US, 9998, 1, 27900)","{""AMETHYSTS"": -1, ""STARFRUIT"": 11}",-75,5042,9997
28000,-4957,-50497,"(AMETHYSTS, US << MARKET, 10002, 1, 28000)
(STARFRUIT, MARKET << US, 5045, 1, 28000)","{""AMETHYSTS"": 0, ""STARFRUIT"": 10}",-87,5041,9998
28100,-86,-50583,"(AMETHYSTS, MARKET << US, 9995, 1, 28100)
(STARFRUIT, US << MARKET, 5040, 1, 28100)
(STARFRUIT, US << MARKET, 5040, 1, 28100)
(STARFRUIT, US << MARKET, 5040, 1, 28100)
(STARFRUIT, MARKET << US, 5039, 1, 28100)","{""AMETHYSTS"": -1, ""STARFRUIT"": 12}",-115,5039,10000
28600,5039,-45544,"(STARFRUIT, MARKET << US, 5039, 1, 28600)","{""AMETHYSTS"": -1, ""STARFRUIT"": 11}",-94,5041,10001
28700,-159936,-205480,"(AMETHYSTS, US << MARKET, 9996, 1, 28700)
(AMETHYSTS, US << MARKET, 9996, 1, 28700)
(AMETHYSTS, US << MARKET, 9996, 1, 28700)
(AMETHYSTS, US << MARKET, 9996, 1, 28700)
(AMETHYSTS, US << MARKET, 9996, 1, 28700)
(AMETHYSTS, US << MARKET, 9996, 1, 28700)
(AMETHYSTS, US << MARKET, 9996, 1, 28700)
(AMETHYSTS, US << MARKET, 9996, 1, 28700)
(AMETHYSTS, US << MARKET, 9996, 1, 28700)
(AMETHYSTS, US << MARKET, 9996, 1, 28700)
(AMETHYSTS, US << MARKET, 9996, 1, 28700)
(AMETHYSTS, US << MARKET, 9996, 1, 28700)
(AMETHYSTS, US << MARKET, 9996, 1, 28700)
(AMETHYSTS, US << MARKET, 9996, 1, 28700)
(AMETHYSTS, US << MARKET, 9996, 1, 28700)
(AMETHYSTS, US << MARKET, 9996, 1, 28700)","{""AMETHYSTS"": 15, ""STARFRUIT"": 11}",-18,5042,10000
29000,25056,-180424,"(AMETHYSTS, MARKET << US, 10005, 1, 29000)
(AMETHYSTS, MARKET << US, 10005, 1, 29000)
(STARFRUIT, MARKET << US, 5046, 1, 29000)","{""AMETHYSTS"": 13, ""STARFRUIT"": 10}",-4,5042,10000
29200,10002,-170422,"(AMETHYSTS, US << MARKET, 10002, 1, 29200)
(AMETHYSTS, MARKET << US, 10002, 1, 29200)
(AMETHYSTS, MARKET << US, 10002, 1, 29200)","{""AMETHYSTS"": 12, ""STARFRUIT"": 10}",-36,5041,9998
29300,5040,-165382,"(STARFRUIT, MARKET << US, 5040, 1, 29300)","{""AMETHYSTS"": 12, ""STARFRUIT"": 9}",5,5043,10000
29900,110274,-55108,"(AMETHYSTS, MARKET << US, 10002, 1, 29900)
(AMETHYSTS, MARKET << US, 10002, 1, 29900)
(AMETHYSTS, MARKET << US, 10002, 1, 29900)
(AMETHYSTS, MARKET << US, 10002, 1, 29900)
(AMETHYSTS, MARKET << US, 10002, 1, 29900)
(AMETHYSTS, MARKET << US, 10002, 1, 29900)
(AMETHYSTS, MARKET << US, 10002, 1, 29900)
(AMETHYSTS, MARKET << US, 10002, 1, 29900)
(STARFRUIT, MARKET << US, 5043, 1, 29900)
(STARFRUIT, MARKET << US, 5043, 1, 29900)
(STARFRUIT, MARKET << US, 5043, 1, 29900)
(STARFRUIT, MARKET << US, 5043, 1, 29900)
(STARFRUIT, MARKET << US, 5043, 1, 29900)
(STARFRUIT, MARKET << US, 5043, 1, 29900)","{""AMETHYSTS"": 4, ""STARFRUIT"": 3}",11,5041,9999
30000,-10092,-65200,"(STARFRUIT, US << MARKET, 5046, 1, 30000)
(STARFRUIT, US << MARKET, 5046, 1, 30000)","{""AMETHYSTS"": 4, ""STARFRUIT"": 5}",26,5046,9999
30100,25225,-39975,"(STARFRUIT, MARKET << US, 5045, 1, 30100)
(STARFRUIT, MARKET << US, 5045, 1, 30100)
(STARFRUIT, MARKET << US, 5045, 1, 30100)
(STARFRUIT, MARKET << US, 5045, 1, 30100)
(STARFRUIT, MARKET << US, 5045, 1, 30100)","{""AMETHYSTS"": 4, ""STARFRUIT"": 0}",13,5042,9997
30700,5040,-34935,"(STARFRUIT, MARKET << US, 5040, 1, 30700)","{""AMETHYSTS"": 4, ""STARFRUIT"": -1}",26,5039,10000
31200,-10076,-45011,"(STARFRUIT, US << MARKET, 5038, 1, 31200)
(STARFRUIT, US << MARKET, 5038, 1, 31200)","{""AMETHYSTS"": 4, ""STARFRUIT"": 1}",30,5041,10000
31500,5038,-39973,"(STARFRUIT, MARKET << US, 5038, 1, 31500)","{""AMETHYSTS"": 4, ""STARFRUIT"": 0}",27,5040,10000
31700,-90074,-130047,"(AMETHYSTS, US << MARKET, 9998, 1, 31700)
(AMETHYSTS, US << MARKET, 9998, 1, 31700)
(AMETHYSTS, US << MARKET, 9998, 1, 31700)
(AMETHYSTS, US << MARKET, 9998, 1, 31700)
(AMETHYSTS, US << MARKET, 9998, 1, 31700)
(AMETHYSTS, US << MARKET, 9998, 1, 31700)
(AMETHYSTS, US << MARKET, 9998, 1, 31700)
(AMETHYSTS, US << MARKET, 9998, 1, 31700)
(STARFRUIT, US << MARKET, 5045, 1, 31700)
(STARFRUIT, US << MARKET, 5045, 1, 31700)","{""AMETHYSTS"": 12, ""STARFRUIT"": 2}",-13,5041,9996
32000,-10002,-140049,"(AMETHYSTS, US << MARKET, 10002, 1, 32000)","{""AMETHYSTS"": 13, ""STARFRUIT"": 2}",3,5039,9998
32200,5043,-135006,"(STARFRUIT, MARKET << US, 5043, 1, 32200)","{""AMETHYSTS"": 13, ""STARFRUIT"": 1}",24,5043,9999
32300,20004,-115002,"(AMETHYSTS, MARKET << US, 10002, 1, 32300)
(AMETHYSTS, MARKET << US, 10002, 1, 32300)","{""AMETHYSTS"": 11, ""STARFRUIT"": 1}",28,5041,9999
32700,20004,-94998,"(AMETHYSTS, MARKET << US, 10002, 1, 32700)
(AMETHYSTS, MARKET << US, 10002, 1, 32700)","{""AMETHYSTS"": 9, ""STARFRUIT"": 1}",70,5041,10003
32800,15117,-79881,"(STARFRUIT, MARKET << US, 5039, 1, 32800)
(STARFRUIT, MARKET << US, 5039, 1, 32800)
(STARFRUIT, MARKET << US, 5039, 1, 32800)","{""AMETHYSTS"": 9, ""STARFRUIT"": -2}",43,5038,10000
33600,5037,-74844,"(STARFRUIT, MARKET << US, 5037, 1, 33600)","{""AMETHYSTS"": 9, ""STARFRUIT"": -3}",36,5040,10000
33700,-19996,-94840,"(AMETHYSTS, US << MARKET, 9998, 1, 33700)
(AMETHYSTS, US << MARKET, 9998, 1, 33700)","{""AMETHYSTS"": 11, ""STARFRUIT"": -3}",51,5040,10001
33800,-10002,-104842,"(AMETHYSTS, US << MARKET, 10002, 1, 33800)","{""AMETHYSTS"": 12, ""STARFRUIT"": -3}",77,5039,10003
33900,50104,-54738,"(AMETHYSTS, MARKET << US, 10005, 1, 33900)
(AMETHYSTS, MARKET << US, 10005, 1, 33900)
(AMETHYSTS, MARKET << US, 10005, 1, 33900)
(AMETHYSTS, MARKET << US, 10005, 1, 33900)
(STARFRUIT, MARKET << US, 5042, 1, 33900)
(STARFRUIT, MARKET << US, 5042, 1, 33900)","{""AMETHYSTS"": 8, ""STARFRUIT"": -5}",67,5039,10000
34200,-90114,-144852,"(AMETHYSTS, US << MARKET, 9995, 1, 34200)
(AMETHYSTS, US << MARKET, 9995, 1, 34200)
(AMETHYSTS, US << MARKET, 9995, 1, 34200)
(AMETHYSTS, US << MARKET, 9995, 1, 34200)
(AMETHYSTS, US << MARKET, 9995, 1, 34200)
(AMETHYSTS, US << MARKET, 9995, 1, 34200)
(AMETHYSTS, US << MARKET, 9996, 1, 34200)
(AMETHYSTS, US << MARKET, 9996, 1, 34200)
(AMETHYSTS, MARKET << US, 9996, 1, 34200)
(STARFRUIT, US << MARKET, 5037, 1, 34200)
(STARFRUIT, US << MARKET, 5037, 1, 34200)
(STARFRUIT, US << MARKET, 5037, 1, 34200)
(STARFRUIT, US << MARKET, 5037, 1, 34200)","{""AMETHYSTS"": 15, ""STARFRUIT"": -1}",108,5040,10000
34300,15108,-129744,"(STARFRUIT, MARKET << US, 5036, 1, 34300)
(STARFRUIT, MARKET << US, 5036, 1, 34300)
(STARFRUIT, MARKET << US, 5036, 1, 34300)","{""AMETHYSTS"": 15, ""STARFRUIT"": -4}",100,5039,10000
34400,5037,-124707,"(STARFRUIT, MARKET << US, 5037, 1, 34400)","{""AMETHYSTS"": 15, ""STARFRUIT"": -5}",113,5036,10000
34700,-49990,-174697,"(AMETHYSTS, US << MARKET, 9998, 1, 34700)
(AMETHYSTS, US << MARKET, 9998, 1, 34700)
(AMETHYSTS, US << MARKET, 9998, 1, 34700)
(AMETHYSTS, US << MARKET, 9998, 1, 34700)
(AMETHYSTS, US << MARKET, 9998, 1, 34700)","{""AMETHYSTS"": 20, ""STARFRUIT"": -5}",28,5039,9996
34800,20004,-154693,"(AMETHYSTS, MARKET << US, 10002, 1, 34800)
(AMETHYSTS, MARKET << US, 10002, 1, 34800)","{""AMETHYSTS"": 18, ""STARFRUIT"": -5}",156,5041,10003
34900,5037,-149656,"(STARFRUIT, MARKET << US, 5037, 1, 34900)","{""AMETHYSTS"": 18, ""STARFRUIT"": -6}",104,5040,10000
35200,-10074,-159730,"(STARFRUIT, US << MARKET, 5037, 1, 35200)
(STARFRUIT, US << MARKET, 5037, 1, 35200)","{""AMETHYSTS"": 18, ""STARFRUIT"": -4}",114,5039,10000
35500,-10074,-169804,"(STARFRUIT, US << MARKET, 5037, 1, 35500)
(STARFRUIT, US << MARKET, 5037, 1, 35500)","{""AMETHYSTS"": 18, ""STARFRUIT"": -2}",170,5040,10003
35600,5038,-164766,"(STARFRUIT, MARKET << US, 5038, 1, 35600)","{""AMETHYSTS"": 18, ""STARFRUIT"": -3}",132,5040,10001
35700,40008,-124758,"(AMETHYSTS, MARKET << US, 10002, 1, 35700)
(AMETHYSTS, MARKET << US, 10002, 1, 35700)
(AMETHYSTS, MARKET << US, 10002, 1, 35700)
(AMETHYSTS, MARKET << US, 10002, 1, 35700)","{""AMETHYSTS"": 14, ""STARFRUIT"": -3}",164,5040,10003
35900,5041,-119717,"(STARFRUIT, MARKET << US, 5041, 1, 35900)","{""AMETHYSTS"": 14, ""STARFRUIT"": -4}",117,5038,9999
36000,9998,-109719,"(AMETHYSTS, MARKET << US, 9998, 1, 36000)","{""AMETHYSTS"": 13, ""STARFRUIT"": -4}",73,5039,9996
36500,9996,-99723,"(AMETHYSTS, MARKET << US, 9996, 1, 36500)","{""AMETHYSTS"": 12, ""STARFRUIT"": -4}",113,5038,9999
36700,9934,-89789,"(AMETHYSTS, MARKET << US, 10002, 1, 36700)
(AMETHYSTS, MARKET << US, 10002, 1, 36700)
(STARFRUIT, US << MARKET, 5035, 1, 36700)
(STARFRUIT, US << MARKET, 5035, 1, 36700)","{""AMETHYSTS"": 10, ""STARFRUIT"": -2}",165,5038,10003
36800,-40242,-130031,"(AMETHYSTS, US << MARKET, 10002, 1, 36800)
(STARFRUIT, US << MARKET, 5040, 1, 36800)
(STARFRUIT, US << MARKET, 5040, 1, 36800)
(STARFRUIT, US << MARKET, 5040, 1, 36800)
(STARFRUIT, US << MARKET, 5040, 1, 36800)
(STARFRUIT, US << MARKET, 5040, 1, 36800)
(STARFRUIT, US << MARKET, 5040, 1, 36800)","{""AMETHYSTS"": 11, ""STARFRUIT"": 4}",166,5041,10003
37100,5041,-124990,"(STARFRUIT, MARKET << US, 5041, 1, 37100)","{""AMETHYSTS"": 11, ""STARFRUIT"": 3}",133,5041,10000
37200,9998,-114992,"(AMETHYSTS, MARKET << US, 9998, 1, 37200)","{""AMETHYSTS"": 10, ""STARFRUIT"": 3}",135,5039,10001
37300,-90018,-205010,"(AMETHYSTS, US << MARKET, 10002, 1, 37300)
(AMETHYSTS, US << MARKET, 10002, 1, 37300)
(AMETHYSTS, US << MARKET, 10002, 1, 37300)
(AMETHYSTS, US << MARKET, 10002, 1, 37300)
(AMETHYSTS, US << MARKET, 10002, 1, 37300)
(AMETHYSTS, US << MARKET, 10002, 1, 37300)
(AMETHYSTS, US << MARKET, 10002, 1, 37300)
(AMETHYSTS, US << MARKET, 10002, 1, 37300)
(AMETHYSTS, US << MARKET, 10002, 1, 37300)","{""AMETHYSTS"": 19, ""STARFRUIT"": 3}",167,5040,10003
37400,5038,-199972,"(STARFRUIT, MARKET << US, 5038, 1, 37400)","{""AMETHYSTS"": 19, ""STARFRUIT"": 2}",110,5041,10000
37700,5042,-194930,"(STARFRUIT, MARKET << US, 5042, 1, 37700)","{""AMETHYSTS"": 19, ""STARFRUIT"": 1}",112,5042,10000
37900,-10086,-205016,"(STARFRUIT, US << MARKET, 5043, 1, 37900)
(STARFRUIT, US << MARKET, 5043, 1, 37900)","{""AMETHYSTS"": 19, ""STARFRUIT"": 3}",60,5038,9998
38100,5038,-199978,"(STARFRUIT, MARKET << US, 5038, 1, 38100)","{""AMETHYSTS"": 19, ""STARFRUIT"": 2}",104,5041,10000
38200,9998,-189980,"(AMETHYSTS, US << MARKET, 9998, 1, 38200)
(AMETHYSTS, MARKET << US, 9998, 1, 38200)
(AMETHYSTS, MARKET << US, 9998, 1, 38200)","{""AMETHYSTS"": 18, ""STARFRUIT"": 2}",30,5041,9996
38400,-10078,-200058,"(STARFRUIT, US << MARKET, 5039, 1, 38400)
(STARFRUIT, US << MARKET, 5039, 1, 38400)","{""AMETHYSTS"": 18, ""STARFRUIT"": 4}",164,5042,10003
38500,9916,-190142,"(AMETHYSTS, MARKET << US, 10002, 1, 38500)
(AMETHYSTS, MARKET << US, 10002, 1, 38500)
(STARFRUIT, US << MARKET, 5044, 1, 38500)
(STARFRUIT, US << MARKET, 5044, 1, 38500)","{""AMETHYSTS"": 16, ""STARFRUIT"": 6}",170,5044,10003
38600,100020,-90122,"(AMETHYSTS, MARKET << US, 10002, 1, 38600)
(AMETHYSTS, MARKET << US, 10002, 1, 38600)
(AMETHYSTS, MARKET << US, 10002, 1, 38600)
(AMETHYSTS, MARKET << US, 10002, 1, 38600)
(AMETHYSTS, MARKET << US, 10002, 1, 38600)
(AMETHYSTS, MARKET << US, 10002, 1, 38600)
(AMETHYSTS, MARKET << US, 10002, 1, 38600)
(AMETHYSTS, MARKET << US, 10002, 1, 38600)
(AMETHYSTS, MARKET << US, 10002, 1, 38600)
(AMETHYSTS, MARKET << US, 10002, 1, 38600)","{""AMETHYSTS"": 6, ""STARFRUIT"": 6}",142,5041,10003
38800,20168,-69954,"(STARFRUIT, MARKET << US, 5042, 1, 38800)
(STARFRUIT, MARKET << US, 5042, 1, 38800)
(STARFRUIT, MARKET << US, 5042, 1, 38800)
(STARFRUIT, MARKET << US, 5042, 1, 38800)","{""AMETHYSTS"": 6, ""STARFRUIT"": 2}",132,5043,10000
38900,80016,10062,"(AMETHYSTS, MARKET << US, 10002, 1, 38900)
(AMETHYSTS, MARKET << US, 10002, 1, 38900)
(AMETHYSTS, MARKET << US, 10002, 1, 38900)
(AMETHYSTS, MARKET << US, 10002, 1, 38900)
(AMETHYSTS, MARKET << US, 10002, 1, 38900)
(AMETHYSTS, MARKET << US, 10002, 1, 38900)
(AMETHYSTS, MARKET << US, 10002, 1, 38900)
(AMETHYSTS, MARKET << US, 10002, 1, 38900)","{""AMETHYSTS"": -2, ""STARFRUIT"": 2}",142,5040,10000
39400,25052,35114,"(AMETHYSTS, MARKET << US, 10004, 1, 39400)
(AMETHYSTS, MARKET << US, 10004, 1, 39400)
(STARFRUIT, MARKET << US, 5044, 1, 39400)","{""AMETHYSTS"": -4, ""STARFRUIT"": 1}",155,5041,10000
39600,14830,49944,"(AMETHYSTS, MARKET << US, 10005, 1, 39600)
(AMETHYSTS, MARKET << US, 10005, 1, 39600)
(AMETHYSTS, MARKET << US, 10005, 1, 39600)
(AMETHYSTS, MARKET << US, 10005, 1, 39600)
(STARFRUIT, US << MARKET, 5038, 1, 39600)
(STARFRUIT, US << MARKET, 5038, 1, 39600)
(STARFRUIT, US << MARKET, 5038, 1, 39600)
(STARFRUIT, US << MARKET, 5038, 1, 39600)
(STARFRUIT, US << MARKET, 5038, 1, 39600)","{""AMETHYSTS"": -8, ""STARFRUIT"": 6}",190,5041,10000
39700,49980,99924,"(AMETHYSTS, US << MARKET, 9995, 1, 39700)
(AMETHYSTS, US << MARKET, 9995, 1, 39700)
(AMETHYSTS, US << MARKET, 9995, 1, 39700)
(AMETHYSTS, US << MARKET, 9995, 1, 39700)
(AMETHYSTS, US << MARKET, 10005, 1, 39700)
(AMETHYSTS, MARKET << US, 10005, 1, 39700)
(AMETHYSTS, MARKET << US, 10005, 1, 39700)
(AMETHYSTS, MARKET << US, 10005, 1, 39700)
(AMETHYSTS, MARKET << US, 10005, 1, 39700)
(AMETHYSTS, MARKET << US, 10005, 1, 39700)
(AMETHYSTS, MARKET << US, 10005, 1, 39700)
(AMETHYSTS, MARKET << US, 10005, 1, 39700)
(AMETHYSTS, MARKET << US, 10005, 1, 39700)
(AMETHYSTS, MARKET << US, 10005, 1, 39700)
(AMETHYSTS, MARKET << US, 10005, 1, 39700)
(AMETHYSTS, MARKET << US, 10005, 1, 39700)
(STARFRUIT, US << MARKET, 5045, 1, 39700)
(STARFRUIT, US << MARKET, 5045, 1, 39700)","{""AMETHYSTS"": -14, ""STARFRUIT"": 8}",252,5041,10000
40100,20004,119928,"(AMETHYSTS, MARKET << US, 10002, 1, 40100)
(AMETHYSTS, MARKET << US, 10002, 1, 40100)","{""AMETHYSTS"": -16, ""STARFRUIT"": 8}",200,5040,10003
40300,-99796,20132,"(AMETHYSTS, US << MARKET, 9996, 1, 40300)
(AMETHYSTS, US << MARKET, 9996, 1, 40300)
(AMETHYSTS, US << MARKET, 9996, 1, 40300)
(AMETHYSTS, US << MARKET, 9996, 1, 40300)
(AMETHYSTS, US << MARKET, 9996, 1, 40300)
(AMETHYSTS, US << MARKET, 9996, 1, 40300)
(AMETHYSTS, US << MARKET, 9996, 1, 40300)
(AMETHYSTS, US << MARKET, 9996, 1, 40300)
(AMETHYSTS, US << MARKET, 9996, 1, 40300)
(AMETHYSTS, US << MARKET, 9996, 1, 40300)
(AMETHYSTS, US << MARKET, 9996, 1, 40300)
(AMETHYSTS, US << MARKET, 9996, 1, 40300)
(STARFRUIT, MARKET << US, 5039, 1, 40300)
(STARFRUIT, MARKET << US, 5039, 1, 40300)
(STARFRUIT, MARKET << US, 5039, 1, 40300)
(STARFRUIT, MARKET << US, 5039, 1, 40300)","{""AMETHYSTS"": -4, ""STARFRUIT"": 4}",292,5038,9998
40800,20180,40312,"(STARFRUIT, MARKET << US, 5045, 1, 40800)
(STARFRUIT, MARKET << US, 5045, 1, 40800)
(STARFRUIT, MARKET << US, 5045, 1, 40800)
(STARFRUIT, MARKET << US, 5045, 1, 40800)","{""AMETHYSTS"": -4, ""STARFRUIT"": 0}",312,5041,10000
41200,15129,55441,"(STARFRUIT, MARKET << US, 5043, 1, 41200)
(STARFRUIT, MARKET << US, 5043, 1, 41200)
(STARFRUIT, MARKET << US, 5043, 1, 41200)","{""AMETHYSTS"": -4, ""STARFRUIT"": -3}",321,5044,9997
41400,10078,65519,"(STARFRUIT, MARKET << US, 5039, 1, 41400)
(STARFRUIT, MARKET << US, 5039, 1, 41400)","{""AMETHYSTS"": -4, ""STARFRUIT"": -5}",309,5042,10000
41500,-40156,25363,"(AMETHYSTS, US << MARKET, 9998, 1, 41500)
(AMETHYSTS, US << MARKET, 9998, 1, 41500)
(STARFRUIT, US << MARKET, 5040, 1, 41500)
(STARFRUIT, US << MARKET, 5040, 1, 41500)
(STARFRUIT, US << MARKET, 5040, 1, 41500)
(STARFRUIT, US << MARKET, 5040, 1, 41500)","{""AMETHYSTS"": -2, ""STARFRUIT"": -1}",322,5039,10001
41900,-20156,5207,"(STARFRUIT, US << MARKET, 5039, 1, 41900)
(STARFRUIT, US << MARKET, 5039, 1, 41900)
(STARFRUIT, US << MARKET, 5039, 1, 41900)
(STARFRUIT, US << MARKET, 5039, 1, 41900)","{""AMETHYSTS"": -2, ""STARFRUIT"": 3}",319,5038,10001
42200,30068,35275,"(AMETHYSTS, MARKET << US, 9995, 1, 42200)
(AMETHYSTS, MARKET << US, 9995, 1, 42200)
(STARFRUIT, MARKET << US, 5039, 1, 42200)
(STARFRUIT, MARKET << US, 5039, 1, 42200)","{""AMETHYSTS"": -4, ""STARFRUIT"": 1}",325,5042,9998
42300,-4965,30310,"(AMETHYSTS, US << MARKET, 10005, 1, 42300)
(STARFRUIT, US << MARKET, 5046, 1, 42300)
(STARFRUIT, US << MARKET, 5046, 1, 42300)
(STARFRUIT, MARKET << US, 5044, 1, 42300)
(STARFRUIT, MARKET << US, 5044, 1, 42300)
(STARFRUIT, MARKET << US, 5044, 1, 42300)","{""AMETHYSTS"": -3, ""STARFRUIT"": 0}",304,5043,10002
42500,-10076,20234,"(STARFRUIT, US << MARKET, 5038, 1, 42500)
(STARFRUIT, US << MARKET, 5038, 1, 42500)","{""AMETHYSTS"": -3, ""STARFRUIT"": 2}",314,5040,10000
42700,-10076,10158,"(STARFRUIT, US << MARKET, 5038, 1, 42700)
(STARFRUIT, US << MARKET, 5038, 1, 42700)","{""AMETHYSTS"": -3, ""STARFRUIT"": 4}",322,5041,10000
43200,80,10238,"(AMETHYSTS, US << MARKET, 10002, 1, 43200)
(STARFRUIT, MARKET << US, 5041, 1, 43200)
(STARFRUIT, MARKET << US, 5041, 1, 43200)","{""AMETHYSTS"": -2, ""STARFRUIT"": 2}",320,5039,9998
43400,-10074,164,"(STARFRUIT, US << MARKET, 5037, 1, 43400)
(STARFRUIT, US << MARKET, 5037, 1, 43400)","{""AMETHYSTS"": -2, ""STARFRUIT"": 4}",326,5040,9999
43800,9998,10162,"(AMETHYSTS, MARKET << US, 9998, 1, 43800)","{""AMETHYSTS"": -3, ""STARFRUIT"": 4}",330,5039,9996
44000,-40008,-29846,"(AMETHYSTS, US << MARKET, 10002, 1, 44000)
(AMETHYSTS, US << MARKET, 10002, 1, 44000)
(AMETHYSTS, US << MARKET, 10002, 1, 44000)
(AMETHYSTS, US << MARKET, 10002, 1, 44000)","{""AMETHYSTS"": 1, ""STARFRUIT"": 4}",313,5039,10003
44100,-152,-29998,"(AMETHYSTS, MARKET << US, 9996, 1, 44100)
(AMETHYSTS, MARKET << US, 9996, 1, 44100)
(STARFRUIT, US << MARKET, 5036, 1, 44100)
(STARFRUIT, US << MARKET, 5036, 1, 44100)
(STARFRUIT, US << MARKET, 5036, 1, 44100)
(STARFRUIT, US << MARKET, 5036, 1, 44100)","{""AMETHYSTS"": -1, ""STARFRUIT"": 8}",314,5039,10000
44200,-39992,-69990,"(AMETHYSTS, US << MARKET, 9998, 1, 44200)
(AMETHYSTS, US << MARKET, 9998, 1, 44200)
(AMETHYSTS, US << MARKET, 9998, 1, 44200)
(AMETHYSTS, US << MARKET, 9998, 1, 44200)","{""AMETHYSTS"": 3, ""STARFRUIT"": 8}",325,5039,10001
44500,15032,-54958,"(AMETHYSTS, MARKET << US, 9996, 1, 44500)
(STARFRUIT, MARKET << US, 5036, 1, 44500)","{""AMETHYSTS"": 2, ""STARFRUIT"": 7}",315,5039,10000
44700,-14954,-69912,"(AMETHYSTS, US << MARKET, 9996, 1, 44700)
(AMETHYSTS, US << MARKET, 9996, 1, 44700)
(STARFRUIT, MARKET << US, 5038, 1, 44700)","{""AMETHYSTS"": 4, ""STARFRUIT"": 6}",330,5041,9999
44900,25205,-44707,"(STARFRUIT, MARKET << US, 5041, 1, 44900)
(STARFRUIT, MARKET << US, 5041, 1, 44900)
(STARFRUIT, MARKET << US, 5041, 1, 44900)
(STARFRUIT, MARKET << US, 5041, 1, 44900)
(STARFRUIT, MARKET << US, 5041, 1, 44900)","{""AMETHYSTS"": 4, ""STARFRUIT"": 1}",327,5042,9998
45100,-15187,-59894,"(AMETHYSTS, MARKET << US, 9998, 1, 45100)
(STARFRUIT, US << MARKET, 5037, 1, 45100)
(STARFRUIT, US << MARKET, 5037, 1, 45100)
(STARFRUIT, US << MARKET, 5037, 1, 45100)
(STARFRUIT, US << MARKET, 5037, 1, 45100)
(STARFRUIT, US << MARKET, 5037, 1, 45100)","{""AMETHYSTS"": 3, ""STARFRUIT"": 6}",337,5040,9997
45300,5224,-54670,"(AMETHYSTS, US << MARKET, 9998, 1, 45300)
(AMETHYSTS, US << MARKET, 9998, 1, 45300)
(STARFRUIT, MARKET << US, 5044, 1, 45300)
(STARFRUIT, MARKET << US, 5044, 1, 45300)
(STARFRUIT, MARKET << US, 5044, 1, 45300)
(STARFRUIT, MARKET << US, 5044, 1, 45300)
(STARFRUIT, MARKET << US, 5044, 1, 45300)","{""AMETHYSTS"": 5, ""STARFRUIT"": 1}",355,5040,9997
45600,5042,-49628,"(STARFRUIT, MARKET << US, 5042, 1, 45600)","{""AMETHYSTS"": 5, ""STARFRUIT"": 0}",372,5039,10000
46000,-99978,-149606,"(AMETHYSTS, US << MARKET, 9996, 1, 46000)
(AMETHYSTS, US << MARKET, 9996, 1, 46000)
(AMETHYSTS, US << MARKET, 9998, 1, 46000)
(AMETHYSTS, US << MARKET, 9998, 1, 46000)
(AMETHYSTS, US << MARKET, 9998, 1, 46000)
(AMETHYSTS, US << MARKET, 9998, 1, 46000)
(AMETHYSTS, US << MARKET, 9996, 1, 46000)
(AMETHYSTS, US << MARKET, 9998, 1, 46000)
(AMETHYSTS, US << MARKET, 9998, 1, 46000)
(AMETHYSTS, US << MARKET, 9998, 1, 46000)
(AMETHYSTS, US << MARKET, 9998, 1, 46000)
(AMETHYSTS, US << MARKET, 9998, 1, 46000)
(AMETHYSTS, MARKET << US, 9996, 1, 46000)
(AMETHYSTS, MARKET << US, 9996, 1, 46000)","{""AMETHYSTS"": 15, ""STARFRUIT"": 0}",349,5040,9997
46100,5038,-144568,"(STARFRUIT, MARKET << US, 5038, 1, 46100)","{""AMETHYSTS"": 15, ""STARFRUIT"": -1}",391,5041,10000
46200,-20174,-164742,"(STARFRUIT, US << MARKET, 5043, 1, 46200)
(STARFRUIT, US << MARKET, 5043, 1, 46200)
(STARFRUIT, US << MARKET, 5043, 1, 46200)
(STARFRUIT, US << MARKET, 5043, 1, 46200)
(STARFRUIT, US << MARKET, 5043, 1, 46200)
(STARFRUIT, US << MARKET, 5043, 1, 46200)
(STARFRUIT, MARKET << US, 5042, 1, 46200)
(STARFRUIT, MARKET << US, 5042, 1, 46200)","{""AMETHYSTS"": 15, ""STARFRUIT"": 3}",390,5044,10000
46300,5044,-159698,"(STARFRUIT, MARKET << US, 5044, 1, 46300)","{""AMETHYSTS"": 15, ""STARFRUIT"": 2}",384,5041,10000
46400,-25215,-184913,"(STARFRUIT, US << MARKET, 5043, 1, 46400)
(STARFRUIT, US << MARKET, 5043, 1, 46400)
(STARFRUIT, US << MARKET, 5043, 1, 46400)
(STARFRUIT, US << MARKET, 5043, 1, 46400)
(STARFRUIT, US << MARKET, 5043, 1, 46400)","{""AMETHYSTS"": 15, ""STARFRUIT"": 7}",395,5044,10000
46500,-5038,-189951,"(STARFRUIT, US << MARKET, 5038, 1, 46500)","{""AMETHYSTS"": 15, ""STARFRUIT"": 8}",362,5041,9999
46800,-40156,-230107,"(AMETHYSTS, US << MARKET, 9998, 1, 46800)
(AMETHYSTS, US << MARKET, 9998, 1, 46800)
(STARFRUIT, US << MARKET, 5040, 1, 46800)
(STARFRUIT, US << MARKET, 5040, 1, 46800)
(STARFRUIT, US << MARKET, 5040, 1, 46800)
(STARFRUIT, US << MARKET, 5040, 1, 46800)","{""AMETHYSTS"": 17, ""STARFRUIT"": 12}",378,5039,10001
46900,-5044,-235151,"(STARFRUIT, US << MARKET, 5044, 1, 46900)","{""AMETHYSTS"": 17, ""STARFRUIT"": 13}",421,5044,10000
47000,9912,-225239,"(AMETHYSTS, MARKET << US, 9995, 1, 47000)
(AMETHYSTS, MARKET << US, 9995, 1, 47000)
(STARFRUIT, US << MARKET, 5039, 1, 47000)
(STARFRUIT, US << MARKET, 5039, 1, 47000)","{""AMETHYSTS"": 15, ""STARFRUIT"": 15}",361,5042,9998
47100,5039,-220200,"(STARFRUIT, MARKET << US, 5039, 1, 47100)","{""AMETHYSTS"": 15, ""STARFRUIT"": 14}",389,5041,10001
47200,-20172,-240372,"(STARFRUIT, US << MARKET, 5043, 1, 47200)
(STARFRUIT, US << MARKET, 5043, 1, 47200)
(STARFRUIT, US << MARKET, 5043, 1, 47200)
(STARFRUIT, US << MARKET, 5043, 1, 47200)","{""AMETHYSTS"": 15, ""STARFRUIT"": 18}",420,5044,10000
47600,-50054,-290426,"(AMETHYSTS, US << MARKET, 9995, 1, 47600)
(AMETHYSTS, US << MARKET, 9995, 1, 47600)
(AMETHYSTS, US << MARKET, 9995, 1, 47600)
(AMETHYSTS, US << MARKET, 9995, 1, 47600)
(STARFRUIT, US << MARKET, 5037, 1, 47600)
(STARFRUIT, US << MARKET, 5037, 1, 47600)","{""AMETHYSTS"": 19, ""STARFRUIT"": 20}",374,5040,10000
47700,-9998,-300424,"(AMETHYSTS, US << MARKET, 9998, 1, 47700)","{""AMETHYSTS"": 20, ""STARFRUIT"": 20}",296,5039,9997
48300,0,-300424,,"{""AMETHYSTS"": 20, ""STARFRUIT"": 20}",436,5043,10000
48400,0,-300424,,"{""AMETHYSTS"": 20, ""STARFRUIT"": 20}",436,5043,10000
48700,0,-300424,,"{""AMETHYSTS"": 20, ""STARFRUIT"": 20}",416,5039,10003
48900,0,-300424,,"{""AMETHYSTS"": 20, ""STARFRUIT"": 20}",376,5039,10001
49100,0,-300424,,"{""AMETHYSTS"": 20, ""STARFRUIT"": 20}",356,5038,10001
49300,5040,-295384,"(STARFRUIT, MARKET << US, 5040, 1, 49300)","{""AMETHYSTS"": 20, ""STARFRUIT"": 19}",376,5040,10000
49700,20004,-275380,"(AMETHYSTS, MARKET << US, 10002, 1, 49700)
(AMETHYSTS, MARKET << US, 10002, 1, 49700)","{""AMETHYSTS"": 18, ""STARFRUIT"": 19}",343,5039,9999
49800,-19996,-295376,"(AMETHYSTS, US << MARKET, 9998, 1, 49800)
(AMETHYSTS, US << MARKET, 9998, 1, 49800)","{""AMETHYSTS"": 20, ""STARFRUIT"": 19}",305,5039,9997
49900,0,-295376,,"{""AMETHYSTS"": 20, ""STARFRUIT"": 19}",384,5040,10000
50100,85405,-209971,"(AMETHYSTS, MARKET << US, 10004, 1, 50100)
(AMETHYSTS, MARKET << US, 10004, 1, 50100)
(AMETHYSTS, MARKET << US, 10004, 1, 50100)
(AMETHYSTS, MARKET << US, 10004, 1, 50100)
(STARFRUIT, MARKET << US, 5044, 1, 50100)
(STARFRUIT, MARKET << US, 5044, 1, 50100)
(STARFRUIT, MARKET << US, 5043, 1, 50100)
(STARFRUIT, MARKET << US, 5043, 1, 50100)
(STARFRUIT, MARKET << US, 5043, 1, 50100)
(STARFRUIT, MARKET << US, 5043, 1, 50100)
(STARFRUIT, MARKET << US, 5043, 1, 50100)
(STARFRUIT, MARKET << US, 5043, 1, 50100)
(STARFRUIT, MARKET << US, 5043, 1, 50100)","{""AMETHYSTS"": 16, ""STARFRUIT"": 10}",449,5042,10000
50300,20004,-189967,"(AMETHYSTS, MARKET << US, 10002, 1, 50300)
(AMETHYSTS, MARKET << US, 10002, 1, 50300)","{""AMETHYSTS"": 14, ""STARFRUIT"": 10}",439,5042,9999
50400,-40008,-229975,"(AMETHYSTS, US << MARKET, 10002, 1, 50400)
(AMETHYSTS, US << MARKET, 10002, 1, 50400)
(AMETHYSTS, US << MARKET, 10002, 1, 50400)
(AMETHYSTS, US << MARKET, 10002, 1, 50400)","{""AMETHYSTS"": 18, ""STARFRUIT"": 10}",469,5039,10003
50600,-5041,-235016,"(STARFRUIT, US << MARKET, 5041, 1, 50600)","{""AMETHYSTS"": 18, ""STARFRUIT"": 11}",446,5042,10000
50800,9998,-225018,"(AMETHYSTS, MARKET << US, 9998, 1, 50800)","{""AMETHYSTS"": 17, ""STARFRUIT"": 11}",354,5040,9996
51300,35266,-189752,"(STARFRUIT, MARKET << US, 5038, 1, 51300)
(STARFRUIT, MARKET << US, 5038, 1, 51300)
(STARFRUIT, MARKET << US, 5038, 1, 51300)
(STARFRUIT, MARKET << US, 5038, 1, 51300)
(STARFRUIT, MARKET << US, 5038, 1, 51300)
(STARFRUIT, MARKET << US, 5038, 1, 51300)
(STARFRUIT, MARKET << US, 5038, 1, 51300)","{""AMETHYSTS"": 17, ""STARFRUIT"": 4}",412,5041,10000
51600,10076,-179676,"(STARFRUIT, MARKET << US, 5038, 1, 51600)
(STARFRUIT, MARKET << US, 5038, 1, 51600)","{""AMETHYSTS"": 17, ""STARFRUIT"": 2}",404,5040,10000
52000,-10076,-189752,"(STARFRUIT, US << MARKET, 5038, 1, 52000)
(STARFRUIT, US << MARKET, 5038, 1, 52000)
(STARFRUIT, US << MARKET, 5038, 1, 52000)
(STARFRUIT, US << MARKET, 5038, 1, 52000)
(STARFRUIT, US << MARKET, 5038, 1, 52000)
(STARFRUIT, MARKET << US, 5038, 1, 52000)
(STARFRUIT, MARKET << US, 5038, 1, 52000)
(STARFRUIT, MARKET << US, 5038, 1, 52000)","{""AMETHYSTS"": 17, ""STARFRUIT"": 4}",430,5037,10002
52300,30251,-159501,"(STARFRUIT, US << MARKET, 5043, 1, 52300)
(STARFRUIT, MARKET << US, 5042, 1, 52300)
(STARFRUIT, MARKET << US, 5042, 1, 52300)
(STARFRUIT, MARKET << US, 5042, 1, 52300)
(STARFRUIT, MARKET << US, 5042, 1, 52300)
(STARFRUIT, MARKET << US, 5042, 1, 52300)
(STARFRUIT, MARKET << US, 5042, 1, 52300)
(STARFRUIT, MARKET << US, 5042, 1, 52300)","{""AMETHYSTS"": 17, ""STARFRUIT"": -2}",391,5037,9998
52600,25185,-134316,"(STARFRUIT, MARKET << US, 5037, 1, 52600)
(STARFRUIT, MARKET << US, 5037, 1, 52600)
(STARFRUIT, MARKET << US, 5037, 1, 52600)
(STARFRUIT, MARKET << US, 5037, 1, 52600)
(STARFRUIT, MARKET << US, 5037, 1, 52600)","{""AMETHYSTS"": 17, ""STARFRUIT"": -7}",353,5040,9997
52700,-9913,-144229,"(AMETHYSTS, US << MARKET, 9995, 1, 52700)
(AMETHYSTS, US << MARKET, 9995, 1, 52700)
(AMETHYSTS, US << MARKET, 9995, 1, 52700)
(AMETHYSTS, MARKET << US, 9998, 1, 52700)
(STARFRUIT, MARKET << US, 5037, 1, 52700)
(STARFRUIT, MARKET << US, 5037, 1, 52700)","{""AMETHYSTS"": 19, ""STARFRUIT"": -9}",335,5040,9996
53200,-45387,-189616,"(STARFRUIT, US << MARKET, 5043, 1, 53200)
(STARFRUIT, US << MARKET, 5043, 1, 53200)
(STARFRUIT, US << MARKET, 5043, 1, 53200)
(STARFRUIT, US << MARKET, 5043, 1, 53200)
(STARFRUIT, US << MARKET, 5043, 1, 53200)
(STARFRUIT, US << MARKET, 5043, 1, 53200)
(STARFRUIT, US << MARKET, 5043, 1, 53200)
(STARFRUIT, US << MARKET, 5043, 1, 53200)
(STARFRUIT, US << MARKET, 5043, 1, 53200)","{""AMETHYSTS"": 19, ""STARFRUIT"": 0}",327,5039,9997
53400,-10074,-199690,"(STARFRUIT, US << MARKET, 5037, 1, 53400)
(STARFRUIT, US << MARKET, 5037, 1, 53400)","{""AMETHYSTS"": 19, ""STARFRUIT"": 2}",390,5040,10000
53500,20148,-179542,"(STARFRUIT, MARKET << US, 5037, 1, 53500)
(STARFRUIT, MARKET << US, 5037, 1, 53500)
(STARFRUIT, MARKET << US, 5037, 1, 53500)
(STARFRUIT, MARKET << US, 5037, 1, 53500)","{""AMETHYSTS"": 19, ""STARFRUIT"": -2}",361,5039,9999
53600,25034,-154508,"(AMETHYSTS, MARKET << US, 9998, 1, 53600)
(AMETHYSTS, MARKET << US, 9998, 1, 53600)
(STARFRUIT, MARKET << US, 5038, 1, 53600)","{""AMETHYSTS"": 17, ""STARFRUIT"": -3}",386,5041,10001
53900,10080,-144428,"(STARFRUIT, MARKET << US, 5043, 1, 53900)
(STARFRUIT, MARKET << US, 5037, 1, 53900)","{""AMETHYSTS"": 17, ""STARFRUIT"": -5}",377,5039,10000
54400,10076,-134352,"(STARFRUIT, MARKET << US, 5038, 1, 54400)
(STARFRUIT, MARKET << US, 5038, 1, 54400)","{""AMETHYSTS"": 17, ""STARFRUIT"": -7}",361,5041,10000
54500,-10076,-144428,"(STARFRUIT, US << MARKET, 5038, 1, 54500)
(STARFRUIT, US << MARKET, 5038, 1, 54500)","{""AMETHYSTS"": 17, ""STARFRUIT"": -5}",333,5041,9998
54700,-19996,-164424,"(AMETHYSTS, US << MARKET, 9998, 1, 54700)
(AMETHYSTS, US << MARKET, 9998, 1, 54700)","{""AMETHYSTS"": 19, ""STARFRUIT"": -5}",390,5041,10001
55000,4959,-159465,"(AMETHYSTS, MARKET << US, 9998, 1, 55000)
(STARFRUIT, US << MARKET, 5039, 1, 55000)
(STARFRUIT, US << MARKET, 5039, 1, 55000)
(STARFRUIT, MARKET << US, 5039, 1, 55000)","{""AMETHYSTS"": 18, ""STARFRUIT"": -4}",307,5039,9996
56600,20008,-139457,"(AMETHYSTS, MARKET << US, 10004, 1, 56600)
(AMETHYSTS, MARKET << US, 10004, 1, 56600)","{""AMETHYSTS"": 16, ""STARFRUIT"": -4}",379,5041,10000
56700,-10076,-149533,"(STARFRUIT, US << MARKET, 5038, 1, 56700)
(STARFRUIT, US << MARKET, 5038, 1, 56700)","{""AMETHYSTS"": 16, ""STARFRUIT"": -2}",393,5037,10000
56800,-10076,-159609,"(STARFRUIT, US << MARKET, 5038, 1, 56800)
(STARFRUIT, US << MARKET, 5038, 1, 56800)","{""AMETHYSTS"": 16, ""STARFRUIT"": 0}",391,5041,10000
57000,-50133,-209742,"(AMETHYSTS, US << MARKET, 9995, 1, 57000)
(AMETHYSTS, US << MARKET, 9995, 1, 57000)
(AMETHYSTS, US << MARKET, 9995, 1, 57000)
(STARFRUIT, US << MARKET, 5037, 1, 57000)
(STARFRUIT, US << MARKET, 5037, 1, 57000)
(STARFRUIT, US << MARKET, 5037, 1, 57000)
(STARFRUIT, US << MARKET, 5037, 1, 57000)
(STARFRUIT, US << MARKET, 5037, 1, 57000)
(STARFRUIT, US << MARKET, 5037, 1, 57000)
(STARFRUIT, MARKET << US, 5037, 1, 57000)
(STARFRUIT, MARKET << US, 5037, 1, 57000)","{""AMETHYSTS"": 19, ""STARFRUIT"": 4}",418,5040,10000
57300,-10002,-219744,"(AMETHYSTS, US << MARKET, 10002, 1, 57300)","{""AMETHYSTS"": 20, ""STARFRUIT"": 4}",480,5041,10003
57400,5038,-214706,"(STARFRUIT, MARKET << US, 5038, 1, 57400)","{""AMETHYSTS"": 20, ""STARFRUIT"": 3}",394,5040,9999
58000,-10082,-224788,"(STARFRUIT, US << MARKET, 5041, 1, 58000)
(STARFRUIT, US << MARKET, 5041, 1, 58000)","{""AMETHYSTS"": 20, ""STARFRUIT"": 5}",442,5042,10001
58100,5037,-219751,"(STARFRUIT, MARKET << US, 5037, 1, 58100)","{""AMETHYSTS"": 20, ""STARFRUIT"": 4}",413,5041,10000
58400,20160,-199591,"(STARFRUIT, MARKET << US, 5040, 1, 58400)
(STARFRUIT, MARKET << US, 5040, 1, 58400)
(STARFRUIT, MARKET << US, 5040, 1, 58400)
(STARFRUIT, MARKET << US, 5040, 1, 58400)","{""AMETHYSTS"": 20, ""STARFRUIT"": 0}",349,5038,9997
58800,0,-199591,,"{""AMETHYSTS"": 20, ""STARFRUIT"": 0}",429,5040,10001
58900,9998,-189593,"(AMETHYSTS, MARKET << US, 9998, 1, 58900)","{""AMETHYSTS"": 19, ""STARFRUIT"": 0}",331,5040,9996
59000,89982,-99611,"(AMETHYSTS, MARKET << US, 9998, 1, 59000)
(AMETHYSTS, MARKET << US, 9998, 1, 59000)
(AMETHYSTS, MARKET << US, 9998, 1, 59000)
(AMETHYSTS, MARKET << US, 9998, 1, 59000)
(AMETHYSTS, MARKET << US, 9998, 1, 59000)
(AMETHYSTS, MARKET << US, 9998, 1, 59000)
(AMETHYSTS, MARKET << US, 9998, 1, 59000)
(AMETHYSTS, MARKET << US, 9998, 1, 59000)
(AMETHYSTS, MARKET << US, 9998, 1, 59000)","{""AMETHYSTS"": 10, ""STARFRUIT"": 0}",389,5041,10000
59100,19996,-79615,"(AMETHYSTS, MARKET << US, 9998, 1, 59100)
(AMETHYSTS, MARKET << US, 9998, 1, 59100)","{""AMETHYSTS"": 8, ""STARFRUIT"": 0}",353,5040,9996
59300,0,-79615,"(AMETHYSTS, US << MARKET, 9998, 1, 59300)
(AMETHYSTS, US << MARKET, 9998, 1, 59300)
(AMETHYSTS, MARKET << US, 9998, 1, 59300)
(AMETHYSTS, MARKET << US, 9998, 1, 59300)","{""AMETHYSTS"": 8, ""STARFRUIT"": 0}",361,5041,9997
59400,60012,-19603,"(AMETHYSTS, MARKET << US, 10002, 1, 59400)
(AMETHYSTS, MARKET << US, 10002, 1, 59400)
(AMETHYSTS, MARKET << US, 10002, 1, 59400)
(AMETHYSTS, MARKET << US, 10002, 1, 59400)
(AMETHYSTS, MARKET << US, 10002, 1, 59400)
(AMETHYSTS, MARKET << US, 10002, 1, 59400)","{""AMETHYSTS"": 2, ""STARFRUIT"": 0}",397,5039,10000
59800,15120,-4483,"(STARFRUIT, MARKET << US, 5040, 1, 59800)
(STARFRUIT, MARKET << US, 5040, 1, 59800)
(STARFRUIT, MARKET << US, 5040, 1, 59800)","{""AMETHYSTS"": 2, ""STARFRUIT"": -3}",400,5039,10000
59900,70110,65627,"(AMETHYSTS, MARKET << US, 10004, 1, 59900)
(AMETHYSTS, MARKET << US, 10004, 1, 59900)
(AMETHYSTS, MARKET << US, 10004, 1, 59900)
(AMETHYSTS, MARKET << US, 10004, 1, 59900)
(AMETHYSTS, MARKET << US, 10004, 1, 59900)
(AMETHYSTS, MARKET << US, 10002, 1, 59900)
(STARFRUIT, MARKET << US, 5044, 1, 59900)
(STARFRUIT, MARKET << US, 5044, 1, 59900)","{""AMETHYSTS"": -4, ""STARFRUIT"": -5}",410,5041,10003
60100,-14958,50669,"(AMETHYSTS, US << MARKET, 9998, 1, 60100)
(AMETHYSTS, US << MARKET, 9998, 1, 60100)
(STARFRUIT, MARKET << US, 5038, 1, 60100)","{""AMETHYSTS"": -2, ""STARFRUIT"": -6}",455,5037,9996
60200,-19996,30673,"(AMETHYSTS, US << MARKET, 9998, 1, 60200)
(AMETHYSTS, US << MARKET, 9998, 1, 60200)","{""AMETHYSTS"": 0, ""STARFRUIT"": -6}",421,5042,10002
60400,-39992,-9319,"(AMETHYSTS, US << MARKET, 9998, 1, 60400)
(AMETHYSTS, US << MARKET, 9998, 1, 60400)
(AMETHYSTS, US << MARKET, 9998, 1, 60400)
(AMETHYSTS, US << MARKET, 9998, 1, 60400)","{""AMETHYSTS"": 4, ""STARFRUIT"": -6}",443,5041,10002
60500,-55251,-64570,"(AMETHYSTS, US << MARKET, 9996, 1, 60500)
(AMETHYSTS, US << MARKET, 9996, 1, 60500)
(STARFRUIT, US << MARKET, 5037, 1, 60500)
(STARFRUIT, US << MARKET, 5037, 1, 60500)
(STARFRUIT, US << MARKET, 5037, 1, 60500)
(STARFRUIT, US << MARKET, 5037, 1, 60500)
(STARFRUIT, US << MARKET, 5037, 1, 60500)
(STARFRUIT, US << MARKET, 5037, 1, 60500)
(STARFRUIT, US << MARKET, 5037, 1, 60500)
(STARFRUIT, US << MARKET, 5037, 1, 60500)
(STARFRUIT, MARKET << US, 5037, 1, 60500)","{""AMETHYSTS"": 6, ""STARFRUIT"": 1}",470,5040,10000
61000,-4966,-69536,"(AMETHYSTS, US << MARKET, 10004, 1, 61000)
(STARFRUIT, MARKET << US, 5038, 1, 61000)","{""AMETHYSTS"": 7, ""STARFRUIT"": 0}",464,5037,10000
61100,15132,-54404,"(STARFRUIT, MARKET << US, 5044, 1, 61100)
(STARFRUIT, MARKET << US, 5044, 1, 61100)
(STARFRUIT, MARKET << US, 5044, 1, 61100)","{""AMETHYSTS"": 7, ""STARFRUIT"": -3}",476,5040,10000
61500,120024,65620,"(AMETHYSTS, MARKET << US, 10002, 1, 61500)
(AMETHYSTS, MARKET << US, 10002, 1, 61500)
(AMETHYSTS, MARKET << US, 10002, 1, 61500)
(AMETHYSTS, MARKET << US, 10002, 1, 61500)
(AMETHYSTS, MARKET << US, 10002, 1, 61500)
(AMETHYSTS, MARKET << US, 10002, 1, 61500)
(AMETHYSTS, MARKET << US, 10002, 1, 61500)
(AMETHYSTS, MARKET << US, 10002, 1, 61500)
(AMETHYSTS, MARKET << US, 10002, 1, 61500)
(AMETHYSTS, MARKET << US, 10002, 1, 61500)
(AMETHYSTS, MARKET << US, 10002, 1, 61500)
(AMETHYSTS, MARKET << US, 10002, 1, 61500)","{""AMETHYSTS"": -5, ""STARFRUIT"": -3}",485,5040,10003
62200,5038,70658,"(STARFRUIT, MARKET << US, 5038, 1, 62200)","{""AMETHYSTS"": -5, ""STARFRUIT"": -4}",505,5037,10001
62800,79968,150626,"(AMETHYSTS, MARKET << US, 9996, 1, 62800)
(AMETHYSTS, MARKET << US, 9996, 1, 62800)
(AMETHYSTS, MARKET << US, 9996, 1, 62800)
(AMETHYSTS, MARKET << US, 9996, 1, 62800)
(AMETHYSTS, MARKET << US, 9996, 1, 62800)
(AMETHYSTS, MARKET << US, 9996, 1, 62800)
(AMETHYSTS, MARKET << US, 9996, 1, 62800)
(AMETHYSTS, MARKET << US, 9996, 1, 62800)","{""AMETHYSTS"": -13, ""STARFRUIT"": -4}",466,5040,10000
62900,9924,160550,"(AMETHYSTS, MARKET << US, 10004, 1, 62900)
(AMETHYSTS, MARKET << US, 10004, 1, 62900)
(STARFRUIT, US << MARKET, 5042, 1, 62900)
(STARFRUIT, US << MARKET, 5042, 1, 62900)","{""AMETHYSTS"": -15, ""STARFRUIT"": -2}",472,5039,10000
63500,9998,170548,"(AMETHYSTS, MARKET << US, 9998, 1, 63500)","{""AMETHYSTS"": -16, ""STARFRUIT"": -2}",516,5040,9997
63700,15035,185583,"(AMETHYSTS, MARKET << US, 9998, 1, 63700)
(STARFRUIT, MARKET << US, 5037, 1, 63700)","{""AMETHYSTS"": -17, ""STARFRUIT"": -3}",446,5040,10001
63800,-10072,175511,"(STARFRUIT, US << MARKET, 5036, 1, 63800)
(STARFRUIT, US << MARKET, 5036, 1, 63800)","{""AMETHYSTS"": -17, ""STARFRUIT"": -1}",472,5039,10000
63900,5036,180547,"(STARFRUIT, MARKET << US, 5036, 1, 63900)","{""AMETHYSTS"": -17, ""STARFRUIT"": -2}",501,5040,9998
64600,5036,185583,"(STARFRUIT, MARKET << US, 5036, 1, 64600)","{""AMETHYSTS"": -17, ""STARFRUIT"": -3}",469,5038,10000
64900,5036,190619,"(STARFRUIT, MARKET << US, 5036, 1, 64900)","{""AMETHYSTS"": -17, ""STARFRUIT"": -4}",463,5039,10000
65100,30088,220707,"(AMETHYSTS, MARKET << US, 10004, 1, 65100)
(AMETHYSTS, MARKET << US, 10004, 1, 65100)
(STARFRUIT, MARKET << US, 5040, 1, 65100)
(STARFRUIT, MARKET << US, 5040, 1, 65100)","{""AMETHYSTS"": -19, ""STARFRUIT"": -6}",460,5038,10001
65300,-30318,190389,"(AMETHYSTS, MARKET << US, 10002, 1, 65300)
(STARFRUIT, US << MARKET, 5040, 1, 65300)
(STARFRUIT, US << MARKET, 5040, 1, 65300)
(STARFRUIT, US << MARKET, 5040, 1, 65300)
(STARFRUIT, US << MARKET, 5040, 1, 65300)
(STARFRUIT, US << MARKET, 5040, 1, 65300)
(STARFRUIT, US << MARKET, 5040, 1, 65300)
(STARFRUIT, US << MARKET, 5040, 1, 65300)
(STARFRUIT, US << MARKET, 5040, 1, 65300)","{""AMETHYSTS"": -20, ""STARFRUIT"": 2}",411,5041,10003
65400,-19996,170393,"(AMETHYSTS, US << MARKET, 9998, 1, 65400)
(AMETHYSTS, US << MARKET, 9998, 1, 65400)","{""AMETHYSTS"": -18, ""STARFRUIT"": 2}",523,5038,9997
66000,-10152,160241,"(AMETHYSTS, MARKET << US, 9996, 1, 66000)
(STARFRUIT, US << MARKET, 5037, 1, 66000)
(STARFRUIT, US << MARKET, 5037, 1, 66000)
(STARFRUIT, US << MARKET, 5037, 1, 66000)
(STARFRUIT, US << MARKET, 5037, 1, 66000)","{""AMETHYSTS"": -19, ""STARFRUIT"": 6}",538,5040,9997
66100,-94720,65521,"(AMETHYSTS, US << MARKET, 9995, 1, 66100)
(AMETHYSTS, US << MARKET, 9995, 1, 66100)
(AMETHYSTS, US << MARKET, 9995, 1, 66100)
(AMETHYSTS, US << MARKET, 9995, 1, 66100)
(AMETHYSTS, US << MARKET, 9995, 1, 66100)
(AMETHYSTS, US << MARKET, 9995, 1, 66100)
(AMETHYSTS, US << MARKET, 9995, 1, 66100)
(AMETHYSTS, US << MARKET, 9995, 1, 66100)
(AMETHYSTS, US << MARKET, 9995, 1, 66100)
(AMETHYSTS, US << MARKET, 9995, 1, 66100)
(AMETHYSTS, US << MARKET, 9995, 1, 66100)
(AMETHYSTS, US << MARKET, 9995, 1, 66100)
(STARFRUIT, MARKET << US, 5044, 1, 66100)
(STARFRUIT, MARKET << US, 5044, 1, 66100)
(STARFRUIT, MARKET << US, 5044, 1, 66100)
(STARFRUIT, MARKET << US, 5044, 1, 66100)
(STARFRUIT, MARKET << US, 5044, 1, 66100)","{""AMETHYSTS"": -7, ""STARFRUIT"": 1}",561,5040,10000
66500,5037,70558,"(STARFRUIT, MARKET << US, 5037, 1, 66500)","{""AMETHYSTS"": -7, ""STARFRUIT"": 0}",558,5040,10000
66600,15114,85672,"(STARFRUIT, MARKET << US, 5038, 1, 66600)
(STARFRUIT, MARKET << US, 5038, 1, 66600)
(STARFRUIT, MARKET << US, 5038, 1, 66600)","{""AMETHYSTS"": -7, ""STARFRUIT"": -3}",563,5041,9998
67000,80016,165688,"(AMETHYSTS, MARKET << US, 10002, 1, 67000)
(AMETHYSTS, MARKET << US, 10002, 1, 67000)
(AMETHYSTS, MARKET << US, 10002, 1, 67000)
(AMETHYSTS, MARKET << US, 10002, 1, 67000)
(AMETHYSTS, MARKET << US, 10002, 1, 67000)
(AMETHYSTS, MARKET << US, 10002, 1, 67000)
(AMETHYSTS, MARKET << US, 10002, 1, 67000)
(AMETHYSTS, MARKET << US, 10002, 1, 67000)","{""AMETHYSTS"": -15, ""STARFRUIT"": -3}",526,5039,10003
67100,-19992,145696,"(AMETHYSTS, US << MARKET, 9996, 1, 67100)
(AMETHYSTS, US << MARKET, 9996, 1, 67100)","{""AMETHYSTS"": -13, ""STARFRUIT"": -3}",601,5036,9999
67700,-15304,130392,"(AMETHYSTS, MARKET << US, 10002, 1, 67700)
(AMETHYSTS, MARKET << US, 10002, 1, 67700)
(STARFRUIT, US << MARKET, 5044, 1, 67700)
(STARFRUIT, US << MARKET, 5044, 1, 67700)
(STARFRUIT, US << MARKET, 5044, 1, 67700)
(STARFRUIT, US << MARKET, 5044, 1, 67700)
(STARFRUIT, US << MARKET, 5044, 1, 67700)
(STARFRUIT, US << MARKET, 5044, 1, 67700)
(STARFRUIT, US << MARKET, 5044, 1, 67700)","{""AMETHYSTS"": -15, ""STARFRUIT"": 4}",507,5040,10003
67900,-8,130384,"(STARFRUIT, US << MARKET, 5043, 1, 67900)
(STARFRUIT, US << MARKET, 5043, 1, 67900)
(STARFRUIT, US << MARKET, 5043, 1, 67900)
(STARFRUIT, US << MARKET, 5043, 1, 67900)
(STARFRUIT, MARKET << US, 5041, 1, 67900)
(STARFRUIT, MARKET << US, 5041, 1, 67900)
(STARFRUIT, MARKET << US, 5041, 1, 67900)
(STARFRUIT, MARKET << US, 5041, 1, 67900)","{""AMETHYSTS"": -15, ""STARFRUIT"": 4}",567,5042,9999
69200,20144,150528,"(STARFRUIT, MARKET << US, 5036, 1, 69200)
(STARFRUIT, MARKET << US, 5036, 1, 69200)
(STARFRUIT, MARKET << US, 5036, 1, 69200)
(STARFRUIT, MARKET << US, 5036, 1, 69200)","{""AMETHYSTS"": -15, ""STARFRUIT"": 0}",543,5035,9999
69400,50010,200538,"(AMETHYSTS, MARKET << US, 10002, 1, 69400)
(AMETHYSTS, MARKET << US, 10002, 1, 69400)
(AMETHYSTS, MARKET << US, 10002, 1, 69400)
(AMETHYSTS, MARKET << US, 10002, 1, 69400)
(AMETHYSTS, MARKET << US, 10002, 1, 69400)","{""AMETHYSTS"": -20, ""STARFRUIT"": 0}",478,5037,10003
69500,-20004,180534,"(AMETHYSTS, US << MARKET, 10002, 1, 69500)
(AMETHYSTS, US << MARKET, 10002, 1, 69500)","{""AMETHYSTS"": -18, ""STARFRUIT"": 0}",480,5035,10003
69600,25023,205557,"(AMETHYSTS, MARKET << US, 10002, 1, 69600)
(AMETHYSTS, MARKET << US, 10002, 1, 69600)
(STARFRUIT, US << MARKET, 5040, 1, 69600)
(STARFRUIT, US << MARKET, 5040, 1, 69600)
(STARFRUIT, MARKET << US, 5033, 1, 69600)
(STARFRUIT, MARKET << US, 5033, 1, 69600)
(STARFRUIT, MARKET << US, 5033, 1, 69600)","{""AMETHYSTS"": -20, ""STARFRUIT"": -1}",541,5036,9999
69800,5034,210591,"(STARFRUIT, MARKET << US, 5034, 1, 69800)","{""AMETHYSTS"": -20, ""STARFRUIT"": -2}",517,5037,10000
69900,10082,220673,"(STARFRUIT, MARKET << US, 5041, 1, 69900)
(STARFRUIT, MARKET << US, 5041, 1, 69900)","{""AMETHYSTS"": -20, ""STARFRUIT"": -4}",521,5038,10000
70200,-30216,190457,"(STARFRUIT, US << MARKET, 5036, 1, 70200)
(STARFRUIT, US << MARKET, 5036, 1, 70200)
(STARFRUIT, US << MARKET, 5036, 1, 70200)
(STARFRUIT, US << MARKET, 5036, 1, 70200)
(STARFRUIT, US << MARKET, 5036, 1, 70200)
(STARFRUIT, US << MARKET, 5036, 1, 70200)","{""AMETHYSTS"": -20, ""STARFRUIT"": 2}",565,5034,9998
70400,0,190457,,"{""AMETHYSTS"": -20, ""STARFRUIT"": 2}",549,5036,9999
70600,-39984,150473,"(AMETHYSTS, US << MARKET, 9996, 1, 70600)
(AMETHYSTS, US << MARKET, 9996, 1, 70600)
(AMETHYSTS, US << MARKET, 9996, 1, 70600)
(AMETHYSTS, US << MARKET, 9996, 1, 70600)","{""AMETHYSTS"": -16, ""STARFRUIT"": 2}",551,5039,10000
70700,40086,190559,"(AMETHYSTS, MARKET << US, 10002, 1, 70700)
(AMETHYSTS, MARKET << US, 10002, 1, 70700)
(AMETHYSTS, MARKET << US, 10002, 1, 70700)
(STARFRUIT, MARKET << US, 5040, 1, 70700)
(STARFRUIT, MARKET << US, 5040, 1, 70700)","{""AMETHYSTS"": -19, ""STARFRUIT"": 0}",597,5036,9998
70800,-10066,180493,"(STARFRUIT, US << MARKET, 5033, 1, 70800)
(STARFRUIT, US << MARKET, 5033, 1, 70800)","{""AMETHYSTS"": -19, ""STARFRUIT"": 2}",622,5036,9997
70900,-75,180418,"(AMETHYSTS, MARKET << US, 10005, 1, 70900)
(STARFRUIT, US << MARKET, 5040, 1, 70900)
(STARFRUIT, US << MARKET, 5040, 1, 70900)","{""AMETHYSTS"": -20, ""STARFRUIT"": 4}",562,5036,10000
71000,5039,185457,"(STARFRUIT, MARKET << US, 5039, 1, 71000)","{""AMETHYSTS"": -20, ""STARFRUIT"": 3}",574,5039,10000
71400,10088,195545,"(STARFRUIT, US << MARKET, 5036, 1, 71400)
(STARFRUIT, US << MARKET, 5036, 1, 71400)
(STARFRUIT, MARKET << US, 5040, 1, 71400)
(STARFRUIT, MARKET << US, 5040, 1, 71400)
(STARFRUIT, MARKET << US, 5040, 1, 71400)
(STARFRUIT, MARKET << US, 5040, 1, 71400)","{""AMETHYSTS"": -20, ""STARFRUIT"": 1}",562,5037,10001
72400,-25180,170365,"(STARFRUIT, US << MARKET, 5036, 1, 72400)
(STARFRUIT, US << MARKET, 5036, 1, 72400)
(STARFRUIT, US << MARKET, 5036, 1, 72400)
(STARFRUIT, US << MARKET, 5036, 1, 72400)
(STARFRUIT, US << MARKET, 5036, 1, 72400)","{""AMETHYSTS"": -20, ""STARFRUIT"": 6}",593,5038,10000
72500,-20090,150275,"(AMETHYSTS, US << MARKET, 10004, 1, 72500)
(STARFRUIT, US << MARKET, 5043, 1, 72500)
(STARFRUIT, US << MARKET, 5043, 1, 72500)","{""AMETHYSTS"": -19, ""STARFRUIT"": 8}",595,5040,10000
73200,-20152,130123,"(STARFRUIT, US << MARKET, 5038, 1, 73200)
(STARFRUIT, US << MARKET, 5038, 1, 73200)
(STARFRUIT, US << MARKET, 5038, 1, 73200)
(STARFRUIT, US << MARKET, 5038, 1, 73200)","{""AMETHYSTS"": -19, ""STARFRUIT"": 12}",615,5041,10000
73400,9998,140121,"(AMETHYSTS, MARKET << US, 9998, 1, 73400)","{""AMETHYSTS"": -20, ""STARFRUIT"": 12}",673,5041,9997
73700,5043,145164,"(STARFRUIT, MARKET << US, 5043, 1, 73700)","{""AMETHYSTS"": -20, ""STARFRUIT"": 11}",728,5044,9996
74300,-5044,140120,"(STARFRUIT, US << MARKET, 5044, 1, 74300)","{""AMETHYSTS"": -20, ""STARFRUIT"": 12}",648,5044,10000
74400,-15129,124991,"(STARFRUIT, US << MARKET, 5043, 1, 74400)
(STARFRUIT, US << MARKET, 5043, 1, 74400)
(STARFRUIT, US << MARKET, 5043, 1, 74400)","{""AMETHYSTS"": -20, ""STARFRUIT"": 15}",651,5044,10000
74600,-14969,110022,"(AMETHYSTS, US << MARKET, 10004, 1, 74600)
(AMETHYSTS, US << MARKET, 10004, 1, 74600)
(STARFRUIT, MARKET << US, 5039, 1, 74600)","{""AMETHYSTS"": -18, ""STARFRUIT"": 14}",610,5042,10000
74800,9998,120020,"(AMETHYSTS, MARKET << US, 9998, 1, 74800)","{""AMETHYSTS"": -19, ""STARFRUIT"": 14}",665,5042,9997
74900,-19996,100024,"(AMETHYSTS, US << MARKET, 9998, 1, 74900)
(AMETHYSTS, US << MARKET, 9998, 1, 74900)","{""AMETHYSTS"": -17, ""STARFRUIT"": 14}",663,5042,9997
75300,5040,105064,"(STARFRUIT, MARKET << US, 5040, 1, 75300)","{""AMETHYSTS"": -17, ""STARFRUIT"": 13}",610,5042,10000
75600,-20184,84880,"(STARFRUIT, US << MARKET, 5046, 1, 75600)
(STARFRUIT, US << MARKET, 5046, 1, 75600)
(STARFRUIT, US << MARKET, 5046, 1, 75600)
(STARFRUIT, US << MARKET, 5046, 1, 75600)","{""AMETHYSTS"": -17, ""STARFRUIT"": 17}",662,5044,9998
75800,-4958,79922,"(AMETHYSTS, US << MARKET, 10004, 1, 75800)
(STARFRUIT, MARKET << US, 5046, 1, 75800)","{""AMETHYSTS"": -16, ""STARFRUIT"": 16}",610,5043,10000
76300,5037,84959,"(STARFRUIT, MARKET << US, 5037, 1, 76300)","{""AMETHYSTS"": -16, ""STARFRUIT"": 15}",592,5039,9997
76400,15114,100073,"(STARFRUIT, MARKET << US, 5038, 1, 76400)
(STARFRUIT, MARKET << US, 5038, 1, 76400)
(STARFRUIT, MARKET << US, 5038, 1, 76400)","{""AMETHYSTS"": -16, ""STARFRUIT"": 12}",517,5037,10000
76800,-5039,95034,"(STARFRUIT, US << MARKET, 5039, 1, 76800)","{""AMETHYSTS"": -16, ""STARFRUIT"": 13}",580,5042,10000
76900,-20164,74870,"(STARFRUIT, US << MARKET, 5041, 1, 76900)
(STARFRUIT, US << MARKET, 5041, 1, 76900)
(STARFRUIT, US << MARKET, 5041, 1, 76900)
(STARFRUIT, US << MARKET, 5041, 1, 76900)","{""AMETHYSTS"": -16, ""STARFRUIT"": 17}",601,5043,10000
77100,5041,79911,"(STARFRUIT, MARKET << US, 5041, 1, 77100)","{""AMETHYSTS"": -16, ""STARFRUIT"": 16}",615,5044,10000
77400,20168,100079,"(STARFRUIT, MARKET << US, 5042, 1, 77400)
(STARFRUIT, MARKET << US, 5042, 1, 77400)
(STARFRUIT, MARKET << US, 5042, 1, 77400)
(STARFRUIT, MARKET << US, 5042, 1, 77400)","{""AMETHYSTS"": -16, ""STARFRUIT"": 12}",571,5041,10000
77700,9998,110077,"(AMETHYSTS, MARKET << US, 9998, 1, 77700)","{""AMETHYSTS"": -17, ""STARFRUIT"": 12}",600,5045,10001
78000,-5043,105034,"(STARFRUIT, US << MARKET, 5043, 1, 78000)","{""AMETHYSTS"": -17, ""STARFRUIT"": 13}",615,5046,10001
78100,-10002,95032,"(AMETHYSTS, US << MARKET, 10002, 1, 78100)","{""AMETHYSTS"": -16, ""STARFRUIT"": 13}",569,5045,10003
78400,40016,135048,"(AMETHYSTS, MARKET << US, 10004, 1, 78400)
(AMETHYSTS, MARKET << US, 10004, 1, 78400)
(AMETHYSTS, MARKET << US, 10004, 1, 78400)
(AMETHYSTS, MARKET << US, 10004, 1, 78400)","{""AMETHYSTS"": -20, ""STARFRUIT"": 13}",646,5046,10000
78600,-39984,95064,"(AMETHYSTS, US << MARKET, 9996, 1, 78600)
(AMETHYSTS, US << MARKET, 9996, 1, 78600)
(AMETHYSTS, US << MARKET, 9996, 1, 78600)
(AMETHYSTS, US << MARKET, 9996, 1, 78600)","{""AMETHYSTS"": -16, ""STARFRUIT"": 13}",649,5045,10000
78700,35343,130407,"(STARFRUIT, MARKET << US, 5049, 1, 78700)
(STARFRUIT, MARKET << US, 5049, 1, 78700)
(STARFRUIT, MARKET << US, 5049, 1, 78700)
(STARFRUIT, MARKET << US, 5049, 1, 78700)
(STARFRUIT, MARKET << US, 5049, 1, 78700)
(STARFRUIT, MARKET << US, 5049, 1, 78700)
(STARFRUIT, MARKET << US, 5049, 1, 78700)","{""AMETHYSTS"": -16, ""STARFRUIT"": 6}",677,5045,10000
78800,5047,135454,"(STARFRUIT, MARKET << US, 5047, 1, 78800)","{""AMETHYSTS"": -16, ""STARFRUIT"": 5}",646,5048,10003
79100,-20188,115266,"(STARFRUIT, US << MARKET, 5047, 1, 79100)
(STARFRUIT, US << MARKET, 5047, 1, 79100)
(STARFRUIT, US << MARKET, 5047, 1, 79100)
(STARFRUIT, US << MARKET, 5047, 1, 79100)","{""AMETHYSTS"": -16, ""STARFRUIT"": 9}",698,5048,10000
79300,-14949,100317,"(AMETHYSTS, US << MARKET, 9996, 1, 79300)
(AMETHYSTS, US << MARKET, 9996, 1, 79300)
(STARFRUIT, MARKET << US, 5043, 1, 79300)","{""AMETHYSTS"": -14, ""STARFRUIT"": 8}",685,5046,10000
79500,-4955,95362,"(AMETHYSTS, US << MARKET, 10004, 1, 79500)
(STARFRUIT, MARKET << US, 5049, 1, 79500)","{""AMETHYSTS"": -13, ""STARFRUIT"": 7}",684,5046,10000
79800,-5050,90312,"(STARFRUIT, US << MARKET, 5050, 1, 79800)","{""AMETHYSTS"": -13, ""STARFRUIT"": 8}",712,5050,10000
79900,-50082,40230,"(AMETHYSTS, US << MARKET, 9998, 1, 79900)
(AMETHYSTS, US << MARKET, 9998, 1, 79900)
(AMETHYSTS, US << MARKET, 9998, 1, 79900)
(AMETHYSTS, US << MARKET, 9998, 1, 79900)
(STARFRUIT, US << MARKET, 5045, 1, 79900)
(STARFRUIT, US << MARKET, 5045, 1, 79900)","{""AMETHYSTS"": -9, ""STARFRUIT"": 10}",701,5048,10001
80300,-59988,-19758,"(AMETHYSTS, US << MARKET, 9998, 1, 80300)
(AMETHYSTS, US << MARKET, 9998, 1, 80300)
(AMETHYSTS, US << MARKET, 9998, 1, 80300)
(AMETHYSTS, US << MARKET, 9998, 1, 80300)
(AMETHYSTS, US << MARKET, 9998, 1, 80300)
(AMETHYSTS, US << MARKET, 9998, 1, 80300)","{""AMETHYSTS"": -3, ""STARFRUIT"": 10}",722,5048,10000
80400,-35137,-54895,"(AMETHYSTS, US << MARKET, 9998, 1, 80400)
(AMETHYSTS, US << MARKET, 9998, 1, 80400)
(STARFRUIT, US << MARKET, 5047, 1, 80400)
(STARFRUIT, US << MARKET, 5047, 1, 80400)
(STARFRUIT, US << MARKET, 5047, 1, 80400)","{""AMETHYSTS"": -1, ""STARFRUIT"": 13}",706,5046,9997
80600,9998,-44897,"(AMETHYSTS, MARKET << US, 9998, 1, 80600)","{""AMETHYSTS"": -2, ""STARFRUIT"": 13}",761,5050,9996
80700,9998,-34899,"(AMETHYSTS, MARKET << US, 9998, 1, 80700)","{""AMETHYSTS"": -3, ""STARFRUIT"": 13}",747,5049,9997
81500,-15046,-49945,"(AMETHYSTS, US << MARKET, 10002, 1, 81500)
(STARFRUIT, US << MARKET, 5044, 1, 81500)","{""AMETHYSTS"": -2, ""STARFRUIT"": 14}",707,5047,10003
81700,5044,-44901,"(STARFRUIT, MARKET << US, 5044, 1, 81700)","{""AMETHYSTS"": -2, ""STARFRUIT"": 13}",695,5046,10001
81800,5049,-39852,"(STARFRUIT, MARKET << US, 5049, 1, 81800)","{""AMETHYSTS"": -2, ""STARFRUIT"": 12}",748,5050,10000
81900,20184,-19668,"(STARFRUIT, MARKET << US, 5046, 1, 81900)
(STARFRUIT, MARKET << US, 5046, 1, 81900)
(STARFRUIT, MARKET << US, 5046, 1, 81900)
(STARFRUIT, MARKET << US, 5046, 1, 81900)","{""AMETHYSTS"": -2, ""STARFRUIT"": 8}",692,5045,10000
82000,-5045,-24713,"(STARFRUIT, US << MARKET, 5045, 1, 82000)","{""AMETHYSTS"": -2, ""STARFRUIT"": 9}",710,5047,10000
82100,-20180,-44893,"(STARFRUIT, US << MARKET, 5045, 1, 82100)
(STARFRUIT, US << MARKET, 5045, 1, 82100)
(STARFRUIT, US << MARKET, 5045, 1, 82100)
(STARFRUIT, US << MARKET, 5045, 1, 82100)","{""AMETHYSTS"": -2, ""STARFRUIT"": 13}",729,5048,10001
82200,39992,-4901,"(AMETHYSTS, MARKET << US, 9998, 1, 82200)
(AMETHYSTS, MARKET << US, 9998, 1, 82200)
(AMETHYSTS, MARKET << US, 9998, 1, 82200)
(AMETHYSTS, MARKET << US, 9998, 1, 82200)","{""AMETHYSTS"": -6, ""STARFRUIT"": 13}",723,5048,10000
82500,-5050,-9951,"(STARFRUIT, US << MARKET, 5050, 1, 82500)","{""AMETHYSTS"": -6, ""STARFRUIT"": 14}",763,5051,10000
82700,5046,-4905,"(STARFRUIT, MARKET << US, 5046, 1, 82700)","{""AMETHYSTS"": -6, ""STARFRUIT"": 13}",732,5049,10000
83000,9998,5093,"(AMETHYSTS, MARKET << US, 9998, 1, 83000)","{""AMETHYSTS"": -7, ""STARFRUIT"": 13}",723,5049,10001
83400,-180,4913,"(AMETHYSTS, MARKET << US, 10002, 1, 83400)
(AMETHYSTS, MARKET << US, 10002, 1, 83400)
(STARFRUIT, US << MARKET, 5046, 1, 83400)
(STARFRUIT, US << MARKET, 5046, 1, 83400)
(STARFRUIT, US << MARKET, 5046, 1, 83400)
(STARFRUIT, US << MARKET, 5046, 1, 83400)","{""AMETHYSTS"": -9, ""STARFRUIT"": 17}",651,5045,10003
83800,14956,19869,"(AMETHYSTS, MARKET << US, 10005, 1, 83800)
(AMETHYSTS, MARKET << US, 10005, 1, 83800)
(STARFRUIT, US << MARKET, 5054, 1, 83800)","{""AMETHYSTS"": -11, ""STARFRUIT"": 18}",769,5050,10000
84100,-4951,14918,"(AMETHYSTS, US << MARKET, 10002, 1, 84100)
(STARFRUIT, MARKET << US, 5051, 1, 84100)","{""AMETHYSTS"": -10, ""STARFRUIT"": 17}",755,5051,10003
84500,55410,70328,"(AMETHYSTS, MARKET << US, 9996, 1, 84500)
(STARFRUIT, MARKET << US, 5046, 1, 84500)
(STARFRUIT, MARKET << US, 5046, 1, 84500)
(STARFRUIT, MARKET << US, 5046, 1, 84500)
(STARFRUIT, MARKET << US, 5046, 1, 84500)
(STARFRUIT, MARKET << US, 5046, 1, 84500)
(STARFRUIT, MARKET << US, 5046, 1, 84500)
(STARFRUIT, MARKET << US, 5046, 1, 84500)
(STARFRUIT, MARKET << US, 5046, 1, 84500)
(STARFRUIT, MARKET << US, 5046, 1, 84500)","{""AMETHYSTS"": -11, ""STARFRUIT"": 8}",723,5048,9999
84600,-20212,50116,"(STARFRUIT, US << MARKET, 5053, 1, 84600)
(STARFRUIT, US << MARKET, 5053, 1, 84600)
(STARFRUIT, US << MARKET, 5053, 1, 84600)
(STARFRUIT, US << MARKET, 5053, 1, 84600)","{""AMETHYSTS"": -11, ""STARFRUIT"": 12}",704,5049,10000
84800,14953,65069,"(AMETHYSTS, MARKET << US, 10002, 1, 84800)
(AMETHYSTS, MARKET << US, 10002, 1, 84800)
(STARFRUIT, US << MARKET, 5051, 1, 84800)","{""AMETHYSTS"": -13, ""STARFRUIT"": 13}",706,5052,10003
85200,-15053,50016,"(AMETHYSTS, US << MARKET, 10002, 1, 85200)
(STARFRUIT, US << MARKET, 5051, 1, 85200)","{""AMETHYSTS"": -12, ""STARFRUIT"": 14}",714,5049,9999
85400,5052,55068,"(STARFRUIT, MARKET << US, 5052, 1, 85400)","{""AMETHYSTS"": -12, ""STARFRUIT"": 13}",757,5053,10000
85500,-139972,-84904,"(AMETHYSTS, US << MARKET, 9998, 1, 85500)
(AMETHYSTS, US << MARKET, 9998, 1, 85500)
(AMETHYSTS, US << MARKET, 9998, 1, 85500)
(AMETHYSTS, US << MARKET, 9998, 1, 85500)
(AMETHYSTS, US << MARKET, 9998, 1, 85500)
(AMETHYSTS, US << MARKET, 9998, 1, 85500)
(AMETHYSTS, US << MARKET, 9998, 1, 85500)
(AMETHYSTS, US << MARKET, 9998, 1, 85500)
(AMETHYSTS, US << MARKET, 9998, 1, 85500)
(AMETHYSTS, US << MARKET, 9998, 1, 85500)
(AMETHYSTS, US << MARKET, 9998, 1, 85500)
(AMETHYSTS, US << MARKET, 9998, 1, 85500)
(AMETHYSTS, US << MARKET, 9998, 1, 85500)
(AMETHYSTS, US << MARKET, 9998, 1, 85500)","{""AMETHYSTS"": 2, ""STARFRUIT"": 13}",748,5050,10001
85600,-39984,-124888,"(AMETHYSTS, US << MARKET, 9996, 1, 85600)
(AMETHYSTS, US << MARKET, 9996, 1, 85600)
(AMETHYSTS, US << MARKET, 9996, 1, 85600)
(AMETHYSTS, US << MARKET, 9996, 1, 85600)","{""AMETHYSTS"": 6, ""STARFRUIT"": 13}",756,5050,9999
85800,20004,-104884,"(AMETHYSTS, MARKET << US, 10002, 1, 85800)
(AMETHYSTS, MARKET << US, 10002, 1, 85800)","{""AMETHYSTS"": 4, ""STARFRUIT"": 13}",791,5051,10003
85900,-19992,-124876,"(AMETHYSTS, US << MARKET, 9996, 1, 85900)
(AMETHYSTS, US << MARKET, 9996, 1, 85900)","{""AMETHYSTS"": 6, ""STARFRUIT"": 13}",774,5050,10000
86200,-39992,-164868,"(AMETHYSTS, US << MARKET, 9998, 1, 86200)
(AMETHYSTS, US << MARKET, 9998, 1, 86200)
(AMETHYSTS, US << MARKET, 9998, 1, 86200)
(AMETHYSTS, US << MARKET, 9998, 1, 86200)","{""AMETHYSTS"": 10, ""STARFRUIT"": 13}",742,5050,9996
86600,-5054,-169922,"(STARFRUIT, US << MARKET, 5054, 1, 86600)","{""AMETHYSTS"": 10, ""STARFRUIT"": 14}",758,5050,9998
86900,3,-169919,"(STARFRUIT, US << MARKET, 5051, 1, 86900)
(STARFRUIT, MARKET << US, 5054, 1, 86900)","{""AMETHYSTS"": 10, ""STARFRUIT"": 14}",757,5049,9999
87100,-10210,-180129,"(AMETHYSTS, MARKET << US, 9998, 1, 87100)
(STARFRUIT, US << MARKET, 5052, 1, 87100)
(STARFRUIT, US << MARKET, 5052, 1, 87100)
(STARFRUIT, US << MARKET, 5052, 1, 87100)
(STARFRUIT, US << MARKET, 5052, 1, 87100)","{""AMETHYSTS"": 9, ""STARFRUIT"": 18}",744,5050,9997
87200,35350,-144779,"(STARFRUIT, MARKET << US, 5050, 1, 87200)
(STARFRUIT, MARKET << US, 5050, 1, 87200)
(STARFRUIT, MARKET << US, 5050, 1, 87200)
(STARFRUIT, MARKET << US, 5050, 1, 87200)
(STARFRUIT, MARKET << US, 5050, 1, 87200)
(STARFRUIT, MARKET << US, 5050, 1, 87200)
(STARFRUIT, MARKET << US, 5050, 1, 87200)","{""AMETHYSTS"": 9, ""STARFRUIT"": 11}",804,5053,10000
87300,-5054,-149833,"(STARFRUIT, US << MARKET, 5054, 1, 87300)","{""AMETHYSTS"": 9, ""STARFRUIT"": 12}",779,5051,10000
87500,5054,-144779,"(STARFRUIT, MARKET << US, 5054, 1, 87500)","{""AMETHYSTS"": 9, ""STARFRUIT"": 11}",782,5051,10000
87900,5055,-139724,"(STARFRUIT, MARKET << US, 5055, 1, 87900)","{""AMETHYSTS"": 9, ""STARFRUIT"": 10}",826,5055,10000
88400,-20220,-159944,"(STARFRUIT, US << MARKET, 5055, 1, 88400)
(STARFRUIT, US << MARKET, 5055, 1, 88400)
(STARFRUIT, US << MARKET, 5055, 1, 88400)
(STARFRUIT, US << MARKET, 5055, 1, 88400)","{""AMETHYSTS"": 9, ""STARFRUIT"": 14}",831,5056,9999
88500,20004,-139940,"(AMETHYSTS, MARKET << US, 10002, 1, 88500)
(AMETHYSTS, MARKET << US, 10002, 1, 88500)","{""AMETHYSTS"": 7, ""STARFRUIT"": 14}",837,5054,10003
88600,-10002,-149942,"(AMETHYSTS, US << MARKET, 10002, 1, 88600)","{""AMETHYSTS"": 8, ""STARFRUIT"": 14}",824,5053,10003
88700,-109945,-259887,"(AMETHYSTS, US << MARKET, 9995, 1, 88700)
(AMETHYSTS, US << MARKET, 9995, 1, 88700)
(AMETHYSTS, US << MARKET, 9995, 1, 88700)
(AMETHYSTS, US << MARKET, 9995, 1, 88700)
(AMETHYSTS, US << MARKET, 9995, 1, 88700)
(AMETHYSTS, US << MARKET, 9995, 1, 88700)
(AMETHYSTS, US << MARKET, 9995, 1, 88700)
(AMETHYSTS, US << MARKET, 9995, 1, 88700)
(AMETHYSTS, US << MARKET, 9995, 1, 88700)
(AMETHYSTS, US << MARKET, 9995, 1, 88700)
(AMETHYSTS, US << MARKET, 9995, 1, 88700)","{""AMETHYSTS"": 19, ""STARFRUIT"": 14}",841,5052,10000
88900,-10002,-269889,"(AMETHYSTS, US << MARKET, 10002, 1, 88900)","{""AMETHYSTS"": 20, ""STARFRUIT"": 14}",899,5052,10003
89100,50134,-219755,"(AMETHYSTS, MARKET << US, 10005, 1, 89100)
(AMETHYSTS, MARKET << US, 10005, 1, 89100)
(AMETHYSTS, MARKET << US, 10005, 1, 89100)
(AMETHYSTS, MARKET << US, 10005, 1, 89100)
(STARFRUIT, MARKET << US, 5057, 1, 89100)
(STARFRUIT, MARKET << US, 5057, 1, 89100)","{""AMETHYSTS"": 16, ""STARFRUIT"": 12}",917,5056,10000
89300,-40086,-259841,"(AMETHYSTS, US << MARKET, 9996, 1, 89300)
(AMETHYSTS, US << MARKET, 9996, 1, 89300)
(AMETHYSTS, US << MARKET, 9996, 1, 89300)
(STARFRUIT, US << MARKET, 5049, 1, 89300)
(STARFRUIT, US << MARKET, 5049, 1, 89300)","{""AMETHYSTS"": 19, ""STARFRUIT"": 14}",887,5052,10000
89500,5054,-254787,"(STARFRUIT, MARKET << US, 5054, 1, 89500)","{""AMETHYSTS"": 19, ""STARFRUIT"": 13}",928,5055,10000
89800,19910,-234877,"(AMETHYSTS, US << MARKET, 9998, 1, 89800)
(AMETHYSTS, MARKET << US, 10005, 1, 89800)
(AMETHYSTS, MARKET << US, 10005, 1, 89800)
(AMETHYSTS, MARKET << US, 10005, 1, 89800)
(AMETHYSTS, MARKET << US, 10005, 1, 89800)
(STARFRUIT, US << MARKET, 5056, 1, 89800)
(STARFRUIT, US << MARKET, 5056, 1, 89800)","{""AMETHYSTS"": 16, ""STARFRUIT"": 15}",965,5054,10002
90200,-19996,-254873,"(AMETHYSTS, US << MARKET, 9998, 1, 90200)
(AMETHYSTS, US << MARKET, 9998, 1, 90200)
(AMETHYSTS, US << MARKET, 9998, 1, 90200)
(AMETHYSTS, MARKET << US, 9998, 1, 90200)","{""AMETHYSTS"": 18, ""STARFRUIT"": 15}",940,5053,10001
90400,-19992,-274865,"(AMETHYSTS, US << MARKET, 9996, 1, 90400)
(AMETHYSTS, US << MARKET, 9996, 1, 90400)","{""AMETHYSTS"": 20, ""STARFRUIT"": 15}",930,5053,10000
90800,25265,-249600,"(STARFRUIT, MARKET << US, 5053, 1, 90800)
(STARFRUIT, MARKET << US, 5053, 1, 90800)
(STARFRUIT, MARKET << US, 5053, 1, 90800)
(STARFRUIT, MARKET << US, 5053, 1, 90800)
(STARFRUIT, MARKET << US, 5053, 1, 90800)","{""AMETHYSTS"": 20, ""STARFRUIT"": 10}",920,5052,10000
91200,25056,-224544,"(AMETHYSTS, MARKET << US, 10002, 1, 91200)
(AMETHYSTS, MARKET << US, 10002, 1, 91200)
(STARFRUIT, US << MARKET, 5058, 1, 91200)
(STARFRUIT, MARKET << US, 5055, 1, 91200)
(STARFRUIT, MARKET << US, 5055, 1, 91200)","{""AMETHYSTS"": 18, ""STARFRUIT"": 9}",906,5054,9998
91300,69986,-154558,"(AMETHYSTS, US << MARKET, 9998, 1, 91300)
(AMETHYSTS, US << MARKET, 9998, 1, 91300)
(AMETHYSTS, MARKET << US, 9998, 1, 91300)
(AMETHYSTS, MARKET << US, 9998, 1, 91300)
(AMETHYSTS, MARKET << US, 9998, 1, 91300)
(AMETHYSTS, MARKET << US, 9998, 1, 91300)
(AMETHYSTS, MARKET << US, 9998, 1, 91300)
(AMETHYSTS, MARKET << US, 9998, 1, 91300)
(AMETHYSTS, MARKET << US, 9998, 1, 91300)
(AMETHYSTS, MARKET << US, 9998, 1, 91300)
(AMETHYSTS, MARKET << US, 9998, 1, 91300)","{""AMETHYSTS"": 11, ""STARFRUIT"": 9}",913,5056,9997
91400,5054,-149504,"(STARFRUIT, MARKET << US, 5054, 1, 91400)","{""AMETHYSTS"": 11, ""STARFRUIT"": 8}",985,5057,10003
91600,4944,-144560,"(AMETHYSTS, MARKET << US, 9998, 1, 91600)
(STARFRUIT, US << MARKET, 5054, 1, 91600)","{""AMETHYSTS"": 10, ""STARFRUIT"": 9}",877,5053,9996
91800,-59988,-204548,"(AMETHYSTS, US << MARKET, 9998, 1, 91800)
(AMETHYSTS, US << MARKET, 9998, 1, 91800)
(AMETHYSTS, US << MARKET, 9998, 1, 91800)
(AMETHYSTS, US << MARKET, 9998, 1, 91800)
(AMETHYSTS, US << MARKET, 9998, 1, 91800)
(AMETHYSTS, US << MARKET, 9998, 1, 91800)","{""AMETHYSTS"": 16, ""STARFRUIT"": 9}",917,5057,9997
91900,9998,-194550,"(AMETHYSTS, MARKET << US, 9998, 1, 91900)","{""AMETHYSTS"": 15, ""STARFRUIT"": 9}",1005,5060,10001
92400,-5060,-199610,"(STARFRUIT, US << MARKET, 5060, 1, 92400)","{""AMETHYSTS"": 15, ""STARFRUIT"": 10}",990,5060,10000
92900,30324,-169286,"(STARFRUIT, MARKET << US, 5054, 1, 92900)
(STARFRUIT, MARKET << US, 5054, 1, 92900)
(STARFRUIT, MARKET << US, 5054, 1, 92900)
(STARFRUIT, MARKET << US, 5054, 1, 92900)
(STARFRUIT, MARKET << US, 5054, 1, 92900)
(STARFRUIT, MARKET << US, 5054, 1, 92900)","{""AMETHYSTS"": 15, ""STARFRUIT"": 4}",916,5058,9998
93200,110164,-59122,"(AMETHYSTS, US << MARKET, 10004, 1, 93200)
(AMETHYSTS, US << MARKET, 10004, 1, 93200)
(AMETHYSTS, US << MARKET, 10004, 1, 93200)
(AMETHYSTS, US << MARKET, 10004, 1, 93200)
(AMETHYSTS, MARKET << US, 10005, 1, 93200)
(AMETHYSTS, MARKET << US, 10005, 1, 93200)
(AMETHYSTS, MARKET << US, 10005, 1, 93200)
(AMETHYSTS, MARKET << US, 10005, 1, 93200)
(AMETHYSTS, MARKET << US, 10005, 1, 93200)
(AMETHYSTS, MARKET << US, 10005, 1, 93200)
(AMETHYSTS, MARKET << US, 10004, 1, 93200)
(AMETHYSTS, MARKET << US, 10005, 1, 93200)
(AMETHYSTS, MARKET << US, 10005, 1, 93200)
(AMETHYSTS, MARKET << US, 10004, 1, 93200)
(AMETHYSTS, MARKET << US, 10004, 1, 93200)
(AMETHYSTS, MARKET << US, 10002, 1, 93200)
(AMETHYSTS, MARKET << US, 10002, 1, 93200)
(AMETHYSTS, MARKET << US, 10002, 1, 93200)
(STARFRUIT, MARKET << US, 5061, 1, 93200)
(STARFRUIT, MARKET << US, 5061, 1, 93200)","{""AMETHYSTS"": 5, ""STARFRUIT"": 2}",1009,5058,10003
93300,-10002,-69124,"(AMETHYSTS, US << MARKET, 10002, 1, 93300)","{""AMETHYSTS"": 6, ""STARFRUIT"": 2}",986,5058,9999
93700,-10122,-79246,"(STARFRUIT, US << MARKET, 5061, 1, 93700)
(STARFRUIT, US << MARKET, 5061, 1, 93700)","{""AMETHYSTS"": 6, ""STARFRUIT"": 4}",986,5058,10000
94000,-10124,-89370,"(STARFRUIT, US << MARKET, 5062, 1, 94000)
(STARFRUIT, US << MARKET, 5062, 1, 94000)","{""AMETHYSTS"": 6, ""STARFRUIT"": 6}",1002,5062,10000
94400,-10234,-99604,"(AMETHYSTS, MARKET << US, 9998, 1, 94400)
(STARFRUIT, US << MARKET, 5058, 1, 94400)
(STARFRUIT, US << MARKET, 5058, 1, 94400)
(STARFRUIT, US << MARKET, 5058, 1, 94400)
(STARFRUIT, US << MARKET, 5058, 1, 94400)","{""AMETHYSTS"": 5, ""STARFRUIT"": 10}",971,5057,10001
94700,10128,-89476,"(STARFRUIT, US << MARKET, 5064, 1, 94700)
(STARFRUIT, US << MARKET, 5064, 1, 94700)
(STARFRUIT, US << MARKET, 5064, 1, 94700)
(STARFRUIT, US << MARKET, 5064, 1, 94700)
(STARFRUIT, MARKET << US, 5064, 1, 94700)
(STARFRUIT, MARKET << US, 5064, 1, 94700)
(STARFRUIT, MARKET << US, 5064, 1, 94700)
(STARFRUIT, MARKET << US, 5064, 1, 94700)
(STARFRUIT, MARKET << US, 5064, 1, 94700)
(STARFRUIT, MARKET << US, 5064, 1, 94700)","{""AMETHYSTS"": 5, ""STARFRUIT"": 8}",1004,5060,10000
95500,-19996,-109472,"(AMETHYSTS, US << MARKET, 9998, 1, 95500)
(AMETHYSTS, US << MARKET, 9998, 1, 95500)","{""AMETHYSTS"": 7, ""STARFRUIT"": 8}",1007,5059,10001
95700,9998,-99474,"(AMETHYSTS, MARKET << US, 9998, 1, 95700)","{""AMETHYSTS"": 6, ""STARFRUIT"": 8}",980,5059,9997
95800,10108,-89366,"(AMETHYSTS, US << MARKET, 9998, 1, 95800)
(AMETHYSTS, US << MARKET, 9998, 1, 95800)
(AMETHYSTS, MARKET << US, 9996, 1, 95800)
(AMETHYSTS, MARKET << US, 9996, 1, 95800)
(STARFRUIT, MARKET << US, 5056, 1, 95800)
(STARFRUIT, MARKET << US, 5056, 1, 95800)","{""AMETHYSTS"": 6, ""STARFRUIT"": 6}",970,5059,9997
96600,-4946,-94312,"(AMETHYSTS, US << MARKET, 10002, 1, 96600)
(STARFRUIT, MARKET << US, 5056, 1, 96600)","{""AMETHYSTS"": 7, ""STARFRUIT"": 5}",1009,5060,10003
96900,5060,-89252,"(STARFRUIT, MARKET << US, 5060, 1, 96900)","{""AMETHYSTS"": 7, ""STARFRUIT"": 4}",992,5061,10000
97100,30126,-59126,"(AMETHYSTS, MARKET << US, 10004, 1, 97100)
(AMETHYSTS, MARKET << US, 10004, 1, 97100)
(STARFRUIT, MARKET << US, 5059, 1, 97100)
(STARFRUIT, MARKET << US, 5059, 1, 97100)","{""AMETHYSTS"": 5, ""STARFRUIT"": 2}",990,5058,10000
97200,-20216,-79342,"(STARFRUIT, US << MARKET, 5054, 1, 97200)
(STARFRUIT, US << MARKET, 5054, 1, 97200)
(STARFRUIT, US << MARKET, 5054, 1, 97200)
(STARFRUIT, US << MARKET, 5054, 1, 97200)","{""AMETHYSTS"": 5, ""STARFRUIT"": 6}",995,5057,9999
97800,-4946,-84288,"(AMETHYSTS, US << MARKET, 10005, 1, 97800)
(STARFRUIT, MARKET << US, 5059, 1, 97800)","{""AMETHYSTS"": 6, ""STARFRUIT"": 5}",987,5055,10000
98700,-35179,-119467,"(AMETHYSTS, US << MARKET, 10004, 1, 98700)
(AMETHYSTS, US << MARKET, 10004, 1, 98700)
(STARFRUIT, US << MARKET, 5057, 1, 98700)
(STARFRUIT, US << MARKET, 5057, 1, 98700)
(STARFRUIT, US << MARKET, 5057, 1, 98700)","{""AMETHYSTS"": 8, ""STARFRUIT"": 8}",965,5054,10000
98800,-49874,-169341,"(AMETHYSTS, US << MARKET, 9996, 1, 98800)
(AMETHYSTS, US << MARKET, 9996, 1, 98800)
(AMETHYSTS, US << MARKET, 9996, 1, 98800)
(AMETHYSTS, US << MARKET, 9996, 1, 98800)
(AMETHYSTS, US << MARKET, 9996, 1, 98800)
(AMETHYSTS, US << MARKET, 9998, 1, 98800)
(STARFRUIT, MARKET << US, 5052, 1, 98800)
(STARFRUIT, MARKET << US, 5052, 1, 98800)","{""AMETHYSTS"": 14, ""STARFRUIT"": 6}",947,5055,9997
98900,-20220,-189561,"(STARFRUIT, US << MARKET, 5055, 1, 98900)
(STARFRUIT, US << MARKET, 5055, 1, 98900)
(STARFRUIT, US << MARKET, 5055, 1, 98900)
(STARFRUIT, US << MARKET, 5055, 1, 98900)","{""AMETHYSTS"": 14, ""STARFRUIT"": 10}",999,5056,10000
99400,-5055,-194616,"(STARFRUIT, US << MARKET, 5055, 1, 99400)","{""AMETHYSTS"": 14, ""STARFRUIT"": 11}",889,5051,9996
99800,4947,-189669,"(AMETHYSTS, MARKET << US, 9998, 1, 99800)
(STARFRUIT, US << MARKET, 5051, 1, 99800)","{""AMETHYSTS"": 13, ""STARFRUIT"": 12}",956,5051,10001
100100,-5050,-194719,"(STARFRUIT, US << MARKET, 5050, 1, 100100)","{""AMETHYSTS"": 13, ""STARFRUIT"": 13}",970,5053,10000
100400,4948,-189771,"(AMETHYSTS, MARKET << US, 9998, 1, 100400)
(STARFRUIT, US << MARKET, 5050, 1, 100400)","{""AMETHYSTS"": 12, ""STARFRUIT"": 14}",935,5053,9997
100600,-14942,-204713,"(AMETHYSTS, US << MARKET, 9998, 1, 100600)
(AMETHYSTS, US << MARKET, 9998, 1, 100600)
(STARFRUIT, MARKET << US, 5054, 1, 100600)","{""AMETHYSTS"": 14, ""STARFRUIT"": 13}",947,5054,9997
100900,-10002,-214715,"(AMETHYSTS, US << MARKET, 10002, 1, 100900)","{""AMETHYSTS"": 15, ""STARFRUIT"": 13}",918,5051,9998
101100,30318,-184397,"(STARFRUIT, US << MARKET, 5053, 1, 101100)
(STARFRUIT, MARKET << US, 5053, 1, 101100)
(STARFRUIT, MARKET << US, 5053, 1, 101100)
(STARFRUIT, MARKET << US, 5053, 1, 101100)
(STARFRUIT, MARKET << US, 5053, 1, 101100)
(STARFRUIT, MARKET << US, 5053, 1, 101100)
(STARFRUIT, MARKET << US, 5053, 1, 101100)
(STARFRUIT, MARKET << US, 5053, 1, 101100)","{""AMETHYSTS"": 15, ""STARFRUIT"": 7}",981,5054,10000
101700,25050,-159347,"(AMETHYSTS, MARKET << US, 10002, 1, 101700)
(AMETHYSTS, MARKET << US, 10002, 1, 101700)
(STARFRUIT, MARKET << US, 5046, 1, 101700)","{""AMETHYSTS"": 13, ""STARFRUIT"": 6}",986,5049,10003
101900,-10092,-169439,"(STARFRUIT, US << MARKET, 5046, 1, 101900)
(STARFRUIT, US << MARKET, 5046, 1, 101900)
(STARFRUIT, US << MARKET, 5046, 1, 101900)
(STARFRUIT, US << MARKET, 5046, 1, 101900)
(STARFRUIT, MARKET << US, 5046, 1, 101900)
(STARFRUIT, MARKET << US, 5046, 1, 101900)","{""AMETHYSTS"": 13, ""STARFRUIT"": 8}",921,5045,10000
102300,87,-169352,"(AMETHYSTS, US << MARKET, 10005, 1, 102300)
(STARFRUIT, MARKET << US, 5046, 1, 102300)
(STARFRUIT, MARKET << US, 5046, 1, 102300)","{""AMETHYSTS"": 14, ""STARFRUIT"": 6}",932,5045,10001
102400,40376,-128976,"(STARFRUIT, MARKET << US, 5047, 1, 102400)
(STARFRUIT, MARKET << US, 5047, 1, 102400)
(STARFRUIT, MARKET << US, 5047, 1, 102400)
(STARFRUIT, MARKET << US, 5047, 1, 102400)
(STARFRUIT, MARKET << US, 5047, 1, 102400)
(STARFRUIT, MARKET << US, 5047, 1, 102400)
(STARFRUIT, MARKET << US, 5047, 1, 102400)
(STARFRUIT, MARKET << US, 5047, 1, 102400)","{""AMETHYSTS"": 14, ""STARFRUIT"": -2}",932,5046,10000
102600,-50278,-179254,"(AMETHYSTS, US << MARKET, 9998, 1, 102600)
(AMETHYSTS, US << MARKET, 9998, 1, 102600)
(STARFRUIT, US << MARKET, 5047, 1, 102600)
(STARFRUIT, US << MARKET, 5047, 1, 102600)
(STARFRUIT, US << MARKET, 5047, 1, 102600)
(STARFRUIT, US << MARKET, 5047, 1, 102600)
(STARFRUIT, US << MARKET, 5047, 1, 102600)
(STARFRUIT, US << MARKET, 5047, 1, 102600)","{""AMETHYSTS"": 16, ""STARFRUIT"": 4}",962,5050,10001
102900,-10104,-189358,"(STARFRUIT, US << MARKET, 5052, 1, 102900)
(STARFRUIT, US << MARKET, 5052, 1, 102900)","{""AMETHYSTS"": 16, ""STARFRUIT"": 6}",938,5052,9999
103100,25245,-164113,"(STARFRUIT, MARKET << US, 5049, 1, 103100)
(STARFRUIT, MARKET << US, 5049, 1, 103100)
(STARFRUIT, MARKET << US, 5049, 1, 103100)
(STARFRUIT, MARKET << US, 5049, 1, 103100)
(STARFRUIT, MARKET << US, 5049, 1, 103100)","{""AMETHYSTS"": 16, ""STARFRUIT"": 1}",902,5047,9998
103700,-19996,-184109,"(AMETHYSTS, US << MARKET, 9998, 1, 103700)
(AMETHYSTS, US << MARKET, 9998, 1, 103700)","{""AMETHYSTS"": 18, ""STARFRUIT"": 1}",867,5048,9996
103900,-19996,-204105,"(AMETHYSTS, US << MARKET, 9998, 1, 103900)
(AMETHYSTS, US << MARKET, 9998, 1, 103900)","{""AMETHYSTS"": 20, ""STARFRUIT"": 1}",963,5048,10001
104000,0,-204105,,"{""AMETHYSTS"": 20, ""STARFRUIT"": 1}",883,5048,9997
104800,0,-204105,,"{""AMETHYSTS"": 20, ""STARFRUIT"": 1}",964,5049,10001
105000,49975,-154130,"(AMETHYSTS, MARKET << US, 9995, 1, 105000)
(AMETHYSTS, MARKET << US, 9995, 1, 105000)
(AMETHYSTS, MARKET << US, 9995, 1, 105000)
(AMETHYSTS, MARKET << US, 9995, 1, 105000)
(AMETHYSTS, MARKET << US, 9995, 1, 105000)","{""AMETHYSTS"": 15, ""STARFRUIT"": 1}",920,5050,10000
105500,-10098,-164228,"(STARFRUIT, US << MARKET, 5049, 1, 105500)
(STARFRUIT, US << MARKET, 5049, 1, 105500)","{""AMETHYSTS"": 15, ""STARFRUIT"": 3}",925,5051,10000
105700,29994,-134234,"(AMETHYSTS, MARKET << US, 9998, 1, 105700)
(AMETHYSTS, MARKET << US, 9998, 1, 105700)
(AMETHYSTS, MARKET << US, 9998, 1, 105700)","{""AMETHYSTS"": 12, ""STARFRUIT"": 3}",901,5053,9998
105800,-25250,-159484,"(STARFRUIT, US << MARKET, 5050, 1, 105800)
(STARFRUIT, US << MARKET, 5050, 1, 105800)
(STARFRUIT, US << MARKET, 5050, 1, 105800)
(STARFRUIT, US << MARKET, 5050, 1, 105800)
(STARFRUIT, US << MARKET, 5050, 1, 105800)","{""AMETHYSTS"": 12, ""STARFRUIT"": 8}",908,5049,10000
106100,20004,-139480,"(AMETHYSTS, MARKET << US, 10002, 1, 106100)
(AMETHYSTS, MARKET << US, 10002, 1, 106100)","{""AMETHYSTS"": 10, ""STARFRUIT"": 8}",918,5051,9999
106300,5047,-134433,"(STARFRUIT, MARKET << US, 5047, 1, 106300)","{""AMETHYSTS"": 10, ""STARFRUIT"": 7}",917,5050,10000
106400,-15141,-149574,"(STARFRUIT, US << MARKET, 5047, 1, 106400)
(STARFRUIT, US << MARKET, 5047, 1, 106400)
(STARFRUIT, US << MARKET, 5047, 1, 106400)
(STARFRUIT, US << MARKET, 5047, 1, 106400)
(STARFRUIT, MARKET << US, 5047, 1, 106400)","{""AMETHYSTS"": 10, ""STARFRUIT"": 10}",926,5050,10000
106500,25063,-124511,"(AMETHYSTS, MARKET << US, 10005, 1, 106500)
(AMETHYSTS, MARKET << US, 10005, 1, 106500)
(STARFRUIT, MARKET << US, 5053, 1, 106500)","{""AMETHYSTS"": 8, ""STARFRUIT"": 9}",947,5050,10001
106800,4952,-119559,"(AMETHYSTS, MARKET << US, 9998, 1, 106800)
(STARFRUIT, US << MARKET, 5046, 1, 106800)","{""AMETHYSTS"": 7, ""STARFRUIT"": 10}",938,5049,10001
107600,-5047,-124606,"(STARFRUIT, US << MARKET, 5047, 1, 107600)","{""AMETHYSTS"": 7, ""STARFRUIT"": 11}",930,5050,9998
107800,4950,-119656,"(AMETHYSTS, MARKET << US, 9996, 1, 107800)
(STARFRUIT, US << MARKET, 5046, 1, 107800)","{""AMETHYSTS"": 6, ""STARFRUIT"": 12}",920,5048,10000
107900,-5051,-124707,"(STARFRUIT, US << MARKET, 5051, 1, 107900)","{""AMETHYSTS"": 6, ""STARFRUIT"": 13}",944,5051,9998
108000,-20188,-144895,"(STARFRUIT, US << MARKET, 5047, 1, 108000)
(STARFRUIT, US << MARKET, 5047, 1, 108000)
(STARFRUIT, US << MARKET, 5047, 1, 108000)
(STARFRUIT, US << MARKET, 5047, 1, 108000)","{""AMETHYSTS"": 6, ""STARFRUIT"": 17}",961,5050,10001
108300,-19996,-164891,"(AMETHYSTS, US << MARKET, 9998, 1, 108300)
(AMETHYSTS, US << MARKET, 9998, 1, 108300)","{""AMETHYSTS"": 8, ""STARFRUIT"": 17}",898,5045,10003
108600,-99980,-264871,"(AMETHYSTS, US << MARKET, 9998, 1, 108600)
(AMETHYSTS, US << MARKET, 9998, 1, 108600)
(AMETHYSTS, US << MARKET, 9998, 1, 108600)
(AMETHYSTS, US << MARKET, 9998, 1, 108600)
(AMETHYSTS, US << MARKET, 9998, 1, 108600)
(AMETHYSTS, US << MARKET, 9998, 1, 108600)
(AMETHYSTS, US << MARKET, 9998, 1, 108600)
(AMETHYSTS, US << MARKET, 9998, 1, 108600)
(AMETHYSTS, US << MARKET, 9998, 1, 108600)
(AMETHYSTS, US << MARKET, 9998, 1, 108600)","{""AMETHYSTS"": 18, ""STARFRUIT"": 17}",908,5049,9997
108800,5151,-259720,"(AMETHYSTS, US << MARKET, 10004, 1, 108800)
(STARFRUIT, MARKET << US, 5052, 1, 108800)
(STARFRUIT, MARKET << US, 5052, 1, 108800)
(STARFRUIT, MARKET << US, 5051, 1, 108800)","{""AMETHYSTS"": 19, ""STARFRUIT"": 14}",994,5051,10000
108900,-9996,-269716,"(AMETHYSTS, US << MARKET, 9996, 1, 108900)","{""AMETHYSTS"": 20, ""STARFRUIT"": 14}",936,5048,9999
109000,-5046,-274762,"(STARFRUIT, US << MARKET, 5046, 1, 109000)","{""AMETHYSTS"": 20, ""STARFRUIT"": 15}",993,5049,10001
109100,25250,-249512,"(STARFRUIT, MARKET << US, 5050, 1, 109100)
(STARFRUIT, MARKET << US, 5050, 1, 109100)
(STARFRUIT, MARKET << US, 5050, 1, 109100)
(STARFRUIT, MARKET << US, 5050, 1, 109100)
(STARFRUIT, MARKET << US, 5050, 1, 109100)","{""AMETHYSTS"": 20, ""STARFRUIT"": 10}",938,5047,9999
109200,30300,-219212,"(STARFRUIT, MARKET << US, 5050, 1, 109200)
(STARFRUIT, MARKET << US, 5050, 1, 109200)
(STARFRUIT, MARKET << US, 5050, 1, 109200)
(STARFRUIT, MARKET << US, 5050, 1, 109200)
(STARFRUIT, MARKET << US, 5050, 1, 109200)
(STARFRUIT, MARKET << US, 5050, 1, 109200)","{""AMETHYSTS"": 20, ""STARFRUIT"": 4}",992,5051,10000
109600,-10090,-229302,"(STARFRUIT, US << MARKET, 5045, 1, 109600)
(STARFRUIT, US << MARKET, 5045, 1, 109600)","{""AMETHYSTS"": 20, ""STARFRUIT"": 6}",1000,5047,10001
109700,-10102,-239404,"(STARFRUIT, US << MARKET, 5051, 1, 109700)
(STARFRUIT, US << MARKET, 5051, 1, 109700)","{""AMETHYSTS"": 20, ""STARFRUIT"": 8}",980,5048,10000
110200,-5044,-244448,"(STARFRUIT, US << MARKET, 5044, 1, 110200)","{""AMETHYSTS"": 20, ""STARFRUIT"": 9}",975,5047,10000
110500,30264,-214184,"(STARFRUIT, MARKET << US, 5044, 1, 110500)
(STARFRUIT, MARKET << US, 5044, 1, 110500)
(STARFRUIT, MARKET << US, 5044, 1, 110500)
(STARFRUIT, MARKET << US, 5044, 1, 110500)
(STARFRUIT, MARKET << US, 5044, 1, 110500)
(STARFRUIT, MARKET << US, 5044, 1, 110500)","{""AMETHYSTS"": 20, ""STARFRUIT"": 3}",954,5046,10000
110600,9998,-204186,"(AMETHYSTS, MARKET << US, 9998, 1, 110600)","{""AMETHYSTS"": 19, ""STARFRUIT"": 3}",898,5047,9997
110700,20004,-184182,"(AMETHYSTS, MARKET << US, 10002, 1, 110700)
(AMETHYSTS, MARKET << US, 10002, 1, 110700)","{""AMETHYSTS"": 17, ""STARFRUIT"": 3}",1010,5047,10003
111000,-25245,-209427,"(STARFRUIT, US << MARKET, 5049, 1, 111000)
(STARFRUIT, US << MARKET, 5049, 1, 111000)
(STARFRUIT, US << MARKET, 5049, 1, 111000)
(STARFRUIT, US << MARKET, 5049, 1, 111000)
(STARFRUIT, US << MARKET, 5049, 1, 111000)","{""AMETHYSTS"": 17, ""STARFRUIT"": 8}",973,5050,10000
111100,-5044,-214471,"(STARFRUIT, US << MARKET, 5044, 1, 111100)","{""AMETHYSTS"": 17, ""STARFRUIT"": 9}",952,5047,10000
111200,-5044,-219515,"(STARFRUIT, US << MARKET, 5044, 1, 111200)","{""AMETHYSTS"": 17, ""STARFRUIT"": 10}",932,5043,10001
111300,-5043,-224558,"(STARFRUIT, US << MARKET, 5043, 1, 111300)","{""AMETHYSTS"": 17, ""STARFRUIT"": 11}",920,5045,9999
111800,-15053,-239611,"(AMETHYSTS, US << MARKET, 10004, 1, 111800)
(STARFRUIT, US << MARKET, 5049, 1, 111800)","{""AMETHYSTS"": 18, ""STARFRUIT"": 12}",941,5046,10000
112000,-10096,-249707,"(STARFRUIT, US << MARKET, 5048, 1, 112000)
(STARFRUIT, US << MARKET, 5048, 1, 112000)","{""AMETHYSTS"": 18, ""STARFRUIT"": 14}",937,5046,10000
112300,5043,-244664,"(STARFRUIT, MARKET << US, 5043, 1, 112300)","{""AMETHYSTS"": 18, ""STARFRUIT"": 13}",947,5047,10000
112800,20188,-224476,"(STARFRUIT, MARKET << US, 5047, 1, 112800)
(STARFRUIT, MARKET << US, 5047, 1, 112800)
(STARFRUIT, MARKET << US, 5047, 1, 112800)
(STARFRUIT, MARKET << US, 5047, 1, 112800)","{""AMETHYSTS"": 18, ""STARFRUIT"": 9}",920,5048,9998
113500,5048,-219428,"(STARFRUIT, MARKET << US, 5048, 1, 113500)","{""AMETHYSTS"": 18, ""STARFRUIT"": 8}",974,5048,10001
113900,20004,-199424,"(AMETHYSTS, MARKET << US, 10002, 1, 113900)
(AMETHYSTS, MARKET << US, 10002, 1, 113900)","{""AMETHYSTS"": 16, ""STARFRUIT"": 8}",936,5045,10000
114300,25054,-174370,"(AMETHYSTS, MARKET << US, 10004, 1, 114300)
(AMETHYSTS, MARKET << US, 10004, 1, 114300)
(STARFRUIT, MARKET << US, 5046, 1, 114300)","{""AMETHYSTS"": 14, ""STARFRUIT"": 7}",938,5044,10000
114500,104914,-69456,"(AMETHYSTS, MARKET << US, 9996, 1, 114500)
(AMETHYSTS, MARKET << US, 9996, 1, 114500)
(AMETHYSTS, MARKET << US, 9996, 1, 114500)
(AMETHYSTS, MARKET << US, 9996, 1, 114500)
(AMETHYSTS, MARKET << US, 9996, 1, 114500)
(AMETHYSTS, MARKET << US, 9996, 1, 114500)
(AMETHYSTS, MARKET << US, 9996, 1, 114500)
(AMETHYSTS, MARKET << US, 9996, 1, 114500)
(AMETHYSTS, MARKET << US, 9996, 1, 114500)
(AMETHYSTS, MARKET << US, 9996, 1, 114500)
(AMETHYSTS, MARKET << US, 9996, 1, 114500)
(STARFRUIT, US << MARKET, 5042, 1, 114500)","{""AMETHYSTS"": 3, ""STARFRUIT"": 8}",904,5045,10000
114600,-20192,-89648,"(STARFRUIT, US << MARKET, 5048, 1, 114600)
(STARFRUIT, US << MARKET, 5048, 1, 114600)
(STARFRUIT, US << MARKET, 5048, 1, 114600)
(STARFRUIT, US << MARKET, 5048, 1, 114600)","{""AMETHYSTS"": 3, ""STARFRUIT"": 12}",892,5045,10000
115100,35322,-54326,"(STARFRUIT, MARKET << US, 5046, 1, 115100)
(STARFRUIT, MARKET << US, 5046, 1, 115100)
(STARFRUIT, MARKET << US, 5046, 1, 115100)
(STARFRUIT, MARKET << US, 5046, 1, 115100)
(STARFRUIT, MARKET << US, 5046, 1, 115100)
(STARFRUIT, MARKET << US, 5046, 1, 115100)
(STARFRUIT, MARKET << US, 5046, 1, 115100)","{""AMETHYSTS"": 3, ""STARFRUIT"": 5}",904,5046,10000
116100,-20097,-74423,"(AMETHYSTS, US << MARKET, 10005, 1, 116100)
(STARFRUIT, US << MARKET, 5046, 1, 116100)
(STARFRUIT, US << MARKET, 5046, 1, 116100)","{""AMETHYSTS"": 4, ""STARFRUIT"": 7}",878,5043,10000
116300,19992,-54431,"(AMETHYSTS, MARKET << US, 9996, 1, 116300)
(AMETHYSTS, MARKET << US, 9996, 1, 116300)","{""AMETHYSTS"": 2, ""STARFRUIT"": 7}",864,5043,9997
116400,20092,-34339,"(AMETHYSTS, MARKET << US, 9998, 1, 116400)
(STARFRUIT, MARKET << US, 5047, 1, 116400)
(STARFRUIT, MARKET << US, 5047, 1, 116400)","{""AMETHYSTS"": 1, ""STARFRUIT"": 5}",878,5044,9997
116600,10084,-24255,"(STARFRUIT, US << MARKET, 5042, 1, 116600)
(STARFRUIT, US << MARKET, 5042, 1, 116600)
(STARFRUIT, US << MARKET, 5042, 1, 116600)
(STARFRUIT, MARKET << US, 5042, 1, 116600)
(STARFRUIT, MARKET << US, 5042, 1, 116600)
(STARFRUIT, MARKET << US, 5042, 1, 116600)
(STARFRUIT, MARKET << US, 5042, 1, 116600)
(STARFRUIT, MARKET << US, 5042, 1, 116600)","{""AMETHYSTS"": 1, ""STARFRUIT"": 3}",868,5041,10000
116800,4870,-19385,"(AMETHYSTS, MARKET << US, 9995, 1, 116800)
(AMETHYSTS, MARKET << US, 9995, 1, 116800)
(STARFRUIT, US << MARKET, 5040, 1, 116800)
(STARFRUIT, US << MARKET, 5040, 1, 116800)
(STARFRUIT, US << MARKET, 5040, 1, 116800)","{""AMETHYSTS"": -1, ""STARFRUIT"": 6}",873,5043,10000
116900,-20164,-39549,"(STARFRUIT, US << MARKET, 5041, 1, 116900)
(STARFRUIT, US << MARKET, 5041, 1, 116900)
(STARFRUIT, US << MARKET, 5041, 1, 116900)
(STARFRUIT, US << MARKET, 5041, 1, 116900)","{""AMETHYSTS"": -1, ""STARFRUIT"": 10}",851,5040,10000
117100,5045,-34504,"(STARFRUIT, MARKET << US, 5045, 1, 117100)","{""AMETHYSTS"": -1, ""STARFRUIT"": 9}",875,5042,9999
117300,30251,-4253,"(STARFRUIT, MARKET << US, 5046, 1, 117300)
(STARFRUIT, MARKET << US, 5041, 1, 117300)
(STARFRUIT, MARKET << US, 5041, 1, 117300)
(STARFRUIT, MARKET << US, 5041, 1, 117300)
(STARFRUIT, MARKET << US, 5041, 1, 117300)
(STARFRUIT, MARKET << US, 5041, 1, 117300)","{""AMETHYSTS"": -1, ""STARFRUIT"": 3}",867,5040,10000
117500,40008,35755,"(AMETHYSTS, MARKET << US, 10002, 1, 117500)
(AMETHYSTS, MARKET << US, 10002, 1, 117500)
(AMETHYSTS, MARKET << US, 10002, 1, 117500)
(AMETHYSTS, MARKET << US, 10002, 1, 117500)","{""AMETHYSTS"": -5, ""STARFRUIT"": 3}",886,5042,9999
117800,15126,50881,"(STARFRUIT, MARKET << US, 5042, 1, 117800)
(STARFRUIT, MARKET << US, 5042, 1, 117800)
(STARFRUIT, MARKET << US, 5042, 1, 117800)","{""AMETHYSTS"": -5, ""STARFRUIT"": 0}",886,5041,9999
117900,-19996,30885,"(AMETHYSTS, US << MARKET, 9998, 1, 117900)
(AMETHYSTS, US << MARKET, 9998, 1, 117900)","{""AMETHYSTS"": -3, ""STARFRUIT"": 0}",894,5045,9997
118100,-30102,783,"(AMETHYSTS, US << MARKET, 10005, 1, 118100)
(AMETHYSTS, US << MARKET, 10005, 1, 118100)
(STARFRUIT, US << MARKET, 5046, 1, 118100)
(STARFRUIT, US << MARKET, 5046, 1, 118100)","{""AMETHYSTS"": -1, ""STARFRUIT"": 2}",866,5043,10003
118200,-35135,-34352,"(AMETHYSTS, US << MARKET, 10002, 1, 118200)
(AMETHYSTS, US << MARKET, 10002, 1, 118200)
(STARFRUIT, US << MARKET, 5045, 1, 118200)
(STARFRUIT, US << MARKET, 5045, 1, 118200)
(STARFRUIT, US << MARKET, 5045, 1, 118200)
(STARFRUIT, US << MARKET, 5045, 1, 118200)
(STARFRUIT, US << MARKET, 5045, 1, 118200)
(STARFRUIT, MARKET << US, 5047, 1, 118200)
(STARFRUIT, MARKET << US, 5047, 1, 118200)","{""AMETHYSTS"": 1, ""STARFRUIT"": 5}",877,5046,9999
118300,39852,5500,"(AMETHYSTS, MARKET << US, 10002, 1, 118300)
(AMETHYSTS, MARKET << US, 10002, 1, 118300)
(AMETHYSTS, MARKET << US, 10002, 1, 118300)
(AMETHYSTS, MARKET << US, 10002, 1, 118300)
(AMETHYSTS, MARKET << US, 10002, 1, 118300)
(AMETHYSTS, MARKET << US, 10002, 1, 118300)
(STARFRUIT, US << MARKET, 5040, 1, 118300)
(STARFRUIT, US << MARKET, 5040, 1, 118300)
(STARFRUIT, US << MARKET, 5040, 1, 118300)
(STARFRUIT, US << MARKET, 5040, 1, 118300)","{""AMETHYSTS"": -5, ""STARFRUIT"": 9}",845,5040,10003
119000,-89966,-84466,"(AMETHYSTS, US << MARKET, 9996, 1, 119000)
(AMETHYSTS, US << MARKET, 9996, 1, 119000)
(AMETHYSTS, US << MARKET, 9996, 1, 119000)
(AMETHYSTS, US << MARKET, 9996, 1, 119000)
(AMETHYSTS, US << MARKET, 9996, 1, 119000)
(AMETHYSTS, US << MARKET, 9996, 1, 119000)
(AMETHYSTS, US << MARKET, 9996, 1, 119000)
(AMETHYSTS, US << MARKET, 9996, 1, 119000)
(AMETHYSTS, US << MARKET, 9996, 1, 119000)
(AMETHYSTS, US << MARKET, 9998, 1, 119000)
(AMETHYSTS, MARKET << US, 9996, 1, 119000)","{""AMETHYSTS"": 4, ""STARFRUIT"": 9}",927,5045,9997
119100,20004,-64462,"(AMETHYSTS, MARKET << US, 10002, 1, 119100)
(AMETHYSTS, MARKET << US, 10002, 1, 119100)","{""AMETHYSTS"": 2, ""STARFRUIT"": 9}",940,5044,10003
119200,19992,-44470,"(AMETHYSTS, MARKET << US, 9996, 1, 119200)
(AMETHYSTS, MARKET << US, 9996, 1, 119200)
(STARFRUIT, US << MARKET, 5042, 1, 119200)
(STARFRUIT, MARKET << US, 5042, 1, 119200)","{""AMETHYSTS"": 0, ""STARFRUIT"": 9}",935,5045,10000
119800,-5042,-49512,"(STARFRUIT, US << MARKET, 5042, 1, 119800)","{""AMETHYSTS"": 0, ""STARFRUIT"": 10}",948,5046,10000
119900,-5048,-54560,"(STARFRUIT, US << MARKET, 5048, 1, 119900)","{""AMETHYSTS"": 0, ""STARFRUIT"": 11}",935,5045,9999
120100,0,-54560,"(STARFRUIT, US << MARKET, 5047, 1, 120100)
(STARFRUIT, US << MARKET, 5047, 1, 120100)
(STARFRUIT, US << MARKET, 5047, 1, 120100)
(STARFRUIT, US << MARKET, 5047, 1, 120100)
(STARFRUIT, MARKET << US, 5047, 1, 120100)
(STARFRUIT, MARKET << US, 5047, 1, 120100)
(STARFRUIT, MARKET << US, 5047, 1, 120100)
(STARFRUIT, MARKET << US, 5047, 1, 120100)","{""AMETHYSTS"": 0, ""STARFRUIT"": 11}",957,5047,10000
120200,14962,-39598,"(AMETHYSTS, MARKET << US, 10002, 1, 120200)
(AMETHYSTS, MARKET << US, 10002, 1, 120200)
(STARFRUIT, US << MARKET, 5042, 1, 120200)","{""AMETHYSTS"": -2, ""STARFRUIT"": 12}",924,5044,10003
120900,-20004,-59602,"(AMETHYSTS, US << MARKET, 10002, 1, 120900)
(AMETHYSTS, US << MARKET, 10002, 1, 120900)","{""AMETHYSTS"": 0, ""STARFRUIT"": 12}",914,5043,10003
121000,25058,-34544,"(AMETHYSTS, MARKET << US, 10004, 1, 121000)
(AMETHYSTS, MARKET << US, 10004, 1, 121000)
(STARFRUIT, MARKET << US, 5050, 1, 121000)","{""AMETHYSTS"": -2, ""STARFRUIT"": 11}",962,5046,10000
121300,14963,-19581,"(AMETHYSTS, MARKET << US, 10004, 1, 121300)
(AMETHYSTS, MARKET << US, 10004, 1, 121300)
(STARFRUIT, US << MARKET, 5045, 1, 121300)","{""AMETHYSTS"": -4, ""STARFRUIT"": 12}",947,5044,10000
121600,45062,25481,"(AMETHYSTS, MARKET << US, 10002, 1, 121600)
(AMETHYSTS, MARKET << US, 10002, 1, 121600)
(AMETHYSTS, MARKET << US, 10002, 1, 121600)
(AMETHYSTS, MARKET << US, 10002, 1, 121600)
(STARFRUIT, US << MARKET, 5050, 1, 121600)
(STARFRUIT, MARKET << US, 5052, 1, 121600)
(STARFRUIT, MARKET << US, 5052, 1, 121600)","{""AMETHYSTS"": -8, ""STARFRUIT"": 11}",1050,5051,9999
121700,5050,30531,"(STARFRUIT, MARKET << US, 5050, 1, 121700)","{""AMETHYSTS"": -8, ""STARFRUIT"": 10}",1031,5050,10000
121800,-14946,15585,"(AMETHYSTS, US << MARKET, 9995, 1, 121800)
(AMETHYSTS, US << MARKET, 9995, 1, 121800)
(STARFRUIT, MARKET << US, 5044, 1, 121800)","{""AMETHYSTS"": -6, ""STARFRUIT"": 9}",1020,5047,9998
122200,-9900,5685,"(AMETHYSTS, US << MARKET, 9996, 1, 122200)
(AMETHYSTS, US << MARKET, 9996, 1, 122200)
(STARFRUIT, MARKET << US, 5046, 1, 122200)
(STARFRUIT, MARKET << US, 5046, 1, 122200)","{""AMETHYSTS"": -4, ""STARFRUIT"": 7}",1028,5049,10000
122500,9908,15593,"(AMETHYSTS, US << MARKET, 10002, 1, 122500)
(AMETHYSTS, US << MARKET, 10002, 1, 122500)
(AMETHYSTS, US << MARKET, 10002, 1, 122500)
(AMETHYSTS, US << MARKET, 10002, 1, 122500)
(AMETHYSTS, US << MARKET, 10002, 1, 122500)
(AMETHYSTS, US << MARKET, 10002, 1, 122500)
(AMETHYSTS, MARKET << US, 10004, 1, 122500)
(AMETHYSTS, MARKET << US, 10004, 1, 122500)
(AMETHYSTS, MARKET << US, 10004, 1, 122500)
(AMETHYSTS, MARKET << US, 10004, 1, 122500)
(AMETHYSTS, MARKET << US, 10004, 1, 122500)
(AMETHYSTS, MARKET << US, 10004, 1, 122500)
(AMETHYSTS, MARKET << US, 10002, 1, 122500)
(AMETHYSTS, MARKET << US, 10002, 1, 122500)
(STARFRUIT, US << MARKET, 5054, 1, 122500)
(STARFRUIT, US << MARKET, 5054, 1, 122500)","{""AMETHYSTS"": -6, ""STARFRUIT"": 9}",1058,5051,9999
122600,-79984,-64391,"(AMETHYSTS, US << MARKET, 9998, 1, 122600)
(AMETHYSTS, US << MARKET, 9998, 1, 122600)
(AMETHYSTS, US << MARKET, 9998, 1, 122600)
(AMETHYSTS, US << MARKET, 9998, 1, 122600)
(AMETHYSTS, US << MARKET, 9998, 1, 122600)
(AMETHYSTS, US << MARKET, 9998, 1, 122600)
(AMETHYSTS, US << MARKET, 9998, 1, 122600)
(AMETHYSTS, US << MARKET, 9998, 1, 122600)","{""AMETHYSTS"": 2, ""STARFRUIT"": 9}",1097,5054,10001
122700,-50010,-114401,"(AMETHYSTS, US << MARKET, 10002, 1, 122700)
(AMETHYSTS, US << MARKET, 10002, 1, 122700)
(AMETHYSTS, US << MARKET, 10002, 1, 122700)
(AMETHYSTS, US << MARKET, 10002, 1, 122700)
(AMETHYSTS, US << MARKET, 10002, 1, 122700)","{""AMETHYSTS"": 7, ""STARFRUIT"": 9}",1070,5050,10003
122800,5048,-109353,"(STARFRUIT, MARKET << US, 5048, 1, 122800)","{""AMETHYSTS"": 7, ""STARFRUIT"": 8}",1055,5051,10000
123100,20004,-89349,"(AMETHYSTS, MARKET << US, 10002, 1, 123100)
(AMETHYSTS, MARKET << US, 10002, 1, 123100)","{""AMETHYSTS"": 5, ""STARFRUIT"": 8}",1082,5052,10003
123200,-20208,-109557,"(STARFRUIT, US << MARKET, 5052, 1, 123200)
(STARFRUIT, US << MARKET, 5052, 1, 123200)
(STARFRUIT, US << MARKET, 5052, 1, 123200)
(STARFRUIT, US << MARKET, 5052, 1, 123200)","{""AMETHYSTS"": 5, ""STARFRUIT"": 12}",1028,5050,9997
123500,-45038,-154595,"(AMETHYSTS, US << MARKET, 9998, 1, 123500)
(AMETHYSTS, US << MARKET, 9998, 1, 123500)
(AMETHYSTS, US << MARKET, 9998, 1, 123500)
(AMETHYSTS, US << MARKET, 9998, 1, 123500)
(STARFRUIT, US << MARKET, 5046, 1, 123500)","{""AMETHYSTS"": 9, ""STARFRUIT"": 13}",1064,5050,10001
123700,-14946,-169541,"(AMETHYSTS, US << MARKET, 9996, 1, 123700)
(AMETHYSTS, US << MARKET, 9996, 1, 123700)
(STARFRUIT, MARKET << US, 5046, 1, 123700)","{""AMETHYSTS"": 11, ""STARFRUIT"": 12}",1047,5049,10000
123900,15044,-154497,"(AMETHYSTS, MARKET << US, 9998, 1, 123900)
(STARFRUIT, MARKET << US, 5046, 1, 123900)","{""AMETHYSTS"": 10, ""STARFRUIT"": 11}",998,5045,10000
124000,-10002,-164499,"(AMETHYSTS, US << MARKET, 10002, 1, 124000)","{""AMETHYSTS"": 11, ""STARFRUIT"": 11}",1062,5048,10003
124200,-100184,-264683,"(AMETHYSTS, US << MARKET, 9998, 1, 124200)
(AMETHYSTS, US << MARKET, 9998, 1, 124200)
(AMETHYSTS, US << MARKET, 9998, 1, 124200)
(AMETHYSTS, US << MARKET, 9998, 1, 124200)
(AMETHYSTS, US << MARKET, 9998, 1, 124200)
(AMETHYSTS, US << MARKET, 9998, 1, 124200)
(AMETHYSTS, US << MARKET, 9998, 1, 124200)
(AMETHYSTS, US << MARKET, 9998, 1, 124200)
(STARFRUIT, US << MARKET, 5050, 1, 124200)
(STARFRUIT, US << MARKET, 5050, 1, 124200)
(STARFRUIT, US << MARKET, 5050, 1, 124200)
(STARFRUIT, US << MARKET, 5050, 1, 124200)","{""AMETHYSTS"": 19, ""STARFRUIT"": 15}",1025,5051,9997
125200,-5055,-269738,"(STARFRUIT, US << MARKET, 5055, 1, 125200)","{""AMETHYSTS"": 19, ""STARFRUIT"": 16}",1161,5055,10001
125400,25065,-244673,"(AMETHYSTS, MARKET << US, 10004, 1, 125400)
(AMETHYSTS, MARKET << US, 10004, 1, 125400)
(STARFRUIT, MARKET << US, 5057, 1, 125400)","{""AMETHYSTS"": 17, ""STARFRUIT"": 15}",1122,5053,10000
125900,15048,-229625,"(AMETHYSTS, MARKET << US, 9998, 1, 125900)
(STARFRUIT, MARKET << US, 5050, 1, 125900)","{""AMETHYSTS"": 16, ""STARFRUIT"": 14}",1163,5054,10002
126200,5049,-224576,"(STARFRUIT, MARKET << US, 5049, 1, 126200)","{""AMETHYSTS"": 16, ""STARFRUIT"": 13}",1103,5051,10001
126400,-35050,-259626,"(AMETHYSTS, US << MARKET, 9998, 1, 126400)
(AMETHYSTS, US << MARKET, 9998, 1, 126400)
(AMETHYSTS, US << MARKET, 9998, 1, 126400)
(STARFRUIT, US << MARKET, 5056, 1, 126400)","{""AMETHYSTS"": 19, ""STARFRUIT"": 14}",1059,5053,9997
126600,5050,-254576,"(STARFRUIT, MARKET << US, 5050, 1, 126600)","{""AMETHYSTS"": 19, ""STARFRUIT"": 13}",1132,5053,10001
126700,0,-254576,"(AMETHYSTS, US << MARKET, 9998, 1, 126700)
(AMETHYSTS, MARKET << US, 9998, 1, 126700)","{""AMETHYSTS"": 19, ""STARFRUIT"": 13}",1030,5051,9997
126900,25059,-229517,"(AMETHYSTS, MARKET << US, 10002, 1, 126900)
(AMETHYSTS, MARKET << US, 10002, 1, 126900)
(STARFRUIT, MARKET << US, 5055, 1, 126900)","{""AMETHYSTS"": 17, ""STARFRUIT"": 12}",1061,5051,9998
127000,30006,-199511,"(AMETHYSTS, US << MARKET, 10002, 1, 127000)
(AMETHYSTS, MARKET << US, 10002, 1, 127000)
(AMETHYSTS, MARKET << US, 10002, 1, 127000)
(AMETHYSTS, MARKET << US, 10002, 1, 127000)
(AMETHYSTS, MARKET << US, 10002, 1, 127000)","{""AMETHYSTS"": 14, ""STARFRUIT"": 12}",1155,5052,10003
127100,-19996,-219507,"(AMETHYSTS, US << MARKET, 9998, 1, 127100)
(AMETHYSTS, US << MARKET, 9998, 1, 127100)","{""AMETHYSTS"": 16, ""STARFRUIT"": 12}",1069,5052,9997
127500,-19896,-239403,"(AMETHYSTS, US << MARKET, 10002, 1, 127500)
(AMETHYSTS, US << MARKET, 10002, 1, 127500)
(AMETHYSTS, US << MARKET, 10002, 1, 127500)
(STARFRUIT, MARKET << US, 5055, 1, 127500)
(STARFRUIT, MARKET << US, 5055, 1, 127500)","{""AMETHYSTS"": 19, ""STARFRUIT"": 10}",1098,5052,9999
127800,-20200,-259603,"(STARFRUIT, US << MARKET, 5050, 1, 127800)
(STARFRUIT, US << MARKET, 5050, 1, 127800)
(STARFRUIT, US << MARKET, 5050, 1, 127800)
(STARFRUIT, US << MARKET, 5050, 1, 127800)","{""AMETHYSTS"": 19, ""STARFRUIT"": 14}",1031,5048,9998
128000,-10002,-269605,"(AMETHYSTS, US << MARKET, 10002, 1, 128000)","{""AMETHYSTS"": 20, ""STARFRUIT"": 14}",1155,5050,10003
128100,-10100,-279705,"(STARFRUIT, US << MARKET, 5050, 1, 128100)
(STARFRUIT, US << MARKET, 5050, 1, 128100)","{""AMETHYSTS"": 20, ""STARFRUIT"": 16}",1043,5048,9999
128400,10098,-269607,"(STARFRUIT, MARKET << US, 5049, 1, 128400)
(STARFRUIT, MARKET << US, 5049, 1, 128400)","{""AMETHYSTS"": 20, ""STARFRUIT"": 14}",1167,5051,10003
128800,-20216,-289823,"(STARFRUIT, US << MARKET, 5054, 1, 128800)
(STARFRUIT, US << MARKET, 5054, 1, 128800)
(STARFRUIT, US << MARKET, 5054, 1, 128800)
(STARFRUIT, US << MARKET, 5054, 1, 128800)","{""AMETHYSTS"": 20, ""STARFRUIT"": 18}",1097,5050,10001
129000,5047,-284776,"(STARFRUIT, MARKET << US, 5047, 1, 129000)","{""AMETHYSTS"": 20, ""STARFRUIT"": 17}",1091,5051,10000
129200,5049,-279727,"(STARFRUIT, MARKET << US, 5049, 1, 129200)","{""AMETHYSTS"": 20, ""STARFRUIT"": 16}",1001,5048,9998
129400,30222,-249505,"(AMETHYSTS, MARKET << US, 9998, 1, 129400)
(STARFRUIT, MARKET << US, 5056, 1, 129400)
(STARFRUIT, MARKET << US, 5056, 1, 129400)
(STARFRUIT, MARKET << US, 5056, 1, 129400)
(STARFRUIT, MARKET << US, 5056, 1, 129400)","{""AMETHYSTS"": 19, ""STARFRUIT"": 12}",1043,5052,9996
129500,9998,-239507,"(AMETHYSTS, MARKET << US, 9998, 1, 129500)","{""AMETHYSTS"": 18, ""STARFRUIT"": 12}",1063,5052,9997
129700,-10102,-249609,"(STARFRUIT, US << MARKET, 5051, 1, 129700)
(STARFRUIT, US << MARKET, 5051, 1, 129700)","{""AMETHYSTS"": 18, ""STARFRUIT"": 14}",1055,5050,9998
129800,29910,-219699,"(AMETHYSTS, MARKET << US, 10005, 1, 129800)
(AMETHYSTS, MARKET << US, 10005, 1, 129800)
(AMETHYSTS, MARKET << US, 10005, 1, 129800)
(AMETHYSTS, MARKET << US, 10005, 1, 129800)
(STARFRUIT, US << MARKET, 5055, 1, 129800)
(STARFRUIT, US << MARKET, 5055, 1, 129800)","{""AMETHYSTS"": 14, ""STARFRUIT"": 16}",1117,5051,10000
130100,5055,-214644,"(STARFRUIT, MARKET << US, 5055, 1, 130100)","{""AMETHYSTS"": 14, ""STARFRUIT"": 15}",1167,5055,9999
130300,-20010,-234654,"(AMETHYSTS, US << MARKET, 10005, 1, 130300)
(AMETHYSTS, US << MARKET, 10005, 1, 130300)","{""AMETHYSTS"": 16, ""STARFRUIT"": 15}",1126,5052,10000
130400,10202,-224452,"(AMETHYSTS, US << MARKET, 10004, 1, 130400)
(STARFRUIT, MARKET << US, 5056, 1, 130400)
(STARFRUIT, MARKET << US, 5050, 1, 130400)
(STARFRUIT, MARKET << US, 5050, 1, 130400)
(STARFRUIT, MARKET << US, 5050, 1, 130400)","{""AMETHYSTS"": 17, ""STARFRUIT"": 11}",1193,5054,10003
130700,-5050,-229502,"(STARFRUIT, US << MARKET, 5050, 1, 130700)
(STARFRUIT, US << MARKET, 5050, 1, 130700)
(STARFRUIT, US << MARKET, 5050, 1, 130700)
(STARFRUIT, US << MARKET, 5050, 1, 130700)
(STARFRUIT, MARKET << US, 5050, 1, 130700)
(STARFRUIT, MARKET << US, 5050, 1, 130700)
(STARFRUIT, MARKET << US, 5050, 1, 130700)","{""AMETHYSTS"": 17, ""STARFRUIT"": 12}",1134,5053,10000
130900,5049,-224453,"(STARFRUIT, MARKET << US, 5049, 1, 130900)","{""AMETHYSTS"": 17, ""STARFRUIT"": 11}",1119,5052,10000
131100,10102,-214351,"(STARFRUIT, MARKET << US, 5051, 1, 131100)
(STARFRUIT, MARKET << US, 5051, 1, 131100)","{""AMETHYSTS"": 17, ""STARFRUIT"": 9}",1099,5050,10000
131200,10100,-204251,"(STARFRUIT, MARKET << US, 5050, 1, 131200)
(STARFRUIT, MARKET << US, 5050, 1, 131200)","{""AMETHYSTS"": 17, ""STARFRUIT"": 7}",1113,5052,10000
131500,-102,-204353,"(AMETHYSTS, MARKET << US, 9996, 1, 131500)
(STARFRUIT, US << MARKET, 5049, 1, 131500)
(STARFRUIT, US << MARKET, 5049, 1, 131500)","{""AMETHYSTS"": 16, ""STARFRUIT"": 9}",1115,5052,10000
131900,-20098,-224451,"(AMETHYSTS, US << MARKET, 9996, 1, 131900)
(AMETHYSTS, US << MARKET, 9996, 1, 131900)
(AMETHYSTS, MARKET << US, 9996, 1, 131900)
(STARFRUIT, US << MARKET, 5051, 1, 131900)
(STARFRUIT, US << MARKET, 5051, 1, 131900)","{""AMETHYSTS"": 17, ""STARFRUIT"": 11}",1143,5054,10000
132100,-10002,-234453,"(AMETHYSTS, US << MARKET, 10002, 1, 132100)","{""AMETHYSTS"": 18, ""STARFRUIT"": 11}",1184,5053,10003
132200,-15059,-249512,"(AMETHYSTS, US << MARKET, 10004, 1, 132200)
(STARFRUIT, US << MARKET, 5055, 1, 132200)","{""AMETHYSTS"": 19, ""STARFRUIT"": 12}",1112,5052,10000
132300,55148,-194364,"(AMETHYSTS, MARKET << US, 9998, 1, 132300)
(AMETHYSTS, MARKET << US, 9998, 1, 132300)
(AMETHYSTS, MARKET << US, 9998, 1, 132300)
(AMETHYSTS, MARKET << US, 9995, 1, 132300)
(STARFRUIT, MARKET << US, 5053, 1, 132300)
(STARFRUIT, MARKET << US, 5053, 1, 132300)
(STARFRUIT, MARKET << US, 5053, 1, 132300)","{""AMETHYSTS"": 15, ""STARFRUIT"": 9}",1062,5054,9996
132600,4948,-189416,"(AMETHYSTS, MARKET << US, 9998, 1, 132600)
(STARFRUIT, US << MARKET, 5050, 1, 132600)","{""AMETHYSTS"": 14, ""STARFRUIT"": 10}",1128,5053,10001
132800,5051,-184365,"(STARFRUIT, MARKET << US, 5051, 1, 132800)","{""AMETHYSTS"": 14, ""STARFRUIT"": 9}",1121,5054,10000
132900,-5055,-189420,"(STARFRUIT, US << MARKET, 5055, 1, 132900)","{""AMETHYSTS"": 14, ""STARFRUIT"": 10}",1100,5052,10000
133000,-39992,-229412,"(AMETHYSTS, US << MARKET, 9998, 1, 133000)
(AMETHYSTS, US << MARKET, 9998, 1, 133000)
(AMETHYSTS, US << MARKET, 9998, 1, 133000)
(AMETHYSTS, US << MARKET, 9998, 1, 133000)","{""AMETHYSTS"": 18, ""STARFRUIT"": 10}",1064,5053,9997
133200,-5056,-234468,"(STARFRUIT, US << MARKET, 5056, 1, 133200)","{""AMETHYSTS"": 18, ""STARFRUIT"": 11}",1177,5057,10001
133500,-19996,-254464,"(AMETHYSTS, US << MARKET, 9998, 1, 133500)
(AMETHYSTS, US << MARKET, 9998, 1, 133500)","{""AMETHYSTS"": 20, ""STARFRUIT"": 11}",1150,5054,10001
133600,-5052,-259516,"(STARFRUIT, US << MARKET, 5052, 1, 133600)","{""AMETHYSTS"": 20, ""STARFRUIT"": 12}",1076,5051,9999
134000,-5051,-264567,"(STARFRUIT, US << MARKET, 5051, 1, 134000)","{""AMETHYSTS"": 20, ""STARFRUIT"": 13}",1122,5053,10000
134500,-5056,-269623,"(STARFRUIT, US << MARKET, 5056, 1, 134500)","{""AMETHYSTS"": 20, ""STARFRUIT"": 14}",1121,5056,9998
134700,9998,-259625,"(AMETHYSTS, MARKET << US, 9998, 1, 134700)","{""AMETHYSTS"": 19, ""STARFRUIT"": 14}",1150,5054,10001
134800,-20208,-279833,"(STARFRUIT, US << MARKET, 5052, 1, 134800)
(STARFRUIT, US << MARKET, 5052, 1, 134800)
(STARFRUIT, US << MARKET, 5052, 1, 134800)
(STARFRUIT, US << MARKET, 5052, 1, 134800)","{""AMETHYSTS"": 19, ""STARFRUIT"": 18}",1138,5055,9999
134900,-10104,-289937,"(STARFRUIT, US << MARKET, 5052, 1, 134900)
(STARFRUIT, US << MARKET, 5052, 1, 134900)","{""AMETHYSTS"": 19, ""STARFRUIT"": 20}",1124,5054,9999
135600,25295,-264642,"(STARFRUIT, MARKET << US, 5059, 1, 135600)
(STARFRUIT, MARKET << US, 5059, 1, 135600)
(STARFRUIT, MARKET << US, 5059, 1, 135600)
(STARFRUIT, MARKET << US, 5059, 1, 135600)
(STARFRUIT, MARKET << US, 5059, 1, 135600)","{""AMETHYSTS"": 19, ""STARFRUIT"": 15}",1183,5055,10000
135800,5058,-259584,"(STARFRUIT, MARKET << US, 5058, 1, 135800)","{""AMETHYSTS"": 19, ""STARFRUIT"": 14}",1167,5055,9999
136100,-5054,-264638,"(STARFRUIT, US << MARKET, 5054, 1, 136100)","{""AMETHYSTS"": 19, ""STARFRUIT"": 15}",1202,5056,10000
136500,5053,-259585,"(STARFRUIT, MARKET << US, 5053, 1, 136500)","{""AMETHYSTS"": 19, ""STARFRUIT"": 14}",1180,5056,9999
137000,20004,-239581,"(AMETHYSTS, MARKET << US, 10002, 1, 137000)
(AMETHYSTS, MARKET << US, 10002, 1, 137000)","{""AMETHYSTS"": 17, ""STARFRUIT"": 14}",1240,5055,10003
137100,-5053,-244634,"(STARFRUIT, US << MARKET, 5053, 1, 137100)","{""AMETHYSTS"": 17, ""STARFRUIT"": 15}",1257,5056,10003
137200,-20216,-264850,"(STARFRUIT, US << MARKET, 5054, 1, 137200)
(STARFRUIT, US << MARKET, 5054, 1, 137200)
(STARFRUIT, US << MARKET, 5054, 1, 137200)
(STARFRUIT, US << MARKET, 5054, 1, 137200)","{""AMETHYSTS"": 17, ""STARFRUIT"": 19}",1157,5053,10000
137400,15047,-249803,"(AMETHYSTS, MARKET << US, 9995, 1, 137400)
(STARFRUIT, MARKET << US, 5052, 1, 137400)","{""AMETHYSTS"": 16, ""STARFRUIT"": 18}",1169,5054,10000
137700,-19882,-269685,"(AMETHYSTS, US << MARKET, 9996, 1, 137700)
(AMETHYSTS, US << MARKET, 9996, 1, 137700)
(AMETHYSTS, US << MARKET, 9996, 1, 137700)
(STARFRUIT, MARKET << US, 5053, 1, 137700)
(STARFRUIT, MARKET << US, 5053, 1, 137700)","{""AMETHYSTS"": 19, ""STARFRUIT"": 16}",1211,5056,10000
137800,30096,-239589,"(AMETHYSTS, MARKET << US, 9996, 1, 137800)
(AMETHYSTS, MARKET << US, 9996, 1, 137800)
(STARFRUIT, MARKET << US, 5052, 1, 137800)
(STARFRUIT, MARKET << US, 5052, 1, 137800)","{""AMETHYSTS"": 17, ""STARFRUIT"": 14}",1181,5055,10000
138200,20114,-219475,"(AMETHYSTS, MARKET << US, 9998, 1, 138200)
(STARFRUIT, MARKET << US, 5058, 1, 138200)
(STARFRUIT, MARKET << US, 5058, 1, 138200)","{""AMETHYSTS"": 16, ""STARFRUIT"": 12}",1173,5058,9997
138300,10106,-209369,"(STARFRUIT, MARKET << US, 5053, 1, 138300)
(STARFRUIT, MARKET << US, 5053, 1, 138300)","{""AMETHYSTS"": 16, ""STARFRUIT"": 10}",1191,5056,10000
138600,-15057,-224426,"(AMETHYSTS, US << MARKET, 10004, 1, 138600)
(STARFRUIT, US << MARKET, 5053, 1, 138600)","{""AMETHYSTS"": 17, ""STARFRUIT"": 11}",1179,5055,10000
139300,-5059,-229485,"(STARFRUIT, US << MARKET, 5059, 1, 139300)","{""AMETHYSTS"": 17, ""STARFRUIT"": 12}",1223,5059,10000
139400,-40232,-269717,"(AMETHYSTS, US << MARKET, 9996, 1, 139400)
(AMETHYSTS, US << MARKET, 9996, 1, 139400)
(STARFRUIT, US << MARKET, 5060, 1, 139400)
(STARFRUIT, US << MARKET, 5060, 1, 139400)
(STARFRUIT, US << MARKET, 5060, 1, 139400)
(STARFRUIT, US << MARKET, 5060, 1, 139400)","{""AMETHYSTS"": 19, ""STARFRUIT"": 16}",1170,5059,9997
140500,9998,-259719,"(AMETHYSTS, MARKET << US, 9998, 1, 140500)","{""AMETHYSTS"": 18, ""STARFRUIT"": 16}",1107,5055,9997
140600,-5053,-264772,"(STARFRUIT, US << MARKET, 5053, 1, 140600)","{""AMETHYSTS"": 18, ""STARFRUIT"": 17}",1180,5056,10000
141400,-19990,-284762,"(AMETHYSTS, US << MARKET, 9995, 1, 141400)
(AMETHYSTS, US << MARKET, 9995, 1, 141400)","{""AMETHYSTS"": 20, ""STARFRUIT"": 17}",1093,5055,9996
141500,5052,-279710,"(STARFRUIT, MARKET << US, 5052, 1, 141500)","{""AMETHYSTS"": 20, ""STARFRUIT"": 16}",1170,5055,10000
141600,-20228,-299938,"(STARFRUIT, US << MARKET, 5057, 1, 141600)
(STARFRUIT, US << MARKET, 5057, 1, 141600)
(STARFRUIT, US << MARKET, 5057, 1, 141600)
(STARFRUIT, US << MARKET, 5057, 1, 141600)","{""AMETHYSTS"": 20, ""STARFRUIT"": 20}",1202,5058,9999
142000,0,-299938,,"{""AMETHYSTS"": 20, ""STARFRUIT"": 20}",1162,5055,10000
142100,0,-299938,,"{""AMETHYSTS"": 20, ""STARFRUIT"": 20}",1202,5059,9998
142200,5054,-294884,"(STARFRUIT, MARKET << US, 5054, 1, 142200)","{""AMETHYSTS"": 20, ""STARFRUIT"": 19}",1199,5057,10000
142500,9998,-284886,"(AMETHYSTS, MARKET << US, 9998, 1, 142500)","{""AMETHYSTS"": 19, ""STARFRUIT"": 19}",1121,5057,9996
143300,9998,-274888,"(AMETHYSTS, MARKET << US, 9998, 1, 143300)","{""AMETHYSTS"": 18, ""STARFRUIT"": 19}",1213,5057,10001
143600,15162,-259726,"(STARFRUIT, MARKET << US, 5054, 1, 143600)
(STARFRUIT, MARKET << US, 5054, 1, 143600)
(STARFRUIT, MARKET << US, 5054, 1, 143600)","{""AMETHYSTS"": 18, ""STARFRUIT"": 16}",1122,5053,10000
143800,5052,-254674,"(STARFRUIT, MARKET << US, 5052, 1, 143800)","{""AMETHYSTS"": 18, ""STARFRUIT"": 15}",1184,5056,10001
143900,-14944,-269618,"(AMETHYSTS, US << MARKET, 9998, 1, 143900)
(AMETHYSTS, US << MARKET, 9998, 1, 143900)
(STARFRUIT, MARKET << US, 5052, 1, 143900)","{""AMETHYSTS"": 20, ""STARFRUIT"": 14}",1206,5056,10002
144100,10114,-259504,"(STARFRUIT, MARKET << US, 5057, 1, 144100)
(STARFRUIT, MARKET << US, 5057, 1, 144100)","{""AMETHYSTS"": 20, ""STARFRUIT"": 12}",1180,5057,10000
144400,-5053,-264557,"(STARFRUIT, US << MARKET, 5053, 1, 144400)","{""AMETHYSTS"": 20, ""STARFRUIT"": 13}",1171,5056,10000
144500,40016,-224541,"(AMETHYSTS, MARKET << US, 10004, 1, 144500)
(AMETHYSTS, MARKET << US, 10004, 1, 144500)
(AMETHYSTS, MARKET << US, 10004, 1, 144500)
(AMETHYSTS, MARKET << US, 10004, 1, 144500)","{""AMETHYSTS"": 16, ""STARFRUIT"": 13}",1174,5055,10000
144600,-19888,-244429,"(AMETHYSTS, US << MARKET, 9998, 1, 144600)
(AMETHYSTS, US << MARKET, 9998, 1, 144600)
(AMETHYSTS, US << MARKET, 9998, 1, 144600)
(STARFRUIT, MARKET << US, 5053, 1, 144600)
(STARFRUIT, MARKET << US, 5053, 1, 144600)","{""AMETHYSTS"": 19, ""STARFRUIT"": 11}",1195,5055,10001
144800,20004,-224425,"(AMETHYSTS, MARKET << US, 10002, 1, 144800)
(AMETHYSTS, MARKET << US, 10002, 1, 144800)","{""AMETHYSTS"": 17, ""STARFRUIT"": 11}",1220,5054,10003
145100,44925,-179500,"(AMETHYSTS, US << MARKET, 10005, 1, 145100)
(AMETHYSTS, MARKET << US, 9998, 1, 145100)
(AMETHYSTS, MARKET << US, 9998, 1, 145100)
(AMETHYSTS, MARKET << US, 9998, 1, 145100)
(AMETHYSTS, MARKET << US, 9998, 1, 145100)
(AMETHYSTS, MARKET << US, 9998, 1, 145100)
(AMETHYSTS, MARKET << US, 9998, 1, 145100)
(STARFRUIT, US << MARKET, 5058, 1, 145100)","{""AMETHYSTS"": 12, ""STARFRUIT"": 12}",1160,5054,10001
145600,25060,-154440,"(AMETHYSTS, MARKET << US, 10002, 1, 145600)
(AMETHYSTS, MARKET << US, 10002, 1, 145600)
(STARFRUIT, MARKET << US, 5056, 1, 145600)","{""AMETHYSTS"": 10, ""STARFRUIT"": 11}",1123,5053,9998
145900,-30108,-184548,"(AMETHYSTS, US << MARKET, 10002, 1, 145900)
(AMETHYSTS, US << MARKET, 10002, 1, 145900)
(STARFRUIT, US << MARKET, 5052, 1, 145900)
(STARFRUIT, US << MARKET, 5052, 1, 145900)","{""AMETHYSTS"": 12, ""STARFRUIT"": 13}",1203,5055,10003
146400,4947,-179601,"(AMETHYSTS, MARKET << US, 9998, 1, 146400)
(STARFRUIT, US << MARKET, 5051, 1, 146400)","{""AMETHYSTS"": 11, ""STARFRUIT"": 14}",1124,5051,10001
147000,-5058,-184659,"(AMETHYSTS, US << MARKET, 10002, 1, 147000)
(AMETHYSTS, US << MARKET, 10004, 1, 147000)
(AMETHYSTS, MARKET << US, 10004, 1, 147000)
(AMETHYSTS, MARKET << US, 10004, 1, 147000)
(STARFRUIT, US << MARKET, 5058, 1, 147000)
(STARFRUIT, US << MARKET, 5058, 1, 147000)
(STARFRUIT, MARKET << US, 5056, 1, 147000)","{""AMETHYSTS"": 11, ""STARFRUIT"": 15}",1229,5057,10003
147200,-5057,-189716,"(STARFRUIT, US << MARKET, 5057, 1, 147200)","{""AMETHYSTS"": 11, ""STARFRUIT"": 16}",1196,5057,10000
147400,-5051,-194767,"(STARFRUIT, US << MARKET, 5051, 1, 147400)","{""AMETHYSTS"": 11, ""STARFRUIT"": 17}",1134,5053,10000
147500,-5056,-199823,"(STARFRUIT, US << MARKET, 5056, 1, 147500)","{""AMETHYSTS"": 11, ""STARFRUIT"": 18}",1131,5053,10000
148200,-85044,-284867,"(AMETHYSTS, US << MARKET, 9998, 1, 148200)
(AMETHYSTS, US << MARKET, 9998, 1, 148200)
(AMETHYSTS, US << MARKET, 9998, 1, 148200)
(AMETHYSTS, US << MARKET, 9998, 1, 148200)
(AMETHYSTS, US << MARKET, 9998, 1, 148200)
(AMETHYSTS, US << MARKET, 9998, 1, 148200)
(AMETHYSTS, US << MARKET, 9998, 1, 148200)
(AMETHYSTS, US << MARKET, 9998, 1, 148200)
(STARFRUIT, US << MARKET, 5058, 1, 148200)
(STARFRUIT, US << MARKET, 5058, 1, 148200)
(STARFRUIT, MARKET << US, 5056, 1, 148200)","{""AMETHYSTS"": 19, ""STARFRUIT"": 19}",1159,5057,9997
148700,95111,-189756,"(AMETHYSTS, US << MARKET, 9995, 1, 148700)
(AMETHYSTS, MARKET << US, 10005, 1, 148700)
(AMETHYSTS, MARKET << US, 10005, 1, 148700)
(AMETHYSTS, MARKET << US, 10005, 1, 148700)
(AMETHYSTS, MARKET << US, 10005, 1, 148700)
(AMETHYSTS, MARKET << US, 10005, 1, 148700)
(AMETHYSTS, MARKET << US, 10005, 1, 148700)
(AMETHYSTS, MARKET << US, 10005, 1, 148700)
(AMETHYSTS, MARKET << US, 10005, 1, 148700)
(AMETHYSTS, MARKET << US, 10005, 1, 148700)
(AMETHYSTS, MARKET << US, 10005, 1, 148700)
(STARFRUIT, MARKET << US, 5056, 1, 148700)","{""AMETHYSTS"": 10, ""STARFRUIT"": 18}",1252,5056,10000
148900,15165,-174591,"(STARFRUIT, MARKET << US, 5055, 1, 148900)
(STARFRUIT, MARKET << US, 5055, 1, 148900)
(STARFRUIT, MARKET << US, 5055, 1, 148900)","{""AMETHYSTS"": 10, ""STARFRUIT"": 15}",1249,5056,10000
149000,-15053,-189644,"(AMETHYSTS, US << MARKET, 10002, 1, 149000)
(STARFRUIT, US << MARKET, 5051, 1, 149000)","{""AMETHYSTS"": 11, ""STARFRUIT"": 16}",1193,5053,9999
149100,-5051,-194695,"(STARFRUIT, US << MARKET, 5051, 1, 149100)","{""AMETHYSTS"": 11, ""STARFRUIT"": 17}",1234,5054,10001
149500,5054,-189641,"(STARFRUIT, MARKET << US, 5054, 1, 149500)","{""AMETHYSTS"": 11, ""STARFRUIT"": 16}",1185,5053,9998
150300,-10002,-199643,"(AMETHYSTS, US << MARKET, 10002, 1, 150300)","{""AMETHYSTS"": 12, ""STARFRUIT"": 16}",1289,5056,10003
150600,-10002,-209645,"(AMETHYSTS, US << MARKET, 10002, 1, 150600)","{""AMETHYSTS"": 13, ""STARFRUIT"": 16}",1274,5055,10003
151100,100020,-109625,"(AMETHYSTS, MARKET << US, 10002, 1, 151100)
(AMETHYSTS, MARKET << US, 10002, 1, 151100)
(AMETHYSTS, MARKET << US, 10002, 1, 151100)
(AMETHYSTS, MARKET << US, 10002, 1, 151100)
(AMETHYSTS, MARKET << US, 10002, 1, 151100)
(AMETHYSTS, MARKET << US, 10002, 1, 151100)
(AMETHYSTS, MARKET << US, 10002, 1, 151100)
(AMETHYSTS, MARKET << US, 10002, 1, 151100)
(AMETHYSTS, MARKET << US, 10002, 1, 151100)
(AMETHYSTS, MARKET << US, 10002, 1, 151100)","{""AMETHYSTS"": 3, ""STARFRUIT"": 16}",1233,5054,9998
151200,-20008,-129633,"(AMETHYSTS, US << MARKET, 10004, 1, 151200)
(AMETHYSTS, US << MARKET, 10004, 1, 151200)","{""AMETHYSTS"": 5, ""STARFRUIT"": 16}",1252,5055,10001
151500,4834,-124799,"(AMETHYSTS, MARKET << US, 10004, 1, 151500)
(AMETHYSTS, MARKET << US, 10004, 1, 151500)
(STARFRUIT, US << MARKET, 5058, 1, 151500)
(STARFRUIT, US << MARKET, 5058, 1, 151500)
(STARFRUIT, US << MARKET, 5058, 1, 151500)
(STARFRUIT, US << MARKET, 5058, 1, 151500)
(STARFRUIT, MARKET << US, 5058, 1, 151500)","{""AMETHYSTS"": 3, ""STARFRUIT"": 19}",1227,5054,10000
151600,-34925,-159724,"(AMETHYSTS, US << MARKET, 9995, 1, 151600)
(AMETHYSTS, US << MARKET, 9995, 1, 151600)
(AMETHYSTS, US << MARKET, 9995, 1, 151600)
(AMETHYSTS, US << MARKET, 9996, 1, 151600)
(STARFRUIT, MARKET << US, 5056, 1, 151600)","{""AMETHYSTS"": 7, ""STARFRUIT"": 18}",1302,5057,10000
152100,-15059,-174783,"(AMETHYSTS, US << MARKET, 10002, 1, 152100)
(STARFRUIT, US << MARKET, 5057, 1, 152100)","{""AMETHYSTS"": 8, ""STARFRUIT"": 19}",1324,5057,10003
152400,-19996,-194779,"(AMETHYSTS, US << MARKET, 9998, 1, 152400)
(AMETHYSTS, US << MARKET, 9998, 1, 152400)","{""AMETHYSTS"": 10, ""STARFRUIT"": 19}",1236,5055,9997
152600,9998,-184781,"(AMETHYSTS, MARKET << US, 9998, 1, 152600)","{""AMETHYSTS"": 9, ""STARFRUIT"": 19}",1235,5053,10001
152700,-19992,-204773,"(AMETHYSTS, US << MARKET, 9996, 1, 152700)
(AMETHYSTS, US << MARKET, 9996, 1, 152700)","{""AMETHYSTS"": 11, ""STARFRUIT"": 19}",1291,5056,10000
152800,-5056,-209829,"(STARFRUIT, US << MARKET, 5056, 1, 152800)","{""AMETHYSTS"": 11, ""STARFRUIT"": 20}",1200,5052,9999
153000,9998,-199831,"(AMETHYSTS, MARKET << US, 9998, 1, 153000)","{""AMETHYSTS"": 10, ""STARFRUIT"": 20}",1219,5054,9997
153200,40008,-159823,"(AMETHYSTS, MARKET << US, 10002, 1, 153200)
(AMETHYSTS, MARKET << US, 10002, 1, 153200)
(AMETHYSTS, MARKET << US, 10002, 1, 153200)
(AMETHYSTS, MARKET << US, 10002, 1, 153200)","{""AMETHYSTS"": 6, ""STARFRUIT"": 20}",1235,5052,10003
153300,-19996,-179819,"(AMETHYSTS, US << MARKET, 9998, 1, 153300)
(AMETHYSTS, US << MARKET, 9998, 1, 153300)","{""AMETHYSTS"": 8, ""STARFRUIT"": 20}",1237,5054,9997
153500,0,-179819,,"{""AMETHYSTS"": 8, ""STARFRUIT"": 20}",1189,5050,10001
153600,5051,-174768,"(STARFRUIT, MARKET << US, 5051, 1, 153600)","{""AMETHYSTS"": 8, ""STARFRUIT"": 19}",1258,5054,10000
154000,-5057,-179825,"(STARFRUIT, US << MARKET, 5057, 1, 154000)","{""AMETHYSTS"": 8, ""STARFRUIT"": 20}",1315,5057,10000
154200,108,-179717,"(AMETHYSTS, US << MARKET, 9996, 1, 154200)
(AMETHYSTS, US << MARKET, 9996, 1, 154200)
(AMETHYSTS, MARKET << US, 9996, 1, 154200)
(STARFRUIT, MARKET << US, 5052, 1, 154200)
(STARFRUIT, MARKET << US, 5052, 1, 154200)","{""AMETHYSTS"": 9, ""STARFRUIT"": 18}",1273,5055,10000
154900,15165,-164552,"(STARFRUIT, MARKET << US, 5055, 1, 154900)
(STARFRUIT, MARKET << US, 5055, 1, 154900)
(STARFRUIT, MARKET << US, 5055, 1, 154900)","{""AMETHYSTS"": 9, ""STARFRUIT"": 15}",1279,5056,9999
155100,35393,-129159,"(STARFRUIT, MARKET << US, 5057, 1, 155100)
(STARFRUIT, MARKET << US, 5057, 1, 155100)
(STARFRUIT, MARKET << US, 5057, 1, 155100)
(STARFRUIT, MARKET << US, 5057, 1, 155100)
(STARFRUIT, MARKET << US, 5057, 1, 155100)
(STARFRUIT, MARKET << US, 5057, 1, 155100)
(STARFRUIT, MARKET << US, 5051, 1, 155100)","{""AMETHYSTS"": 9, ""STARFRUIT"": 8}",1300,5054,10003
155200,14958,-114201,"(AMETHYSTS, MARKET << US, 10004, 1, 155200)
(AMETHYSTS, MARKET << US, 10004, 1, 155200)
(STARFRUIT, US << MARKET, 5050, 1, 155200)","{""AMETHYSTS"": 7, ""STARFRUIT"": 9}",1292,5054,10001
155300,-59988,-174189,"(AMETHYSTS, US << MARKET, 9998, 1, 155300)
(AMETHYSTS, US << MARKET, 9998, 1, 155300)
(AMETHYSTS, US << MARKET, 9998, 1, 155300)
(AMETHYSTS, US << MARKET, 9998, 1, 155300)
(AMETHYSTS, US << MARKET, 9998, 1, 155300)
(AMETHYSTS, US << MARKET, 9998, 1, 155300)","{""AMETHYSTS"": 13, ""STARFRUIT"": 9}",1240,5052,9997
155600,5048,-169141,"(STARFRUIT, MARKET << US, 5048, 1, 155600)","{""AMETHYSTS"": 13, ""STARFRUIT"": 8}",1267,5051,10000
156000,30342,-138799,"(STARFRUIT, MARKET << US, 5057, 1, 156000)
(STARFRUIT, MARKET << US, 5057, 1, 156000)
(STARFRUIT, MARKET << US, 5057, 1, 156000)
(STARFRUIT, MARKET << US, 5057, 1, 156000)
(STARFRUIT, MARKET << US, 5057, 1, 156000)
(STARFRUIT, MARKET << US, 5057, 1, 156000)","{""AMETHYSTS"": 13, ""STARFRUIT"": 2}",1346,5053,10003
156100,-10002,-148801,"(AMETHYSTS, US << MARKET, 10002, 1, 156100)","{""AMETHYSTS"": 14, ""STARFRUIT"": 2}",1349,5054,10003
156400,-9770,-158571,"(AMETHYSTS, US << MARKET, 9998, 1, 156400)
(AMETHYSTS, US << MARKET, 9998, 1, 156400)
(AMETHYSTS, US << MARKET, 9998, 1, 156400)
(AMETHYSTS, US << MARKET, 9998, 1, 156400)
(AMETHYSTS, MARKET << US, 9998, 1, 156400)
(STARFRUIT, MARKET << US, 5056, 1, 156400)
(STARFRUIT, MARKET << US, 5056, 1, 156400)
(STARFRUIT, MARKET << US, 5056, 1, 156400)
(STARFRUIT, MARKET << US, 5056, 1, 156400)","{""AMETHYSTS"": 17, ""STARFRUIT"": -2}",1336,5055,10001
156800,-20106,-178677,"(AMETHYSTS, US << MARKET, 9998, 1, 156800)
(AMETHYSTS, US << MARKET, 9998, 1, 156800)
(AMETHYSTS, MARKET << US, 9998, 1, 156800)
(STARFRUIT, US << MARKET, 5054, 1, 156800)
(STARFRUIT, US << MARKET, 5054, 1, 156800)
(STARFRUIT, US << MARKET, 5054, 1, 156800)
(STARFRUIT, US << MARKET, 5054, 1, 156800)
(STARFRUIT, MARKET << US, 5054, 1, 156800)
(STARFRUIT, MARKET << US, 5054, 1, 156800)","{""AMETHYSTS"": 18, ""STARFRUIT"": 0}",1341,5055,10001
156900,-14941,-193618,"(AMETHYSTS, US << MARKET, 9998, 1, 156900)
(AMETHYSTS, US << MARKET, 9998, 1, 156900)
(STARFRUIT, MARKET << US, 5055, 1, 156900)","{""AMETHYSTS"": 20, ""STARFRUIT"": -1}",1250,5052,9996
157100,0,-193618,,"{""AMETHYSTS"": 20, ""STARFRUIT"": -1}",1311,5051,9999
157400,-15171,-208789,"(STARFRUIT, US << MARKET, 5055, 1, 157400)
(STARFRUIT, US << MARKET, 5055, 1, 157400)
(STARFRUIT, US << MARKET, 5055, 1, 157400)
(STARFRUIT, US << MARKET, 5055, 1, 157400)
(STARFRUIT, US << MARKET, 5055, 1, 157400)
(STARFRUIT, US << MARKET, 5055, 1, 157400)
(STARFRUIT, MARKET << US, 5055, 1, 157400)
(STARFRUIT, MARKET << US, 5055, 1, 157400)
(STARFRUIT, MARKET << US, 5049, 1, 157400)","{""AMETHYSTS"": 20, ""STARFRUIT"": 2}",1315,5052,10000
157600,20224,-188565,"(STARFRUIT, MARKET << US, 5056, 1, 157600)
(STARFRUIT, MARKET << US, 5056, 1, 157600)
(STARFRUIT, MARKET << US, 5056, 1, 157600)
(STARFRUIT, MARKET << US, 5056, 1, 157600)","{""AMETHYSTS"": 20, ""STARFRUIT"": -2}",1325,5055,10000
157700,10096,-178469,"(STARFRUIT, MARKET << US, 5048, 1, 157700)
(STARFRUIT, MARKET << US, 5048, 1, 157700)","{""AMETHYSTS"": 20, ""STARFRUIT"": -4}",1327,5051,10000
157800,0,-178469,,"{""AMETHYSTS"": 20, ""STARFRUIT"": -4}",1307,5051,9999
158300,9998,-168471,"(AMETHYSTS, MARKET << US, 9998, 1, 158300)","{""AMETHYSTS"": 19, ""STARFRUIT"": -4}",1348,5050,10001
158400,30116,-138355,"(AMETHYSTS, MARKET << US, 10004, 1, 158400)
(AMETHYSTS, MARKET << US, 10004, 1, 158400)
(STARFRUIT, MARKET << US, 5054, 1, 158400)
(STARFRUIT, MARKET << US, 5054, 1, 158400)","{""AMETHYSTS"": 17, ""STARFRUIT"": -6}",1345,5050,10000
158700,15051,-123304,"(AMETHYSTS, MARKET << US, 9998, 1, 158700)
(STARFRUIT, MARKET << US, 5053, 1, 158700)","{""AMETHYSTS"": 16, ""STARFRUIT"": -7}",1289,5049,9996
159000,-10104,-133408,"(STARFRUIT, US << MARKET, 5052, 1, 159000)
(STARFRUIT, US << MARKET, 5052, 1, 159000)","{""AMETHYSTS"": 16, ""STARFRUIT"": -5}",1299,5049,9997
159200,5048,-128360,"(STARFRUIT, MARKET << US, 5048, 1, 159200)","{""AMETHYSTS"": 16, ""STARFRUIT"": -6}",1296,5052,9998
159300,5049,-123311,"(STARFRUIT, MARKET << US, 5049, 1, 159300)","{""AMETHYSTS"": 16, ""STARFRUIT"": -7}",1353,5048,10000
159400,-14942,-138253,"(AMETHYSTS, US << MARKET, 9998, 1, 159400)
(AMETHYSTS, US << MARKET, 9998, 1, 159400)
(STARFRUIT, MARKET << US, 5054, 1, 159400)","{""AMETHYSTS"": 18, ""STARFRUIT"": -8}",1293,5050,9997
159500,15048,-123205,"(AMETHYSTS, MARKET << US, 9995, 1, 159500)
(STARFRUIT, MARKET << US, 5053, 1, 159500)","{""AMETHYSTS"": 17, ""STARFRUIT"": -9}",1309,5054,10000
159700,20220,-102985,"(STARFRUIT, MARKET << US, 5055, 1, 159700)
(STARFRUIT, MARKET << US, 5055, 1, 159700)
(STARFRUIT, MARKET << US, 5055, 1, 159700)
(STARFRUIT, MARKET << US, 5055, 1, 159700)","{""AMETHYSTS"": 17, ""STARFRUIT"": -13}",1339,5052,10000
160000,240120,137135,"(AMETHYSTS, MARKET << US, 10005, 1, 160000)
(AMETHYSTS, MARKET << US, 10005, 1, 160000)
(AMETHYSTS, MARKET << US, 10005, 1, 160000)
(AMETHYSTS, MARKET << US, 10005, 1, 160000)
(AMETHYSTS, MARKET << US, 10005, 1, 160000)
(AMETHYSTS, MARKET << US, 10005, 1, 160000)
(AMETHYSTS, MARKET << US, 10005, 1, 160000)
(AMETHYSTS, MARKET << US, 10005, 1, 160000)
(AMETHYSTS, MARKET << US, 10005, 1, 160000)
(AMETHYSTS, MARKET << US, 10005, 1, 160000)
(AMETHYSTS, MARKET << US, 10005, 1, 160000)
(AMETHYSTS, MARKET << US, 10005, 1, 160000)
(AMETHYSTS, MARKET << US, 10005, 1, 160000)
(AMETHYSTS, MARKET << US, 10005, 1, 160000)
(AMETHYSTS, MARKET << US, 10005, 1, 160000)
(AMETHYSTS, MARKET << US, 10005, 1, 160000)
(AMETHYSTS, MARKET << US, 10005, 1, 160000)
(AMETHYSTS, MARKET << US, 10005, 1, 160000)
(AMETHYSTS, MARKET << US, 10005, 1, 160000)
(AMETHYSTS, MARKET << US, 10005, 1, 160000)
(AMETHYSTS, MARKET << US, 10005, 1, 160000)
(AMETHYSTS, MARKET << US, 10005, 1, 160000)
(AMETHYSTS, MARKET << US, 10005, 1, 160000)
(AMETHYSTS, MARKET << US, 10005, 1, 160000)","{""AMETHYSTS"": -7, ""STARFRUIT"": -13}",1432,5053,10002
160700,-40384,96751,"(STARFRUIT, US << MARKET, 5048, 1, 160700)
(STARFRUIT, US << MARKET, 5048, 1, 160700)
(STARFRUIT, US << MARKET, 5048, 1, 160700)
(STARFRUIT, US << MARKET, 5048, 1, 160700)
(STARFRUIT, US << MARKET, 5048, 1, 160700)
(STARFRUIT, US << MARKET, 5048, 1, 160700)
(STARFRUIT, US << MARKET, 5048, 1, 160700)
(STARFRUIT, US << MARKET, 5048, 1, 160700)","{""AMETHYSTS"": -7, ""STARFRUIT"": -5}",1516,5047,10000
161000,4854,101605,"(AMETHYSTS, MARKET << US, 9996, 1, 161000)
(AMETHYSTS, MARKET << US, 9996, 1, 161000)
(STARFRUIT, US << MARKET, 5046, 1, 161000)
(STARFRUIT, US << MARKET, 5046, 1, 161000)
(STARFRUIT, US << MARKET, 5046, 1, 161000)
(STARFRUIT, US << MARKET, 5046, 1, 161000)
(STARFRUIT, MARKET << US, 5046, 1, 161000)","{""AMETHYSTS"": -9, ""STARFRUIT"": -2}",1507,5049,10000
161500,5050,106655,"(STARFRUIT, MARKET << US, 5050, 1, 161500)","{""AMETHYSTS"": -9, ""STARFRUIT"": -3}",1532,5047,9998
161600,20004,126659,"(AMETHYSTS, MARKET << US, 10002, 1, 161600)
(AMETHYSTS, MARKET << US, 10002, 1, 161600)","{""AMETHYSTS"": -11, ""STARFRUIT"": -3}",1479,5049,10003
163100,10,126669,"(STARFRUIT, US << MARKET, 5045, 1, 163100)
(STARFRUIT, US << MARKET, 5045, 1, 163100)
(STARFRUIT, MARKET << US, 5050, 1, 163100)
(STARFRUIT, MARKET << US, 5050, 1, 163100)","{""AMETHYSTS"": -11, ""STARFRUIT"": -3}",1539,5047,9999
163400,20108,146777,"(AMETHYSTS, US << MARKET, 10004, 1, 163400)
(AMETHYSTS, MARKET << US, 10004, 1, 163400)
(AMETHYSTS, MARKET << US, 10004, 1, 163400)
(STARFRUIT, MARKET << US, 5052, 1, 163400)
(STARFRUIT, MARKET << US, 5052, 1, 163400)","{""AMETHYSTS"": -12, ""STARFRUIT"": -5}",1527,5050,10000
163900,-20008,126769,"(AMETHYSTS, US << MARKET, 10004, 1, 163900)
(AMETHYSTS, US << MARKET, 10004, 1, 163900)","{""AMETHYSTS"": -10, ""STARFRUIT"": -5}",1504,5049,10002
164000,-5051,121718,"(STARFRUIT, US << MARKET, 5050, 1, 164000)
(STARFRUIT, US << MARKET, 5050, 1, 164000)
(STARFRUIT, MARKET << US, 5049, 1, 164000)","{""AMETHYSTS"": -10, ""STARFRUIT"": -4}",1518,5050,10000
164200,-35364,86354,"(STARFRUIT, US << MARKET, 5052, 1, 164200)
(STARFRUIT, US << MARKET, 5052, 1, 164200)
(STARFRUIT, US << MARKET, 5052, 1, 164200)
(STARFRUIT, US << MARKET, 5052, 1, 164200)
(STARFRUIT, US << MARKET, 5052, 1, 164200)
(STARFRUIT, US << MARKET, 5052, 1, 164200)
(STARFRUIT, US << MARKET, 5052, 1, 164200)","{""AMETHYSTS"": -10, ""STARFRUIT"": 3}",1498,5048,10000
164400,5049,91403,"(STARFRUIT, MARKET << US, 5049, 1, 164400)","{""AMETHYSTS"": -10, ""STARFRUIT"": 2}",1495,5046,10000
164600,-19996,71407,"(AMETHYSTS, US << MARKET, 9998, 1, 164600)
(AMETHYSTS, US << MARKET, 9998, 1, 164600)","{""AMETHYSTS"": -8, ""STARFRUIT"": 2}",1527,5048,9997
164800,-40016,31391,"(AMETHYSTS, US << MARKET, 10004, 1, 164800)
(AMETHYSTS, US << MARKET, 10004, 1, 164800)
(AMETHYSTS, US << MARKET, 10004, 1, 164800)
(AMETHYSTS, US << MARKET, 10004, 1, 164800)","{""AMETHYSTS"": -4, ""STARFRUIT"": 2}",1483,5046,10000
164900,67,31458,"(AMETHYSTS, US << MARKET, 10005, 1, 164900)
(STARFRUIT, US << MARKET, 5050, 1, 164900)
(STARFRUIT, US << MARKET, 5050, 1, 164900)
(STARFRUIT, MARKET << US, 5043, 1, 164900)
(STARFRUIT, MARKET << US, 5043, 1, 164900)
(STARFRUIT, MARKET << US, 5043, 1, 164900)
(STARFRUIT, MARKET << US, 5043, 1, 164900)","{""AMETHYSTS"": -3, ""STARFRUIT"": 0}",1458,5046,10000
165600,-25240,6218,"(STARFRUIT, US << MARKET, 5048, 1, 165600)
(STARFRUIT, US << MARKET, 5048, 1, 165600)
(STARFRUIT, US << MARKET, 5048, 1, 165600)
(STARFRUIT, US << MARKET, 5048, 1, 165600)
(STARFRUIT, US << MARKET, 5048, 1, 165600)","{""AMETHYSTS"": -3, ""STARFRUIT"": 5}",1457,5046,9997
165700,5050,11268,"(STARFRUIT, MARKET << US, 5050, 1, 165700)","{""AMETHYSTS"": -3, ""STARFRUIT"": 4}",1468,5050,10000
165800,14951,26219,"(AMETHYSTS, MARKET << US, 10004, 1, 165800)
(AMETHYSTS, MARKET << US, 10004, 1, 165800)
(STARFRUIT, US << MARKET, 5051, 1, 165800)
(STARFRUIT, US << MARKET, 5051, 1, 165800)
(STARFRUIT, MARKET << US, 5045, 1, 165800)","{""AMETHYSTS"": -5, ""STARFRUIT"": 5}",1454,5048,10001
165900,-19992,6227,"(AMETHYSTS, US << MARKET, 9996, 1, 165900)
(AMETHYSTS, US << MARKET, 9996, 1, 165900)","{""AMETHYSTS"": -3, ""STARFRUIT"": 5}",1462,5047,10000
166000,20196,26423,"(STARFRUIT, MARKET << US, 5049, 1, 166000)
(STARFRUIT, MARKET << US, 5049, 1, 166000)
(STARFRUIT, MARKET << US, 5049, 1, 166000)
(STARFRUIT, MARKET << US, 5049, 1, 166000)","{""AMETHYSTS"": -3, ""STARFRUIT"": 1}",1473,5050,10000
166200,-10002,16421,"(AMETHYSTS, US << MARKET, 10002, 1, 166200)","{""AMETHYSTS"": -2, ""STARFRUIT"": 1}",1462,5047,10003
166500,5045,21466,"(STARFRUIT, MARKET << US, 5045, 1, 166500)","{""AMETHYSTS"": -2, ""STARFRUIT"": 0}",1466,5048,10000
167100,-29892,-8426,"(AMETHYSTS, US << MARKET, 9996, 1, 167100)
(AMETHYSTS, US << MARKET, 9996, 1, 167100)
(AMETHYSTS, US << MARKET, 9996, 1, 167100)
(AMETHYSTS, US << MARKET, 9996, 1, 167100)
(STARFRUIT, MARKET << US, 5046, 1, 167100)
(STARFRUIT, MARKET << US, 5046, 1, 167100)","{""AMETHYSTS"": 2, ""STARFRUIT"": -2}",1476,5049,10000
167400,5052,-3374,"(STARFRUIT, MARKET << US, 5052, 1, 167400)","{""AMETHYSTS"": 2, ""STARFRUIT"": -3}",1477,5049,9999
167800,25235,21861,"(STARFRUIT, MARKET << US, 5047, 1, 167800)
(STARFRUIT, MARKET << US, 5047, 1, 167800)
(STARFRUIT, MARKET << US, 5047, 1, 167800)
(STARFRUIT, MARKET << US, 5047, 1, 167800)
(STARFRUIT, MARKET << US, 5047, 1, 167800)","{""AMETHYSTS"": 2, ""STARFRUIT"": -8}",1461,5050,10000
168200,50124,71985,"(AMETHYSTS, MARKET << US, 10005, 1, 168200)
(AMETHYSTS, MARKET << US, 10005, 1, 168200)
(AMETHYSTS, MARKET << US, 10005, 1, 168200)
(AMETHYSTS, MARKET << US, 10005, 1, 168200)
(STARFRUIT, MARKET << US, 5052, 1, 168200)
(STARFRUIT, MARKET << US, 5052, 1, 168200)","{""AMETHYSTS"": -2, ""STARFRUIT"": -10}",1495,5049,10000
168400,160064,232049,"(AMETHYSTS, US << MARKET, 10004, 1, 168400)
(AMETHYSTS, MARKET << US, 10004, 1, 168400)
(AMETHYSTS, MARKET << US, 10004, 1, 168400)
(AMETHYSTS, MARKET << US, 10004, 1, 168400)
(AMETHYSTS, MARKET << US, 10004, 1, 168400)
(AMETHYSTS, MARKET << US, 10004, 1, 168400)
(AMETHYSTS, MARKET << US, 10004, 1, 168400)
(AMETHYSTS, MARKET << US, 10004, 1, 168400)
(AMETHYSTS, MARKET << US, 10004, 1, 168400)
(AMETHYSTS, MARKET << US, 10004, 1, 168400)
(AMETHYSTS, MARKET << US, 10004, 1, 168400)
(AMETHYSTS, MARKET << US, 10004, 1, 168400)
(AMETHYSTS, MARKET << US, 10004, 1, 168400)
(AMETHYSTS, MARKET << US, 10004, 1, 168400)
(AMETHYSTS, MARKET << US, 10004, 1, 168400)
(AMETHYSTS, MARKET << US, 10004, 1, 168400)
(AMETHYSTS, MARKET << US, 10004, 1, 168400)
(AMETHYSTS, MARKET << US, 10004, 1, 168400)","{""AMETHYSTS"": -18, ""STARFRUIT"": -10}",1541,5049,10001
168700,0,232049,,"{""AMETHYSTS"": -18, ""STARFRUIT"": -10}",1595,5049,9998
169000,-35434,196615,"(AMETHYSTS, MARKET << US, 9998, 1, 169000)
(STARFRUIT, US << MARKET, 5048, 1, 169000)
(STARFRUIT, US << MARKET, 5048, 1, 169000)
(STARFRUIT, US << MARKET, 5048, 1, 169000)
(STARFRUIT, US << MARKET, 5048, 1, 169000)
(STARFRUIT, US << MARKET, 5048, 1, 169000)
(STARFRUIT, US << MARKET, 5048, 1, 169000)
(STARFRUIT, US << MARKET, 5048, 1, 169000)
(STARFRUIT, US << MARKET, 5048, 1, 169000)
(STARFRUIT, US << MARKET, 5048, 1, 169000)","{""AMETHYSTS"": -19, ""STARFRUIT"": -1}",1625,5047,9997
169200,-10193,186422,"(AMETHYSTS, MARKET << US, 9995, 1, 169200)
(STARFRUIT, US << MARKET, 5047, 1, 169200)
(STARFRUIT, US << MARKET, 5047, 1, 169200)
(STARFRUIT, US << MARKET, 5047, 1, 169200)
(STARFRUIT, US << MARKET, 5047, 1, 169200)","{""AMETHYSTS"": -20, ""STARFRUIT"": 3}",1572,5050,10000
169900,-39992,146430,"(AMETHYSTS, US << MARKET, 9998, 1, 169900)
(AMETHYSTS, US << MARKET, 9998, 1, 169900)
(AMETHYSTS, US << MARKET, 9998, 1, 169900)
(AMETHYSTS, US << MARKET, 9998, 1, 169900)","{""AMETHYSTS"": -16, ""STARFRUIT"": 3}",1577,5049,10000
170000,-99980,46450,"(AMETHYSTS, US << MARKET, 9998, 1, 170000)
(AMETHYSTS, US << MARKET, 9998, 1, 170000)
(AMETHYSTS, US << MARKET, 9998, 1, 170000)
(AMETHYSTS, US << MARKET, 9998, 1, 170000)
(AMETHYSTS, US << MARKET, 9998, 1, 170000)
(AMETHYSTS, US << MARKET, 9998, 1, 170000)
(AMETHYSTS, US << MARKET, 9998, 1, 170000)
(AMETHYSTS, US << MARKET, 9998, 1, 170000)
(AMETHYSTS, US << MARKET, 9998, 1, 170000)
(AMETHYSTS, US << MARKET, 9998, 1, 170000)","{""AMETHYSTS"": -6, ""STARFRUIT"": 3}",1618,5048,9996
170100,5046,51496,"(STARFRUIT, MARKET << US, 5046, 1, 170100)","{""AMETHYSTS"": -6, ""STARFRUIT"": 2}",1594,5049,10000
170200,9998,61494,"(AMETHYSTS, MARKET << US, 9998, 1, 170200)","{""AMETHYSTS"": -7, ""STARFRUIT"": 2}",1613,5049,9997
171300,9998,71492,"(AMETHYSTS, MARKET << US, 9998, 1, 171300)","{""AMETHYSTS"": -8, ""STARFRUIT"": 2}",1574,5045,10001
171600,-14945,56547,"(AMETHYSTS, US << MARKET, 9998, 1, 171600)
(AMETHYSTS, US << MARKET, 9998, 1, 171600)
(STARFRUIT, MARKET << US, 5051, 1, 171600)","{""AMETHYSTS"": -6, ""STARFRUIT"": 1}",1617,5052,9997
171700,40008,96555,"(AMETHYSTS, MARKET << US, 10002, 1, 171700)
(AMETHYSTS, MARKET << US, 10002, 1, 171700)
(AMETHYSTS, MARKET << US, 10002, 1, 171700)
(AMETHYSTS, MARKET << US, 10002, 1, 171700)","{""AMETHYSTS"": -10, ""STARFRUIT"": 1}",1574,5049,10003
171800,-14939,81616,"(AMETHYSTS, US << MARKET, 9995, 1, 171800)
(AMETHYSTS, US << MARKET, 9995, 1, 171800)
(STARFRUIT, MARKET << US, 5051, 1, 171800)","{""AMETHYSTS"": -8, ""STARFRUIT"": 0}",1616,5052,10000
172300,-30282,51334,"(STARFRUIT, US << MARKET, 5047, 1, 172300)
(STARFRUIT, US << MARKET, 5047, 1, 172300)
(STARFRUIT, US << MARKET, 5047, 1, 172300)
(STARFRUIT, US << MARKET, 5047, 1, 172300)
(STARFRUIT, US << MARKET, 5047, 1, 172300)
(STARFRUIT, US << MARKET, 5047, 1, 172300)","{""AMETHYSTS"": -8, ""STARFRUIT"": 6}",1628,5049,10000
172500,25235,76569,"(STARFRUIT, MARKET << US, 5047, 1, 172500)
(STARFRUIT, MARKET << US, 5047, 1, 172500)
(STARFRUIT, MARKET << US, 5047, 1, 172500)
(STARFRUIT, MARKET << US, 5047, 1, 172500)
(STARFRUIT, MARKET << US, 5047, 1, 172500)","{""AMETHYSTS"": -8, ""STARFRUIT"": 1}",1619,5050,10000
172600,25062,101631,"(AMETHYSTS, MARKET << US, 10004, 1, 172600)
(AMETHYSTS, MARKET << US, 10004, 1, 172600)
(STARFRUIT, MARKET << US, 5054, 1, 172600)","{""AMETHYSTS"": -10, ""STARFRUIT"": 0}",1631,5050,10000
172800,-10096,91535,"(STARFRUIT, US << MARKET, 5048, 1, 172800)
(STARFRUIT, US << MARKET, 5048, 1, 172800)","{""AMETHYSTS"": -10, ""STARFRUIT"": 2}",1629,5047,10000
172900,-39992,51543,"(AMETHYSTS, US << MARKET, 9998, 1, 172900)
(AMETHYSTS, US << MARKET, 9998, 1, 172900)
(AMETHYSTS, US << MARKET, 9998, 1, 172900)
(AMETHYSTS, US << MARKET, 9998, 1, 172900)","{""AMETHYSTS"": -6, ""STARFRUIT"": 2}",1667,5050,9996
173000,-29898,21645,"(AMETHYSTS, US << MARKET, 9998, 1, 173000)
(AMETHYSTS, US << MARKET, 9998, 1, 173000)
(AMETHYSTS, US << MARKET, 9998, 1, 173000)
(AMETHYSTS, US << MARKET, 9998, 1, 173000)
(STARFRUIT, MARKET << US, 5047, 1, 173000)
(STARFRUIT, MARKET << US, 5047, 1, 173000)","{""AMETHYSTS"": -2, ""STARFRUIT"": 0}",1643,5050,10001
173100,-10096,11549,"(STARFRUIT, US << MARKET, 5048, 1, 173100)
(STARFRUIT, US << MARKET, 5048, 1, 173100)","{""AMETHYSTS"": -2, ""STARFRUIT"": 2}",1647,5047,9998
173300,4843,16392,"(AMETHYSTS, MARKET << US, 10004, 1, 173300)
(AMETHYSTS, MARKET << US, 10004, 1, 173300)
(STARFRUIT, US << MARKET, 5055, 1, 173300)
(STARFRUIT, US << MARKET, 5055, 1, 173300)
(STARFRUIT, US << MARKET, 5055, 1, 173300)
(STARFRUIT, US << MARKET, 5055, 1, 173300)
(STARFRUIT, US << MARKET, 5055, 1, 173300)
(STARFRUIT, MARKET << US, 5055, 1, 173300)
(STARFRUIT, MARKET << US, 5055, 1, 173300)","{""AMETHYSTS"": -4, ""STARFRUIT"": 5}",1647,5051,10000
173600,5053,21445,"(STARFRUIT, MARKET << US, 5053, 1, 173600)","{""AMETHYSTS"": -4, ""STARFRUIT"": 4}",1657,5054,10001
174400,-9999,11446,"(AMETHYSTS, US << MARKET, 10002, 1, 174400)
(STARFRUIT, US << MARKET, 5050, 1, 174400)
(STARFRUIT, US << MARKET, 5050, 1, 174400)
(STARFRUIT, US << MARKET, 5050, 1, 174400)
(STARFRUIT, MARKET << US, 5051, 1, 174400)
(STARFRUIT, MARKET << US, 5051, 1, 174400)
(STARFRUIT, MARKET << US, 5051, 1, 174400)","{""AMETHYSTS"": -3, ""STARFRUIT"": 4}",1637,5050,10003
174600,20004,31450,"(AMETHYSTS, MARKET << US, 10002, 1, 174600)
(AMETHYSTS, MARKET << US, 10002, 1, 174600)","{""AMETHYSTS"": -5, ""STARFRUIT"": 4}",1676,5054,9998
174800,-10100,21350,"(STARFRUIT, US << MARKET, 5050, 1, 174800)
(STARFRUIT, US << MARKET, 5050, 1, 174800)","{""AMETHYSTS"": -5, ""STARFRUIT"": 6}",1662,5052,10000
175100,-20004,1346,"(AMETHYSTS, US << MARKET, 10002, 1, 175100)
(AMETHYSTS, US << MARKET, 10002, 1, 175100)","{""AMETHYSTS"": -3, ""STARFRUIT"": 6}",1676,5054,9998
176300,-30015,-28669,"(AMETHYSTS, US << MARKET, 10005, 1, 176300)
(AMETHYSTS, US << MARKET, 10005, 1, 176300)
(AMETHYSTS, US << MARKET, 10005, 1, 176300)","{""AMETHYSTS"": 0, ""STARFRUIT"": 6}",1655,5054,10001
176700,50096,21427,"(AMETHYSTS, MARKET << US, 9998, 1, 176700)
(AMETHYSTS, MARKET << US, 9998, 1, 176700)
(AMETHYSTS, MARKET << US, 9998, 1, 176700)
(AMETHYSTS, MARKET << US, 9998, 1, 176700)
(STARFRUIT, MARKET << US, 5052, 1, 176700)
(STARFRUIT, MARKET << US, 5052, 1, 176700)","{""AMETHYSTS"": -4, ""STARFRUIT"": 4}",1643,5055,10001
177000,5052,26479,"(STARFRUIT, MARKET << US, 5052, 1, 177000)","{""AMETHYSTS"": -4, ""STARFRUIT"": 3}",1644,5055,10000
177600,120060,146539,"(AMETHYSTS, MARKET << US, 10005, 1, 177600)
(AMETHYSTS, MARKET << US, 10005, 1, 177600)
(AMETHYSTS, MARKET << US, 10005, 1, 177600)
(AMETHYSTS, MARKET << US, 10005, 1, 177600)
(AMETHYSTS, MARKET << US, 10005, 1, 177600)
(AMETHYSTS, MARKET << US, 10005, 1, 177600)
(AMETHYSTS, MARKET << US, 10005, 1, 177600)
(AMETHYSTS, MARKET << US, 10005, 1, 177600)
(AMETHYSTS, MARKET << US, 10005, 1, 177600)
(AMETHYSTS, MARKET << US, 10005, 1, 177600)
(AMETHYSTS, MARKET << US, 10005, 1, 177600)
(AMETHYSTS, MARKET << US, 10005, 1, 177600)","{""AMETHYSTS"": -16, ""STARFRUIT"": 3}",1701,5054,10000
177900,-4946,141593,"(AMETHYSTS, US << MARKET, 10004, 1, 177900)
(STARFRUIT, MARKET << US, 5058, 1, 177900)","{""AMETHYSTS"": -15, ""STARFRUIT"": 2}",1703,5055,10000
178100,-25280,116313,"(STARFRUIT, US << MARKET, 5056, 1, 178100)
(STARFRUIT, US << MARKET, 5056, 1, 178100)
(STARFRUIT, US << MARKET, 5056, 1, 178100)
(STARFRUIT, US << MARKET, 5056, 1, 178100)
(STARFRUIT, US << MARKET, 5056, 1, 178100)","{""AMETHYSTS"": -15, ""STARFRUIT"": 7}",1712,5057,10000
178800,5052,121365,"(STARFRUIT, MARKET << US, 5052, 1, 178800)","{""AMETHYSTS"": -15, ""STARFRUIT"": 6}",1689,5054,10000
179000,25295,146660,"(STARFRUIT, MARKET << US, 5059, 1, 179000)
(STARFRUIT, MARKET << US, 5059, 1, 179000)
(STARFRUIT, MARKET << US, 5059, 1, 179000)
(STARFRUIT, MARKET << US, 5059, 1, 179000)
(STARFRUIT, MARKET << US, 5059, 1, 179000)","{""AMETHYSTS"": -15, ""STARFRUIT"": 1}",1730,5055,9999
179500,-10002,136658,"(AMETHYSTS, US << MARKET, 10002, 1, 179500)","{""AMETHYSTS"": -14, ""STARFRUIT"": 1}",1671,5055,10003
179600,-10114,126544,"(STARFRUIT, US << MARKET, 5057, 1, 179600)
(STARFRUIT, US << MARKET, 5057, 1, 179600)","{""AMETHYSTS"": -14, ""STARFRUIT"": 3}",1715,5057,10000
179900,-40008,86536,"(AMETHYSTS, US << MARKET, 10002, 1, 179900)
(AMETHYSTS, US << MARKET, 10002, 1, 179900)
(AMETHYSTS, US << MARKET, 10002, 1, 179900)
(AMETHYSTS, US << MARKET, 10002, 1, 179900)","{""AMETHYSTS"": -10, ""STARFRUIT"": 3}",1674,5056,10003
180000,9998,96534,"(AMETHYSTS, MARKET << US, 9998, 1, 180000)","{""AMETHYSTS"": -11, ""STARFRUIT"": 3}",1732,5055,9997
180100,-25290,71244,"(STARFRUIT, US << MARKET, 5058, 1, 180100)
(STARFRUIT, US << MARKET, 5058, 1, 180100)
(STARFRUIT, US << MARKET, 5058, 1, 180100)
(STARFRUIT, US << MARKET, 5058, 1, 180100)
(STARFRUIT, US << MARKET, 5058, 1, 180100)","{""AMETHYSTS"": -11, ""STARFRUIT"": 8}",1684,5055,10000
180300,-5051,66193,"(STARFRUIT, US << MARKET, 5051, 1, 180300)","{""AMETHYSTS"": -11, ""STARFRUIT"": 9}",1714,5053,9996
180400,5057,71250,"(STARFRUIT, MARKET << US, 5057, 1, 180400)","{""AMETHYSTS"": -11, ""STARFRUIT"": 8}",1706,5057,10000
180600,-10002,61248,"(AMETHYSTS, US << MARKET, 10002, 1, 180600)","{""AMETHYSTS"": -10, ""STARFRUIT"": 8}",1658,5055,10003
180900,20120,81368,"(AMETHYSTS, US << MARKET, 10004, 1, 180900)
(AMETHYSTS, MARKET << US, 10004, 1, 180900)
(AMETHYSTS, MARKET << US, 10004, 1, 180900)
(STARFRUIT, MARKET << US, 5058, 1, 180900)
(STARFRUIT, MARKET << US, 5058, 1, 180900)","{""AMETHYSTS"": -11, ""STARFRUIT"": 6}",1698,5055,10000
181600,-30006,51362,"(AMETHYSTS, US << MARKET, 10002, 1, 181600)
(AMETHYSTS, US << MARKET, 10002, 1, 181600)
(AMETHYSTS, US << MARKET, 10002, 1, 181600)","{""AMETHYSTS"": -8, ""STARFRUIT"": 6}",1656,5053,10003
181700,-20224,31138,"(STARFRUIT, US << MARKET, 5056, 1, 181700)
(STARFRUIT, US << MARKET, 5056, 1, 181700)
(STARFRUIT, US << MARKET, 5056, 1, 181700)
(STARFRUIT, US << MARKET, 5056, 1, 181700)","{""AMETHYSTS"": -8, ""STARFRUIT"": 10}",1660,5053,10001
182200,-5053,26085,"(STARFRUIT, US << MARKET, 5053, 1, 182200)","{""AMETHYSTS"": -8, ""STARFRUIT"": 11}",1616,5049,10001
182500,25057,51142,"(AMETHYSTS, MARKET << US, 10002, 1, 182500)
(AMETHYSTS, MARKET << US, 10002, 1, 182500)
(STARFRUIT, MARKET << US, 5053, 1, 182500)","{""AMETHYSTS"": -10, ""STARFRUIT"": 10}",1642,5053,10003
182800,-10002,41140,"(AMETHYSTS, US << MARKET, 10002, 1, 182800)","{""AMETHYSTS"": -9, ""STARFRUIT"": 10}",1648,5049,9998
182900,-20220,20920,"(STARFRUIT, US << MARKET, 5055, 1, 182900)
(STARFRUIT, US << MARKET, 5055, 1, 182900)
(STARFRUIT, US << MARKET, 5055, 1, 182900)
(STARFRUIT, US << MARKET, 5055, 1, 182900)","{""AMETHYSTS"": -9, ""STARFRUIT"": 14}",1648,5052,10000
183300,-5049,15871,"(STARFRUIT, US << MARKET, 5049, 1, 183300)","{""AMETHYSTS"": -9, ""STARFRUIT"": 15}",1651,5052,10000
183400,99980,115851,"(AMETHYSTS, MARKET << US, 9998, 1, 183400)
(AMETHYSTS, MARKET << US, 9998, 1, 183400)
(AMETHYSTS, MARKET << US, 9998, 1, 183400)
(AMETHYSTS, MARKET << US, 9998, 1, 183400)
(AMETHYSTS, MARKET << US, 9998, 1, 183400)
(AMETHYSTS, MARKET << US, 9998, 1, 183400)
(AMETHYSTS, MARKET << US, 9998, 1, 183400)
(AMETHYSTS, MARKET << US, 9998, 1, 183400)
(AMETHYSTS, MARKET << US, 9998, 1, 183400)
(AMETHYSTS, MARKET << US, 9998, 1, 183400)","{""AMETHYSTS"": -19, ""STARFRUIT"": 15}",1658,5050,9997
183600,-30214,85637,"(AMETHYSTS, US << MARKET, 10002, 1, 183600)
(STARFRUIT, US << MARKET, 5053, 1, 183600)
(STARFRUIT, US << MARKET, 5053, 1, 183600)
(STARFRUIT, US << MARKET, 5053, 1, 183600)
(STARFRUIT, US << MARKET, 5053, 1, 183600)","{""AMETHYSTS"": -18, ""STARFRUIT"": 19}",1699,5054,9998
183800,-5048,80589,"(STARFRUIT, US << MARKET, 5048, 1, 183800)","{""AMETHYSTS"": -18, ""STARFRUIT"": 20}",1609,5051,10000
184800,15051,95640,"(AMETHYSTS, MARKET << US, 9998, 1, 184800)
(STARFRUIT, MARKET << US, 5053, 1, 184800)","{""AMETHYSTS"": -19, ""STARFRUIT"": 19}",1647,5054,10001
185000,4947,100587,"(AMETHYSTS, MARKET << US, 9996, 1, 185000)
(STARFRUIT, US << MARKET, 5049, 1, 185000)","{""AMETHYSTS"": -20, ""STARFRUIT"": 20}",1607,5051,10000
185500,0,100587,,"{""AMETHYSTS"": -20, ""STARFRUIT"": 20}",1607,5051,10000
185600,50480,151067,"(STARFRUIT, MARKET << US, 5048, 1, 185600)
(STARFRUIT, MARKET << US, 5048, 1, 185600)
(STARFRUIT, MARKET << US, 5048, 1, 185600)
(STARFRUIT, MARKET << US, 5048, 1, 185600)
(STARFRUIT, MARKET << US, 5048, 1, 185600)
(STARFRUIT, MARKET << US, 5048, 1, 185600)
(STARFRUIT, MARKET << US, 5048, 1, 185600)
(STARFRUIT, MARKET << US, 5048, 1, 185600)
(STARFRUIT, MARKET << US, 5048, 1, 185600)
(STARFRUIT, MARKET << US, 5048, 1, 185600)","{""AMETHYSTS"": -20, ""STARFRUIT"": 10}",1597,5051,9999
185800,5053,156120,"(STARFRUIT, MARKET << US, 5053, 1, 185800)","{""AMETHYSTS"": -20, ""STARFRUIT"": 9}",1617,5053,9999
186200,0,156120,,"{""AMETHYSTS"": -20, ""STARFRUIT"": 9}",1599,5051,9999
186700,-19992,136128,"(AMETHYSTS, US << MARKET, 9996, 1, 186700)
(AMETHYSTS, US << MARKET, 9996, 1, 186700)","{""AMETHYSTS"": -18, ""STARFRUIT"": 9}",1641,5051,9997
187000,5050,141178,"(STARFRUIT, MARKET << US, 5050, 1, 187000)","{""AMETHYSTS"": -18, ""STARFRUIT"": 8}",1570,5049,10000
187200,9998,151176,"(AMETHYSTS, MARKET << US, 9998, 1, 187200)","{""AMETHYSTS"": -19, ""STARFRUIT"": 8}",1692,5055,9996
187300,-14940,136236,"(AMETHYSTS, US << MARKET, 9995, 1, 187300)
(AMETHYSTS, US << MARKET, 9995, 1, 187300)
(STARFRUIT, MARKET << US, 5050, 1, 187300)","{""AMETHYSTS"": -17, ""STARFRUIT"": 7}",1634,5052,9998
187600,14955,151191,"(AMETHYSTS, MARKET << US, 10002, 1, 187600)
(AMETHYSTS, MARKET << US, 10002, 1, 187600)
(STARFRUIT, US << MARKET, 5049, 1, 187600)","{""AMETHYSTS"": -19, ""STARFRUIT"": 8}",1550,5052,10003
187900,-99992,51199,"(AMETHYSTS, US << MARKET, 9998, 1, 187900)
(AMETHYSTS, US << MARKET, 9998, 1, 187900)
(AMETHYSTS, US << MARKET, 9998, 1, 187900)
(AMETHYSTS, US << MARKET, 9998, 1, 187900)
(AMETHYSTS, US << MARKET, 9998, 1, 187900)
(AMETHYSTS, US << MARKET, 9998, 1, 187900)
(AMETHYSTS, US << MARKET, 9998, 1, 187900)
(AMETHYSTS, US << MARKET, 9998, 1, 187900)
(AMETHYSTS, US << MARKET, 10004, 1, 187900)
(AMETHYSTS, US << MARKET, 10004, 1, 187900)","{""AMETHYSTS"": -9, ""STARFRUIT"": 8}",1582,5049,10001
188200,109,51308,"(AMETHYSTS, US << MARKET, 9998, 1, 188200)
(AMETHYSTS, US << MARKET, 9998, 1, 188200)
(AMETHYSTS, MARKET << US, 9996, 1, 188200)
(STARFRUIT, US << MARKET, 5050, 1, 188200)
(STARFRUIT, MARKET << US, 5053, 1, 188200)
(STARFRUIT, MARKET << US, 5053, 1, 188200)
(STARFRUIT, MARKET << US, 5053, 1, 188200)","{""AMETHYSTS"": -8, ""STARFRUIT"": 6}",1638,5051,9997
188500,25066,76374,"(AMETHYSTS, MARKET << US, 10005, 1, 188500)
(AMETHYSTS, MARKET << US, 10005, 1, 188500)
(STARFRUIT, MARKET << US, 5056, 1, 188500)","{""AMETHYSTS"": -10, ""STARFRUIT"": 5}",1634,5052,10000
189200,19992,96366,"(AMETHYSTS, MARKET << US, 9996, 1, 189200)
(AMETHYSTS, MARKET << US, 9996, 1, 189200)","{""AMETHYSTS"": -12, ""STARFRUIT"": 5}",1626,5052,10000
189600,-35160,61206,"(AMETHYSTS, US << MARKET, 10002, 1, 189600)
(AMETHYSTS, US << MARKET, 10002, 1, 189600)
(STARFRUIT, US << MARKET, 5052, 1, 189600)
(STARFRUIT, US << MARKET, 5052, 1, 189600)
(STARFRUIT, US << MARKET, 5052, 1, 189600)","{""AMETHYSTS"": -10, ""STARFRUIT"": 8}",1576,5050,10003
189800,9998,71204,"(AMETHYSTS, MARKET << US, 9998, 1, 189800)","{""AMETHYSTS"": -11, ""STARFRUIT"": 8}",1664,5052,9996
190000,-19996,51208,"(AMETHYSTS, US << MARKET, 9998, 1, 190000)
(AMETHYSTS, US << MARKET, 9998, 1, 190000)","{""AMETHYSTS"": -9, ""STARFRUIT"": 8}",1651,5052,9997
190200,5048,56256,"(STARFRUIT, MARKET << US, 5048, 1, 190200)","{""AMETHYSTS"": -9, ""STARFRUIT"": 7}",1642,5050,9996
190300,-39984,16272,"(AMETHYSTS, US << MARKET, 9996, 1, 190300)
(AMETHYSTS, US << MARKET, 9996, 1, 190300)
(AMETHYSTS, US << MARKET, 9996, 1, 190300)
(AMETHYSTS, US << MARKET, 9996, 1, 190300)","{""AMETHYSTS"": -5, ""STARFRUIT"": 7}",1622,5050,10000
190800,20200,36472,"(STARFRUIT, MARKET << US, 5050, 1, 190800)
(STARFRUIT, MARKET << US, 5050, 1, 190800)
(STARFRUIT, MARKET << US, 5050, 1, 190800)
(STARFRUIT, MARKET << US, 5050, 1, 190800)","{""AMETHYSTS"": -5, ""STARFRUIT"": 3}",1630,5051,9999
190900,-55115,-18643,"(AMETHYSTS, US << MARKET, 9995, 1, 190900)
(AMETHYSTS, US << MARKET, 9995, 1, 190900)
(AMETHYSTS, US << MARKET, 9995, 1, 190900)
(AMETHYSTS, US << MARKET, 9995, 1, 190900)
(STARFRUIT, US << MARKET, 5045, 1, 190900)
(STARFRUIT, US << MARKET, 5045, 1, 190900)
(STARFRUIT, US << MARKET, 5045, 1, 190900)","{""AMETHYSTS"": -1, ""STARFRUIT"": 6}",1647,5048,9998
192200,-10100,-28743,"(STARFRUIT, US << MARKET, 5050, 1, 192200)
(STARFRUIT, US << MARKET, 5050, 1, 192200)","{""AMETHYSTS"": -1, ""STARFRUIT"": 8}",1665,5051,10000
192400,-20212,-48955,"(STARFRUIT, US << MARKET, 5053, 1, 192400)
(STARFRUIT, US << MARKET, 5053, 1, 192400)
(STARFRUIT, US << MARKET, 5053, 1, 192400)
(STARFRUIT, US << MARKET, 5053, 1, 192400)","{""AMETHYSTS"": -1, ""STARFRUIT"": 12}",1633,5049,10000
192900,20192,-28763,"(STARFRUIT, MARKET << US, 5048, 1, 192900)
(STARFRUIT, MARKET << US, 5048, 1, 192900)
(STARFRUIT, MARKET << US, 5048, 1, 192900)
(STARFRUIT, MARKET << US, 5048, 1, 192900)","{""AMETHYSTS"": -1, ""STARFRUIT"": 8}",1643,5051,10002
193000,15042,-13721,"(AMETHYSTS, MARKET << US, 9995, 1, 193000)
(STARFRUIT, MARKET << US, 5047, 1, 193000)","{""AMETHYSTS"": -2, ""STARFRUIT"": 7}",1614,5047,9997
193100,-5047,-18768,"(STARFRUIT, US << MARKET, 5047, 1, 193100)","{""AMETHYSTS"": -2, ""STARFRUIT"": 8}",1632,5050,10000
193200,-5051,-23819,"(STARFRUIT, US << MARKET, 5051, 1, 193200)","{""AMETHYSTS"": -2, ""STARFRUIT"": 9}",1653,5052,9998
193700,-130263,-154082,"(AMETHYSTS, US << MARKET, 10005, 1, 193700)
(AMETHYSTS, US << MARKET, 10005, 1, 193700)
(AMETHYSTS, US << MARKET, 10005, 1, 193700)
(AMETHYSTS, US << MARKET, 10005, 1, 193700)
(AMETHYSTS, US << MARKET, 10005, 1, 193700)
(AMETHYSTS, US << MARKET, 10005, 1, 193700)
(AMETHYSTS, US << MARKET, 10005, 1, 193700)
(AMETHYSTS, US << MARKET, 10005, 1, 193700)
(AMETHYSTS, US << MARKET, 10005, 1, 193700)
(AMETHYSTS, US << MARKET, 10005, 1, 193700)
(AMETHYSTS, US << MARKET, 10005, 1, 193700)
(STARFRUIT, US << MARKET, 5052, 1, 193700)
(STARFRUIT, US << MARKET, 5052, 1, 193700)
(STARFRUIT, US << MARKET, 5052, 1, 193700)
(STARFRUIT, US << MARKET, 5052, 1, 193700)","{""AMETHYSTS"": 9, ""STARFRUIT"": 13}",1542,5048,10000
193800,-19996,-174078,"(AMETHYSTS, US << MARKET, 9998, 1, 193800)
(AMETHYSTS, US << MARKET, 9998, 1, 193800)","{""AMETHYSTS"": 11, ""STARFRUIT"": 13}",1570,5049,10001
193900,14940,-159138,"(AMETHYSTS, MARKET << US, 9996, 1, 193900)
(AMETHYSTS, MARKET << US, 9996, 1, 193900)
(STARFRUIT, US << MARKET, 5052, 1, 193900)","{""AMETHYSTS"": 9, ""STARFRUIT"": 14}",1548,5049,10000
194000,-5054,-164192,"(STARFRUIT, US << MARKET, 5054, 1, 194000)","{""AMETHYSTS"": 9, ""STARFRUIT"": 15}",1558,5050,10000
194200,25053,-139139,"(AMETHYSTS, MARKET << US, 10002, 1, 194200)
(AMETHYSTS, MARKET << US, 10002, 1, 194200)
(STARFRUIT, MARKET << US, 5049, 1, 194200)","{""AMETHYSTS"": 7, ""STARFRUIT"": 14}",1610,5052,10003
194300,5048,-134091,"(STARFRUIT, MARKET << US, 5048, 1, 194300)","{""AMETHYSTS"": 7, ""STARFRUIT"": 13}",1572,5051,10000
194800,4947,-129144,"(AMETHYSTS, MARKET << US, 9995, 1, 194800)
(STARFRUIT, US << MARKET, 5048, 1, 194800)","{""AMETHYSTS"": 6, ""STARFRUIT"": 14}",1556,5050,10000
195100,9996,-119148,"(AMETHYSTS, MARKET << US, 9996, 1, 195100)","{""AMETHYSTS"": 5, ""STARFRUIT"": 14}",1566,5051,10000
195300,-15156,-134304,"(STARFRUIT, US << MARKET, 5052, 1, 195300)
(STARFRUIT, US << MARKET, 5052, 1, 195300)
(STARFRUIT, US << MARKET, 5052, 1, 195300)","{""AMETHYSTS"": 5, ""STARFRUIT"": 17}",1597,5053,10000
195500,-5047,-139351,"(STARFRUIT, US << MARKET, 5047, 1, 195500)","{""AMETHYSTS"": 5, ""STARFRUIT"": 18}",1564,5050,10003
195600,-30106,-169457,"(AMETHYSTS, US << MARKET, 10004, 1, 195600)
(AMETHYSTS, US << MARKET, 10004, 1, 195600)
(STARFRUIT, US << MARKET, 5049, 1, 195600)
(STARFRUIT, US << MARKET, 5049, 1, 195600)","{""AMETHYSTS"": 7, ""STARFRUIT"": 20}",1510,5048,10001
195700,0,-169457,,"{""AMETHYSTS"": 7, ""STARFRUIT"": 20}",1590,5052,10001
196100,30312,-139145,"(STARFRUIT, MARKET << US, 5052, 1, 196100)
(STARFRUIT, MARKET << US, 5052, 1, 196100)
(STARFRUIT, MARKET << US, 5052, 1, 196100)
(STARFRUIT, MARKET << US, 5052, 1, 196100)
(STARFRUIT, MARKET << US, 5052, 1, 196100)
(STARFRUIT, MARKET << US, 5052, 1, 196100)","{""AMETHYSTS"": 7, ""STARFRUIT"": 14}",1541,5049,10000
196700,-5052,-144197,"(STARFRUIT, US << MARKET, 5052, 1, 196700)","{""AMETHYSTS"": 7, ""STARFRUIT"": 15}",1590,5052,10001
197000,-19996,-164193,"(AMETHYSTS, US << MARKET, 9998, 1, 197000)
(AMETHYSTS, US << MARKET, 9998, 1, 197000)","{""AMETHYSTS"": 9, ""STARFRUIT"": 15}",1515,5049,9997
197100,20004,-144189,"(AMETHYSTS, MARKET << US, 10002, 1, 197100)
(AMETHYSTS, MARKET << US, 10002, 1, 197100)","{""AMETHYSTS"": 7, ""STARFRUIT"": 15}",1582,5050,10003
197400,-19992,-164181,"(AMETHYSTS, US << MARKET, 9996, 1, 197400)
(AMETHYSTS, US << MARKET, 9996, 1, 197400)","{""AMETHYSTS"": 9, ""STARFRUIT"": 15}",1542,5050,9997
197500,-99980,-264161,"(AMETHYSTS, US << MARKET, 9998, 1, 197500)
(AMETHYSTS, US << MARKET, 9998, 1, 197500)
(AMETHYSTS, US << MARKET, 9998, 1, 197500)
(AMETHYSTS, US << MARKET, 9998, 1, 197500)
(AMETHYSTS, US << MARKET, 9998, 1, 197500)
(AMETHYSTS, US << MARKET, 9998, 1, 197500)
(AMETHYSTS, US << MARKET, 9998, 1, 197500)
(AMETHYSTS, US << MARKET, 9998, 1, 197500)
(AMETHYSTS, US << MARKET, 9998, 1, 197500)
(AMETHYSTS, US << MARKET, 9998, 1, 197500)","{""AMETHYSTS"": 19, ""STARFRUIT"": 15}",1608,5050,10001
197700,-15042,-279203,"(AMETHYSTS, US << MARKET, 9995, 1, 197700)
(STARFRUIT, US << MARKET, 5047, 1, 197700)","{""AMETHYSTS"": 20, ""STARFRUIT"": 16}",1509,5047,9998
198000,-5048,-284251,"(STARFRUIT, US << MARKET, 5048, 1, 198000)","{""AMETHYSTS"": 20, ""STARFRUIT"": 17}",1616,5051,10000
198400,20094,-264157,"(AMETHYSTS, MARKET << US, 9998, 1, 198400)
(STARFRUIT, MARKET << US, 5048, 1, 198400)
(STARFRUIT, MARKET << US, 5048, 1, 198400)","{""AMETHYSTS"": 19, ""STARFRUIT"": 15}",1567,5047,10001
198500,-10002,-274159,"(AMETHYSTS, US << MARKET, 10002, 1, 198500)","{""AMETHYSTS"": 20, ""STARFRUIT"": 15}",1556,5049,9999
199000,-5047,-279206,"(STARFRUIT, US << MARKET, 5047, 1, 199000)","{""AMETHYSTS"": 20, ""STARFRUIT"": 16}",1594,5050,10000
199300,5053,-274153,"(STARFRUIT, MARKET << US, 5053, 1, 199300)","{""AMETHYSTS"": 20, ""STARFRUIT"": 15}",1642,5053,10000
199400,0,-274153,,"{""AMETHYSTS"": 20, ""STARFRUIT"": 15}",1642,5049,10003
199700,20004,-254149,"(AMETHYSTS, MARKET << US, 10002, 1, 199700)
(AMETHYSTS, MARKET << US, 10002, 1, 199700)","{""AMETHYSTS"": 18, ""STARFRUIT"": 15}",1655,5050,10003
200100,94,-254055,"(AMETHYSTS, US << MARKET, 10002, 1, 200100)
(STARFRUIT, MARKET << US, 5048, 1, 200100)
(STARFRUIT, MARKET << US, 5048, 1, 200100)","{""AMETHYSTS"": 19, ""STARFRUIT"": 13}",1613,5047,10003
200200,35329,-218726,"(STARFRUIT, MARKET << US, 5047, 1, 200200)
(STARFRUIT, MARKET << US, 5047, 1, 200200)
(STARFRUIT, MARKET << US, 5047, 1, 200200)
(STARFRUIT, MARKET << US, 5047, 1, 200200)
(STARFRUIT, MARKET << US, 5047, 1, 200200)
(STARFRUIT, MARKET << US, 5047, 1, 200200)
(STARFRUIT, MARKET << US, 5047, 1, 200200)","{""AMETHYSTS"": 19, ""STARFRUIT"": 6}",1498,5050,9996
200300,-4956,-223682,"(AMETHYSTS, US << MARKET, 10004, 1, 200300)
(STARFRUIT, MARKET << US, 5048, 1, 200300)","{""AMETHYSTS"": 20, ""STARFRUIT"": 5}",1573,5047,10001
200400,10108,-213574,"(STARFRUIT, MARKET << US, 5054, 1, 200400)
(STARFRUIT, MARKET << US, 5054, 1, 200400)","{""AMETHYSTS"": 20, ""STARFRUIT"": 3}",1579,5051,10000
200800,20004,-193570,"(AMETHYSTS, MARKET << US, 10002, 1, 200800)
(AMETHYSTS, MARKET << US, 10002, 1, 200800)","{""AMETHYSTS"": 18, ""STARFRUIT"": 3}",1547,5051,9998
200900,5047,-188523,"(STARFRUIT, MARKET << US, 5047, 1, 200900)","{""AMETHYSTS"": 18, ""STARFRUIT"": 2}",1559,5050,9999
201800,29994,-158529,"(AMETHYSTS, MARKET << US, 9998, 1, 201800)
(AMETHYSTS, MARKET << US, 9998, 1, 201800)
(AMETHYSTS, MARKET << US, 9998, 1, 201800)","{""AMETHYSTS"": 15, ""STARFRUIT"": 2}",1524,5049,9997
202000,-30006,-188535,"(AMETHYSTS, US << MARKET, 10002, 1, 202000)
(AMETHYSTS, US << MARKET, 10002, 1, 202000)
(AMETHYSTS, US << MARKET, 10002, 1, 202000)","{""AMETHYSTS"": 18, ""STARFRUIT"": 2}",1619,5050,10003
202100,5048,-183487,"(STARFRUIT, MARKET << US, 5048, 1, 202100)","{""AMETHYSTS"": 18, ""STARFRUIT"": 1}",1578,5047,10001
202200,-10002,-193489,"(AMETHYSTS, US << MARKET, 10002, 1, 202200)","{""AMETHYSTS"": 19, ""STARFRUIT"": 1}",1620,5052,10003
202600,80016,-113473,"(AMETHYSTS, MARKET << US, 10002, 1, 202600)
(AMETHYSTS, MARKET << US, 10002, 1, 202600)
(AMETHYSTS, MARKET << US, 10002, 1, 202600)
(AMETHYSTS, MARKET << US, 10002, 1, 202600)
(AMETHYSTS, MARKET << US, 10002, 1, 202600)
(AMETHYSTS, MARKET << US, 10002, 1, 202600)
(AMETHYSTS, MARKET << US, 10002, 1, 202600)
(AMETHYSTS, MARKET << US, 10002, 1, 202600)","{""AMETHYSTS"": 11, ""STARFRUIT"": 1}",1610,5050,10003
203000,-10104,-123577,"(STARFRUIT, US << MARKET, 5052, 1, 203000)
(STARFRUIT, US << MARKET, 5052, 1, 203000)","{""AMETHYSTS"": 11, ""STARFRUIT"": 3}",1593,5053,10001
203300,-39984,-163561,"(AMETHYSTS, US << MARKET, 9996, 1, 203300)
(AMETHYSTS, US << MARKET, 9996, 1, 203300)
(AMETHYSTS, US << MARKET, 9996, 1, 203300)
(AMETHYSTS, US << MARKET, 9996, 1, 203300)","{""AMETHYSTS"": 15, ""STARFRUIT"": 3}",1553,5048,9998
203700,-10102,-173663,"(STARFRUIT, US << MARKET, 5051, 1, 203700)
(STARFRUIT, US << MARKET, 5051, 1, 203700)","{""AMETHYSTS"": 15, ""STARFRUIT"": 5}",1607,5051,10001
203900,4858,-168805,"(AMETHYSTS, MARKET << US, 10004, 1, 203900)
(AMETHYSTS, MARKET << US, 10004, 1, 203900)
(STARFRUIT, US << MARKET, 5050, 1, 203900)
(STARFRUIT, US << MARKET, 5050, 1, 203900)
(STARFRUIT, US << MARKET, 5050, 1, 203900)","{""AMETHYSTS"": 13, ""STARFRUIT"": 8}",1610,5047,10003
204000,10098,-158707,"(STARFRUIT, MARKET << US, 5049, 1, 204000)
(STARFRUIT, MARKET << US, 5049, 1, 204000)","{""AMETHYSTS"": 13, ""STARFRUIT"": 6}",1606,5050,10001
204200,5050,-153657,"(STARFRUIT, MARKET << US, 5050, 1, 204200)","{""AMETHYSTS"": 13, ""STARFRUIT"": 5}",1578,5047,10000
204400,-10100,-163757,"(STARFRUIT, US << MARKET, 5050, 1, 204400)
(STARFRUIT, US << MARKET, 5050, 1, 204400)","{""AMETHYSTS"": 13, ""STARFRUIT"": 7}",1585,5047,10001
204500,-5050,-168807,"(STARFRUIT, US << MARKET, 5050, 1, 204500)","{""AMETHYSTS"": 13, ""STARFRUIT"": 8}",1608,5047,10003
204800,160064,-8743,"(AMETHYSTS, MARKET << US, 10004, 1, 204800)
(AMETHYSTS, MARKET << US, 10004, 1, 204800)
(AMETHYSTS, MARKET << US, 10004, 1, 204800)
(AMETHYSTS, MARKET << US, 10004, 1, 204800)
(AMETHYSTS, MARKET << US, 10004, 1, 204800)
(AMETHYSTS, MARKET << US, 10004, 1, 204800)
(AMETHYSTS, MARKET << US, 10004, 1, 204800)
(AMETHYSTS, MARKET << US, 10004, 1, 204800)
(AMETHYSTS, MARKET << US, 10004, 1, 204800)
(AMETHYSTS, MARKET << US, 10004, 1, 204800)
(AMETHYSTS, MARKET << US, 10004, 1, 204800)
(AMETHYSTS, MARKET << US, 10004, 1, 204800)
(AMETHYSTS, MARKET << US, 10004, 1, 204800)
(AMETHYSTS, MARKET << US, 10004, 1, 204800)
(AMETHYSTS, MARKET << US, 10004, 1, 204800)
(AMETHYSTS, MARKET << US, 10004, 1, 204800)","{""AMETHYSTS"": -3, ""STARFRUIT"": 8}",1625,5046,10000
205000,34972,26229,"(AMETHYSTS, MARKET << US, 10004, 1, 205000)
(AMETHYSTS, MARKET << US, 10004, 1, 205000)
(AMETHYSTS, MARKET << US, 10004, 1, 205000)
(AMETHYSTS, MARKET << US, 10004, 1, 205000)
(STARFRUIT, US << MARKET, 5044, 1, 205000)","{""AMETHYSTS"": -7, ""STARFRUIT"": 9}",1652,5047,10000
205400,-5050,21179,"(STARFRUIT, US << MARKET, 5050, 1, 205400)","{""AMETHYSTS"": -7, ""STARFRUIT"": 10}",1672,5050,10001
205800,20004,41183,"(AMETHYSTS, MARKET << US, 10002, 1, 205800)
(AMETHYSTS, MARKET << US, 10002, 1, 205800)","{""AMETHYSTS"": -9, ""STARFRUIT"": 10}",1681,5048,9998
206400,9904,51087,"(AMETHYSTS, MARKET << US, 9996, 1, 206400)
(AMETHYSTS, MARKET << US, 9996, 1, 206400)
(STARFRUIT, US << MARKET, 5044, 1, 206400)
(STARFRUIT, US << MARKET, 5044, 1, 206400)","{""AMETHYSTS"": -11, ""STARFRUIT"": 12}",1662,5047,9999
206700,-20180,30907,"(STARFRUIT, US << MARKET, 5045, 1, 206700)
(STARFRUIT, US << MARKET, 5045, 1, 206700)
(STARFRUIT, US << MARKET, 5045, 1, 206700)
(STARFRUIT, US << MARKET, 5045, 1, 206700)","{""AMETHYSTS"": -11, ""STARFRUIT"": 16}",1611,5044,10000
207000,4955,35862,"(AMETHYSTS, MARKET << US, 9998, 1, 207000)
(STARFRUIT, US << MARKET, 5043, 1, 207000)","{""AMETHYSTS"": -12, ""STARFRUIT"": 17}",1624,5042,9996
207300,-15054,20808,"(AMETHYSTS, US << MARKET, 10004, 1, 207300)
(STARFRUIT, US << MARKET, 5050, 1, 207300)","{""AMETHYSTS"": -11, ""STARFRUIT"": 18}",1654,5047,10000
207500,-139944,-119136,"(AMETHYSTS, US << MARKET, 9996, 1, 207500)
(AMETHYSTS, US << MARKET, 9996, 1, 207500)
(AMETHYSTS, US << MARKET, 9996, 1, 207500)
(AMETHYSTS, US << MARKET, 9996, 1, 207500)
(AMETHYSTS, US << MARKET, 9996, 1, 207500)
(AMETHYSTS, US << MARKET, 9996, 1, 207500)
(AMETHYSTS, US << MARKET, 9996, 1, 207500)
(AMETHYSTS, US << MARKET, 9996, 1, 207500)
(AMETHYSTS, US << MARKET, 9996, 1, 207500)
(AMETHYSTS, US << MARKET, 9996, 1, 207500)
(AMETHYSTS, US << MARKET, 9996, 1, 207500)
(AMETHYSTS, US << MARKET, 9996, 1, 207500)
(AMETHYSTS, US << MARKET, 9996, 1, 207500)
(AMETHYSTS, US << MARKET, 9996, 1, 207500)","{""AMETHYSTS"": 3, ""STARFRUIT"": 18}",1710,5047,10000
207600,-10096,-129232,"(STARFRUIT, US << MARKET, 5048, 1, 207600)
(STARFRUIT, US << MARKET, 5048, 1, 207600)","{""AMETHYSTS"": 3, ""STARFRUIT"": 20}",1748,5049,10000
207800,50510,-78722,"(STARFRUIT, MARKET << US, 5051, 1, 207800)
(STARFRUIT, MARKET << US, 5051, 1, 207800)
(STARFRUIT, MARKET << US, 5051, 1, 207800)
(STARFRUIT, MARKET << US, 5051, 1, 207800)
(STARFRUIT, MARKET << US, 5051, 1, 207800)
(STARFRUIT, MARKET << US, 5051, 1, 207800)
(STARFRUIT, MARKET << US, 5051, 1, 207800)
(STARFRUIT, MARKET << US, 5051, 1, 207800)
(STARFRUIT, MARKET << US, 5051, 1, 207800)
(STARFRUIT, MARKET << US, 5051, 1, 207800)","{""AMETHYSTS"": 3, ""STARFRUIT"": 10}",1781,5050,10001
208000,14956,-63766,"(AMETHYSTS, MARKET << US, 10004, 1, 208000)
(AMETHYSTS, MARKET << US, 10004, 1, 208000)
(STARFRUIT, US << MARKET, 5052, 1, 208000)","{""AMETHYSTS"": 1, ""STARFRUIT"": 11}",1776,5049,10003
208100,188,-63578,"(AMETHYSTS, US << MARKET, 9998, 1, 208100)
(AMETHYSTS, US << MARKET, 9998, 1, 208100)
(STARFRUIT, MARKET << US, 5046, 1, 208100)
(STARFRUIT, MARKET << US, 5046, 1, 208100)
(STARFRUIT, MARKET << US, 5046, 1, 208100)
(STARFRUIT, MARKET << US, 5046, 1, 208100)","{""AMETHYSTS"": 3, ""STARFRUIT"": 7}",1756,5049,9997
208300,5044,-58534,"(STARFRUIT, MARKET << US, 5044, 1, 208300)","{""AMETHYSTS"": 3, ""STARFRUIT"": 6}",1757,5047,10003
208700,5045,-53489,"(STARFRUIT, MARKET << US, 5045, 1, 208700)","{""AMETHYSTS"": 3, ""STARFRUIT"": 5}",1754,5048,10001
208900,-15138,-68627,"(STARFRUIT, US << MARKET, 5046, 1, 208900)
(STARFRUIT, US << MARKET, 5046, 1, 208900)
(STARFRUIT, US << MARKET, 5046, 1, 208900)","{""AMETHYSTS"": 3, ""STARFRUIT"": 8}",1727,5045,9998
209000,-5050,-73677,"(STARFRUIT, US << MARKET, 5050, 1, 209000)","{""AMETHYSTS"": 3, ""STARFRUIT"": 9}",1776,5050,10001
209700,-144990,-218667,"(AMETHYSTS, US << MARKET, 9996, 1, 209700)
(AMETHYSTS, US << MARKET, 9996, 1, 209700)
(AMETHYSTS, US << MARKET, 9996, 1, 209700)
(AMETHYSTS, US << MARKET, 9996, 1, 209700)
(AMETHYSTS, US << MARKET, 9996, 1, 209700)
(AMETHYSTS, US << MARKET, 9996, 1, 209700)
(AMETHYSTS, US << MARKET, 9996, 1, 209700)
(AMETHYSTS, US << MARKET, 9996, 1, 209700)
(AMETHYSTS, US << MARKET, 9996, 1, 209700)
(AMETHYSTS, US << MARKET, 9996, 1, 209700)
(AMETHYSTS, US << MARKET, 9996, 1, 209700)
(AMETHYSTS, US << MARKET, 9996, 1, 209700)
(AMETHYSTS, US << MARKET, 9996, 1, 209700)
(AMETHYSTS, US << MARKET, 9996, 1, 209700)
(STARFRUIT, US << MARKET, 5046, 1, 209700)","{""AMETHYSTS"": 17, ""STARFRUIT"": 10}",1783,5045,10000
209900,9998,-208669,"(AMETHYSTS, MARKET << US, 9998, 1, 209900)","{""AMETHYSTS"": 16, ""STARFRUIT"": 10}",1737,5047,9996
210000,15138,-193531,"(STARFRUIT, MARKET << US, 5046, 1, 210000)
(STARFRUIT, MARKET << US, 5046, 1, 210000)
(STARFRUIT, MARKET << US, 5046, 1, 210000)","{""AMETHYSTS"": 16, ""STARFRUIT"": 7}",1768,5045,9999
210100,-5045,-198576,"(STARFRUIT, US << MARKET, 5045, 1, 210100)","{""AMETHYSTS"": 16, ""STARFRUIT"": 8}",1800,5047,10000
210300,20010,-178566,"(AMETHYSTS, MARKET << US, 10002, 1, 210300)
(AMETHYSTS, MARKET << US, 10002, 1, 210300)
(STARFRUIT, US << MARKET, 5045, 1, 210300)
(STARFRUIT, MARKET << US, 5051, 1, 210300)","{""AMETHYSTS"": 14, ""STARFRUIT"": 8}",1804,5048,9999
210400,5045,-173521,"(STARFRUIT, MARKET << US, 5045, 1, 210400)","{""AMETHYSTS"": 14, ""STARFRUIT"": 7}",1808,5047,10000
210600,-14945,-188466,"(AMETHYSTS, US << MARKET, 9995, 1, 210600)
(AMETHYSTS, US << MARKET, 9995, 1, 210600)
(STARFRUIT, MARKET << US, 5045, 1, 210600)","{""AMETHYSTS"": 16, ""STARFRUIT"": 6}",1822,5048,10000
210700,-9902,-198368,"(AMETHYSTS, US << MARKET, 9996, 1, 210700)
(AMETHYSTS, US << MARKET, 9996, 1, 210700)
(STARFRUIT, MARKET << US, 5045, 1, 210700)
(STARFRUIT, MARKET << US, 5045, 1, 210700)","{""AMETHYSTS"": 18, ""STARFRUIT"": 4}",1806,5048,9999
211100,104,-198264,"(AMETHYSTS, US << MARKET, 10002, 1, 211100)
(STARFRUIT, MARKET << US, 5053, 1, 211100)
(STARFRUIT, MARKET << US, 5053, 1, 211100)","{""AMETHYSTS"": 19, ""STARFRUIT"": 2}",1796,5049,9998
211300,20320,-177944,"(AMETHYSTS, US << MARKET, 9998, 1, 211300)
(STARFRUIT, MARKET << US, 5053, 1, 211300)
(STARFRUIT, MARKET << US, 5053, 1, 211300)
(STARFRUIT, MARKET << US, 5053, 1, 211300)
(STARFRUIT, MARKET << US, 5053, 1, 211300)
(STARFRUIT, MARKET << US, 5053, 1, 211300)
(STARFRUIT, MARKET << US, 5053, 1, 211300)","{""AMETHYSTS"": 20, ""STARFRUIT"": -4}",1780,5049,9996
211400,9996,-167948,"(AMETHYSTS, MARKET << US, 9996, 1, 211400)","{""AMETHYSTS"": 19, ""STARFRUIT"": -4}",1852,5050,10000
211500,-10094,-178042,"(STARFRUIT, US << MARKET, 5047, 1, 211500)
(STARFRUIT, US << MARKET, 5047, 1, 211500)
(STARFRUIT, US << MARKET, 5047, 1, 211500)
(STARFRUIT, US << MARKET, 5047, 1, 211500)
(STARFRUIT, MARKET << US, 5047, 1, 211500)
(STARFRUIT, MARKET << US, 5047, 1, 211500)","{""AMETHYSTS"": 19, ""STARFRUIT"": -2}",1858,5050,10000
211800,-10092,-188134,"(STARFRUIT, US << MARKET, 5046, 1, 211800)
(STARFRUIT, US << MARKET, 5046, 1, 211800)","{""AMETHYSTS"": 19, ""STARFRUIT"": 0}",1866,5045,10000
212000,-30270,-218404,"(STARFRUIT, US << MARKET, 5045, 1, 212000)
(STARFRUIT, US << MARKET, 5045, 1, 212000)
(STARFRUIT, US << MARKET, 5045, 1, 212000)
(STARFRUIT, US << MARKET, 5045, 1, 212000)
(STARFRUIT, US << MARKET, 5045, 1, 212000)
(STARFRUIT, US << MARKET, 5045, 1, 212000)","{""AMETHYSTS"": 19, ""STARFRUIT"": 6}",1903,5048,10001
212300,-25149,-243553,"(AMETHYSTS, US << MARKET, 9998, 1, 212300)
(STARFRUIT, US << MARKET, 5051, 1, 212300)
(STARFRUIT, US << MARKET, 5051, 1, 212300)
(STARFRUIT, US << MARKET, 5051, 1, 212300)
(STARFRUIT, US << MARKET, 5051, 1, 212300)
(STARFRUIT, MARKET << US, 5053, 1, 212300)","{""AMETHYSTS"": 20, ""STARFRUIT"": 9}",1855,5052,9997
212500,30306,-213247,"(STARFRUIT, MARKET << US, 5051, 1, 212500)
(STARFRUIT, MARKET << US, 5051, 1, 212500)
(STARFRUIT, MARKET << US, 5051, 1, 212500)
(STARFRUIT, MARKET << US, 5051, 1, 212500)
(STARFRUIT, MARKET << US, 5051, 1, 212500)
(STARFRUIT, MARKET << US, 5051, 1, 212500)","{""AMETHYSTS"": 20, ""STARFRUIT"": 3}",1900,5049,10000
212800,-10092,-223339,"(STARFRUIT, US << MARKET, 5046, 1, 212800)
(STARFRUIT, US << MARKET, 5046, 1, 212800)","{""AMETHYSTS"": 20, ""STARFRUIT"": 5}",1906,5049,10000
213000,0,-223339,,"{""AMETHYSTS"": 20, ""STARFRUIT"": 5}",1826,5049,9996
213900,19902,-203437,"(AMETHYSTS, MARKET << US, 9998, 1, 213900)
(AMETHYSTS, MARKET << US, 9998, 1, 213900)
(AMETHYSTS, MARKET << US, 9998, 1, 213900)
(STARFRUIT, US << MARKET, 5046, 1, 213900)
(STARFRUIT, US << MARKET, 5046, 1, 213900)","{""AMETHYSTS"": 17, ""STARFRUIT"": 7}",1855,5049,9997
214100,-9998,-213435,"(AMETHYSTS, US << MARKET, 9998, 1, 214100)
(AMETHYSTS, US << MARKET, 9998, 1, 214100)
(AMETHYSTS, MARKET << US, 9998, 1, 214100)","{""AMETHYSTS"": 18, ""STARFRUIT"": 7}",1829,5048,9996
214500,-9998,-223433,"(AMETHYSTS, US << MARKET, 9998, 1, 214500)
(AMETHYSTS, US << MARKET, 9998, 1, 214500)
(AMETHYSTS, MARKET << US, 9998, 1, 214500)","{""AMETHYSTS"": 19, ""STARFRUIT"": 7}",1922,5048,10001
214700,-9996,-233429,"(AMETHYSTS, US << MARKET, 9996, 1, 214700)","{""AMETHYSTS"": 20, ""STARFRUIT"": 7}",1907,5048,10000
214800,-20184,-253613,"(STARFRUIT, US << MARKET, 5046, 1, 214800)
(STARFRUIT, US << MARKET, 5046, 1, 214800)
(STARFRUIT, US << MARKET, 5046, 1, 214800)
(STARFRUIT, US << MARKET, 5046, 1, 214800)","{""AMETHYSTS"": 20, ""STARFRUIT"": 11}",1902,5045,10001
215100,9998,-243615,"(AMETHYSTS, MARKET << US, 9998, 1, 215100)","{""AMETHYSTS"": 19, ""STARFRUIT"": 11}",1867,5049,9997
215800,-5046,-248661,"(STARFRUIT, US << MARKET, 5046, 1, 215800)","{""AMETHYSTS"": 19, ""STARFRUIT"": 12}",1927,5049,10000
215900,35322,-213339,"(STARFRUIT, MARKET << US, 5046, 1, 215900)
(STARFRUIT, MARKET << US, 5046, 1, 215900)
(STARFRUIT, MARKET << US, 5046, 1, 215900)
(STARFRUIT, MARKET << US, 5046, 1, 215900)
(STARFRUIT, MARKET << US, 5046, 1, 215900)
(STARFRUIT, MARKET << US, 5046, 1, 215900)
(STARFRUIT, MARKET << US, 5046, 1, 215900)","{""AMETHYSTS"": 19, ""STARFRUIT"": 5}",1963,5049,10003
216000,-5041,-218380,"(STARFRUIT, US << MARKET, 5046, 1, 216000)
(STARFRUIT, US << MARKET, 5046, 1, 216000)
(STARFRUIT, MARKET << US, 5051, 1, 216000)","{""AMETHYSTS"": 19, ""STARFRUIT"": 6}",1932,5052,10000
216100,20004,-198376,"(AMETHYSTS, MARKET << US, 10002, 1, 216100)
(AMETHYSTS, MARKET << US, 10002, 1, 216100)","{""AMETHYSTS"": 17, ""STARFRUIT"": 6}",1919,5052,9999
216400,15144,-183232,"(STARFRUIT, MARKET << US, 5048, 1, 216400)
(STARFRUIT, MARKET << US, 5048, 1, 216400)
(STARFRUIT, MARKET << US, 5048, 1, 216400)","{""AMETHYSTS"": 17, ""STARFRUIT"": 3}",1875,5047,9998
216500,-10094,-193326,"(STARFRUIT, US << MARKET, 5047, 1, 216500)
(STARFRUIT, US << MARKET, 5047, 1, 216500)","{""AMETHYSTS"": 17, ""STARFRUIT"": 5}",1880,5048,9998
216600,-40200,-233526,"(AMETHYSTS, US << MARKET, 9998, 1, 216600)
(AMETHYSTS, US << MARKET, 9998, 1, 216600)
(STARFRUIT, US << MARKET, 5051, 1, 216600)
(STARFRUIT, US << MARKET, 5051, 1, 216600)
(STARFRUIT, US << MARKET, 5051, 1, 216600)
(STARFRUIT, US << MARKET, 5051, 1, 216600)","{""AMETHYSTS"": 19, ""STARFRUIT"": 9}",1830,5048,9996
217100,9996,-223530,"(AMETHYSTS, MARKET << US, 9996, 1, 217100)","{""AMETHYSTS"": 18, ""STARFRUIT"": 9}",1911,5049,10000
217400,-20184,-243714,"(STARFRUIT, US << MARKET, 5046, 1, 217400)
(STARFRUIT, US << MARKET, 5046, 1, 217400)
(STARFRUIT, US << MARKET, 5046, 1, 217400)
(STARFRUIT, US << MARKET, 5046, 1, 217400)","{""AMETHYSTS"": 18, ""STARFRUIT"": 13}",1977,5049,10003
217500,-25037,-268751,"(AMETHYSTS, US << MARKET, 9996, 1, 217500)
(AMETHYSTS, US << MARKET, 9996, 1, 217500)
(STARFRUIT, US << MARKET, 5045, 1, 217500)","{""AMETHYSTS"": 20, ""STARFRUIT"": 14}",1921,5048,10000
217700,-5051,-273802,"(STARFRUIT, US << MARKET, 5051, 1, 217700)","{""AMETHYSTS"": 20, ""STARFRUIT"": 15}",1943,5051,9999
217800,0,-273802,,"{""AMETHYSTS"": 20, ""STARFRUIT"": 15}",1933,5049,10000
218200,5045,-268757,"(STARFRUIT, MARKET << US, 5045, 1, 218200)","{""AMETHYSTS"": 20, ""STARFRUIT"": 14}",1915,5048,10000
218700,5050,-263707,"(STARFRUIT, MARKET << US, 5050, 1, 218700)","{""AMETHYSTS"": 20, ""STARFRUIT"": 13}",1924,5047,10001
219400,20007,-243700,"(AMETHYSTS, MARKET << US, 10004, 1, 219400)
(AMETHYSTS, MARKET << US, 10004, 1, 219400)
(STARFRUIT, US << MARKET, 5049, 1, 219400)
(STARFRUIT, MARKET << US, 5048, 1, 219400)","{""AMETHYSTS"": 18, ""STARFRUIT"": 13}",1903,5045,10001
219600,10098,-233602,"(STARFRUIT, MARKET << US, 5049, 1, 219600)
(STARFRUIT, MARKET << US, 5049, 1, 219600)","{""AMETHYSTS"": 18, ""STARFRUIT"": 11}",1911,5045,10001
220500,-15135,-248737,"(STARFRUIT, US << MARKET, 5045, 1, 220500)
(STARFRUIT, US << MARKET, 5045, 1, 220500)
(STARFRUIT, US << MARKET, 5045, 1, 220500)","{""AMETHYSTS"": 18, ""STARFRUIT"": 14}",1939,5047,10001
221000,-20200,-268937,"(STARFRUIT, US << MARKET, 5050, 1, 221000)
(STARFRUIT, US << MARKET, 5050, 1, 221000)
(STARFRUIT, US << MARKET, 5050, 1, 221000)
(STARFRUIT, US << MARKET, 5050, 1, 221000)","{""AMETHYSTS"": 18, ""STARFRUIT"": 18}",1909,5047,10000
221100,-4953,-273890,"(AMETHYSTS, US << MARKET, 10002, 1, 221100)
(STARFRUIT, MARKET << US, 5049, 1, 221100)","{""AMETHYSTS"": 19, ""STARFRUIT"": 17}",1856,5045,9999
221200,14962,-258928,"(AMETHYSTS, MARKET << US, 10002, 1, 221200)
(AMETHYSTS, MARKET << US, 10002, 1, 221200)
(STARFRUIT, US << MARKET, 5042, 1, 221200)","{""AMETHYSTS"": 17, ""STARFRUIT"": 18}",1951,5046,10003
221800,-10092,-269020,"(STARFRUIT, US << MARKET, 5046, 1, 221800)
(STARFRUIT, US << MARKET, 5046, 1, 221800)","{""AMETHYSTS"": 17, ""STARFRUIT"": 20}",1897,5045,10001
222200,-29994,-299014,"(AMETHYSTS, US << MARKET, 9998, 1, 222200)
(AMETHYSTS, US << MARKET, 9998, 1, 222200)
(AMETHYSTS, US << MARKET, 9998, 1, 222200)","{""AMETHYSTS"": 20, ""STARFRUIT"": 20}",1846,5047,9996
222800,5047,-293967,"(STARFRUIT, MARKET << US, 5047, 1, 222800)","{""AMETHYSTS"": 20, ""STARFRUIT"": 19}",1869,5044,10000
223000,25205,-268762,"(STARFRUIT, MARKET << US, 5041, 1, 223000)
(STARFRUIT, MARKET << US, 5041, 1, 223000)
(STARFRUIT, MARKET << US, 5041, 1, 223000)
(STARFRUIT, MARKET << US, 5041, 1, 223000)
(STARFRUIT, MARKET << US, 5041, 1, 223000)","{""AMETHYSTS"": 20, ""STARFRUIT"": 14}",1792,5041,9999
223100,0,-268762,,"{""AMETHYSTS"": 20, ""STARFRUIT"": 14}",1888,5045,10001
223600,0,-268762,,"{""AMETHYSTS"": 20, ""STARFRUIT"": 14}",1834,5044,9999
223700,-5048,-273810,"(STARFRUIT, US << MARKET, 5048, 1, 223700)","{""AMETHYSTS"": 20, ""STARFRUIT"": 15}",1910,5044,10003
223800,5042,-268768,"(STARFRUIT, MARKET << US, 5042, 1, 223800)","{""AMETHYSTS"": 20, ""STARFRUIT"": 14}",1922,5045,10003
224400,40344,-228424,"(STARFRUIT, MARKET << US, 5043, 1, 224400)
(STARFRUIT, MARKET << US, 5043, 1, 224400)
(STARFRUIT, MARKET << US, 5043, 1, 224400)
(STARFRUIT, MARKET << US, 5043, 1, 224400)
(STARFRUIT, MARKET << US, 5043, 1, 224400)
(STARFRUIT, MARKET << US, 5043, 1, 224400)
(STARFRUIT, MARKET << US, 5043, 1, 224400)
(STARFRUIT, MARKET << US, 5043, 1, 224400)","{""AMETHYSTS"": 20, ""STARFRUIT"": 6}",1846,5045,10000
224500,40196,-188228,"(AMETHYSTS, MARKET << US, 10002, 1, 224500)
(AMETHYSTS, MARKET << US, 10002, 1, 224500)
(STARFRUIT, MARKET << US, 5048, 1, 224500)
(STARFRUIT, MARKET << US, 5048, 1, 224500)
(STARFRUIT, MARKET << US, 5048, 1, 224500)
(STARFRUIT, MARKET << US, 5048, 1, 224500)","{""AMETHYSTS"": 18, ""STARFRUIT"": 2}",1924,5049,10003
224600,20105,-168123,"(AMETHYSTS, US << MARKET, 10005, 1, 224600)
(AMETHYSTS, MARKET << US, 10004, 1, 224600)
(AMETHYSTS, MARKET << US, 10004, 1, 224600)
(STARFRUIT, MARKET << US, 5051, 1, 224600)
(STARFRUIT, MARKET << US, 5051, 1, 224600)","{""AMETHYSTS"": 17, ""STARFRUIT"": 0}",1894,5047,10001
225000,-19992,-188115,"(AMETHYSTS, US << MARKET, 9996, 1, 225000)
(AMETHYSTS, US << MARKET, 9996, 1, 225000)","{""AMETHYSTS"": 19, ""STARFRUIT"": 0}",1828,5047,9997
225500,5044,-183071,"(STARFRUIT, MARKET << US, 5044, 1, 225500)","{""AMETHYSTS"": 19, ""STARFRUIT"": -1}",1847,5044,9998
225700,9916,-173155,"(AMETHYSTS, MARKET << US, 10002, 1, 225700)
(AMETHYSTS, MARKET << US, 10002, 1, 225700)
(STARFRUIT, US << MARKET, 5044, 1, 225700)
(STARFRUIT, US << MARKET, 5044, 1, 225700)","{""AMETHYSTS"": 17, ""STARFRUIT"": 1}",1943,5047,10003
226100,-19996,-193151,"(AMETHYSTS, US << MARKET, 9998, 1, 226100)
(AMETHYSTS, US << MARKET, 9998, 1, 226100)
(AMETHYSTS, US << MARKET, 9998, 1, 226100)
(AMETHYSTS, MARKET << US, 9998, 1, 226100)","{""AMETHYSTS"": 19, ""STARFRUIT"": 1}",1840,5048,9997
226700,-30182,-223333,"(AMETHYSTS, US << MARKET, 9998, 1, 226700)
(STARFRUIT, US << MARKET, 5046, 1, 226700)
(STARFRUIT, US << MARKET, 5046, 1, 226700)
(STARFRUIT, US << MARKET, 5046, 1, 226700)
(STARFRUIT, US << MARKET, 5046, 1, 226700)","{""AMETHYSTS"": 20, ""STARFRUIT"": 5}",1927,5048,10001
226800,-20188,-243521,"(STARFRUIT, US << MARKET, 5047, 1, 226800)
(STARFRUIT, US << MARKET, 5047, 1, 226800)
(STARFRUIT, US << MARKET, 5047, 1, 226800)
(STARFRUIT, US << MARKET, 5047, 1, 226800)","{""AMETHYSTS"": 20, ""STARFRUIT"": 9}",1893,5046,10000
227100,-5046,-248567,"(STARFRUIT, US << MARKET, 5046, 1, 227100)","{""AMETHYSTS"": 20, ""STARFRUIT"": 10}",1913,5048,10000
227300,9998,-238569,"(AMETHYSTS, MARKET << US, 9998, 1, 227300)","{""AMETHYSTS"": 19, ""STARFRUIT"": 10}",1835,5048,9996
227700,4949,-233620,"(AMETHYSTS, MARKET << US, 9996, 1, 227700)
(STARFRUIT, US << MARKET, 5047, 1, 227700)","{""AMETHYSTS"": 18, ""STARFRUIT"": 11}",1930,5050,10000
228300,25240,-208380,"(STARFRUIT, US << MARKET, 5048, 1, 228300)
(STARFRUIT, MARKET << US, 5048, 1, 228300)
(STARFRUIT, MARKET << US, 5048, 1, 228300)
(STARFRUIT, MARKET << US, 5048, 1, 228300)
(STARFRUIT, MARKET << US, 5048, 1, 228300)
(STARFRUIT, MARKET << US, 5048, 1, 228300)
(STARFRUIT, MARKET << US, 5048, 1, 228300)","{""AMETHYSTS"": 18, ""STARFRUIT"": 6}",1926,5051,10000
228400,-10096,-218476,"(STARFRUIT, US << MARKET, 5048, 1, 228400)
(STARFRUIT, US << MARKET, 5048, 1, 228400)","{""AMETHYSTS"": 18, ""STARFRUIT"": 8}",1932,5051,10000
229400,-19996,-238472,"(AMETHYSTS, US << MARKET, 9998, 1, 229400)
(AMETHYSTS, US << MARKET, 9998, 1, 229400)","{""AMETHYSTS"": 20, ""STARFRUIT"": 8}",1860,5049,9997
229600,20004,-218468,"(AMETHYSTS, MARKET << US, 10002, 1, 229600)
(AMETHYSTS, MARKET << US, 10002, 1, 229600)","{""AMETHYSTS"": 18, ""STARFRUIT"": 8}",1950,5050,10001
229700,5051,-213417,"(STARFRUIT, MARKET << US, 5051, 1, 229700)","{""AMETHYSTS"": 18, ""STARFRUIT"": 7}",1940,5051,10000
229900,-10092,-223509,"(STARFRUIT, US << MARKET, 5046, 1, 229900)
(STARFRUIT, US << MARKET, 5046, 1, 229900)","{""AMETHYSTS"": 18, ""STARFRUIT"": 9}",1878,5049,9997
230100,0,-223509,"(STARFRUIT, US << MARKET, 5047, 1, 230100)
(STARFRUIT, MARKET << US, 5047, 1, 230100)","{""AMETHYSTS"": 18, ""STARFRUIT"": 9}",1851,5046,9997
230300,-19992,-243501,"(AMETHYSTS, US << MARKET, 9996, 1, 230300)
(AMETHYSTS, US << MARKET, 9996, 1, 230300)","{""AMETHYSTS"": 20, ""STARFRUIT"": 9}",1940,5049,10000
230400,-5052,-248553,"(STARFRUIT, US << MARKET, 5052, 1, 230400)","{""AMETHYSTS"": 20, ""STARFRUIT"": 10}",1907,5048,9999
230500,5046,-243507,"(STARFRUIT, MARKET << US, 5046, 1, 230500)","{""AMETHYSTS"": 20, ""STARFRUIT"": 9}",1934,5049,10000
230900,5051,-238456,"(STARFRUIT, MARKET << US, 5051, 1, 230900)","{""AMETHYSTS"": 20, ""STARFRUIT"": 8}",1948,5048,10001
231100,25240,-213216,"(STARFRUIT, MARKET << US, 5048, 1, 231100)
(STARFRUIT, MARKET << US, 5048, 1, 231100)
(STARFRUIT, MARKET << US, 5048, 1, 231100)
(STARFRUIT, MARKET << US, 5048, 1, 231100)
(STARFRUIT, MARKET << US, 5048, 1, 231100)","{""AMETHYSTS"": 20, ""STARFRUIT"": 3}",1882,5046,9998
231300,9998,-203218,"(AMETHYSTS, MARKET << US, 9998, 1, 231300)","{""AMETHYSTS"": 19, ""STARFRUIT"": 3}",1945,5048,10001
231400,-15147,-218365,"(STARFRUIT, US << MARKET, 5049, 1, 231400)
(STARFRUIT, US << MARKET, 5049, 1, 231400)
(STARFRUIT, US << MARKET, 5049, 1, 231400)","{""AMETHYSTS"": 19, ""STARFRUIT"": 6}",1935,5050,10000
231700,65242,-153123,"(AMETHYSTS, MARKET << US, 10000, 1, 231700)
(AMETHYSTS, MARKET << US, 10000, 1, 231700)
(AMETHYSTS, MARKET << US, 10000, 1, 231700)
(AMETHYSTS, MARKET << US, 10000, 1, 231700)
(STARFRUIT, MARKET << US, 5049, 1, 231700)
(STARFRUIT, MARKET << US, 5049, 1, 231700)
(STARFRUIT, MARKET << US, 5049, 1, 231700)
(STARFRUIT, MARKET << US, 5049, 1, 231700)
(STARFRUIT, MARKET << US, 5046, 1, 231700)","{""AMETHYSTS"": 15, ""STARFRUIT"": 1}",1894,5047,9998
232000,-25255,-178378,"(STARFRUIT, US << MARKET, 5051, 1, 232000)
(STARFRUIT, US << MARKET, 5051, 1, 232000)
(STARFRUIT, US << MARKET, 5051, 1, 232000)
(STARFRUIT, US << MARKET, 5051, 1, 232000)
(STARFRUIT, US << MARKET, 5051, 1, 232000)","{""AMETHYSTS"": 15, ""STARFRUIT"": 6}",1949,5052,10001
232100,20004,-158374,"(AMETHYSTS, MARKET << US, 10002, 1, 232100)
(AMETHYSTS, MARKET << US, 10002, 1, 232100)","{""AMETHYSTS"": 13, ""STARFRUIT"": 6}",1965,5050,10003
232300,25057,-133317,"(AMETHYSTS, MARKET << US, 10002, 1, 232300)
(AMETHYSTS, MARKET << US, 10002, 1, 232300)
(STARFRUIT, MARKET << US, 5053, 1, 232300)","{""AMETHYSTS"": 11, ""STARFRUIT"": 5}",1911,5050,9998
232600,-40100,-173417,"(AMETHYSTS, US << MARKET, 9998, 1, 232600)
(AMETHYSTS, US << MARKET, 9998, 1, 232600)
(AMETHYSTS, US << MARKET, 9998, 1, 232600)
(AMETHYSTS, US << MARKET, 9998, 1, 232600)
(AMETHYSTS, MARKET << US, 9998, 1, 232600)
(STARFRUIT, US << MARKET, 5053, 1, 232600)
(STARFRUIT, US << MARKET, 5053, 1, 232600)","{""AMETHYSTS"": 14, ""STARFRUIT"": 7}",1884,5049,9997
234200,-5044,-178461,"(STARFRUIT, US << MARKET, 5044, 1, 234200)","{""AMETHYSTS"": 14, ""STARFRUIT"": 8}",1915,5047,10000
234300,4950,-173511,"(AMETHYSTS, MARKET << US, 9995, 1, 234300)
(STARFRUIT, US << MARKET, 5045, 1, 234300)","{""AMETHYSTS"": 13, ""STARFRUIT"": 9}",1921,5048,10000
234500,9998,-163513,"(AMETHYSTS, MARKET << US, 9998, 1, 234500)","{""AMETHYSTS"": 12, ""STARFRUIT"": 9}",1892,5049,9997
234700,-9914,-173427,"(AMETHYSTS, US << MARKET, 10004, 1, 234700)
(AMETHYSTS, US << MARKET, 10004, 1, 234700)
(STARFRUIT, US << MARKET, 5051, 1, 234700)
(STARFRUIT, US << MARKET, 5051, 1, 234700)
(STARFRUIT, MARKET << US, 5049, 1, 234700)
(STARFRUIT, MARKET << US, 5049, 1, 234700)
(STARFRUIT, MARKET << US, 5049, 1, 234700)
(STARFRUIT, MARKET << US, 5049, 1, 234700)","{""AMETHYSTS"": 14, ""STARFRUIT"": 7}",1923,5050,10000
234800,-19996,-193423,"(AMETHYSTS, US << MARKET, 9998, 1, 234800)
(AMETHYSTS, US << MARKET, 9998, 1, 234800)","{""AMETHYSTS"": 16, ""STARFRUIT"": 7}",1922,5047,10001
235200,79960,-113463,"(AMETHYSTS, MARKET << US, 9995, 1, 235200)
(AMETHYSTS, MARKET << US, 9995, 1, 235200)
(AMETHYSTS, MARKET << US, 9995, 1, 235200)
(AMETHYSTS, MARKET << US, 9995, 1, 235200)
(AMETHYSTS, MARKET << US, 9995, 1, 235200)
(AMETHYSTS, MARKET << US, 9995, 1, 235200)
(AMETHYSTS, MARKET << US, 9995, 1, 235200)
(AMETHYSTS, MARKET << US, 9995, 1, 235200)","{""AMETHYSTS"": 8, ""STARFRUIT"": 7}",1873,5048,10000
235500,-5045,-118508,"(STARFRUIT, US << MARKET, 5045, 1, 235500)","{""AMETHYSTS"": 8, ""STARFRUIT"": 8}",1868,5048,9999
235900,15138,-103370,"(STARFRUIT, MARKET << US, 5046, 1, 235900)
(STARFRUIT, MARKET << US, 5046, 1, 235900)
(STARFRUIT, MARKET << US, 5046, 1, 235900)","{""AMETHYSTS"": 8, ""STARFRUIT"": 5}",1855,5045,10000
236200,-19996,-123366,"(AMETHYSTS, US << MARKET, 9998, 1, 236200)
(AMETHYSTS, US << MARKET, 9998, 1, 236200)","{""AMETHYSTS"": 10, ""STARFRUIT"": 5}",1844,5048,9997
236400,-19996,-143362,"(AMETHYSTS, US << MARKET, 9998, 1, 236400)
(AMETHYSTS, US << MARKET, 9998, 1, 236400)","{""AMETHYSTS"": 12, ""STARFRUIT"": 5}",1837,5047,9997
236800,9998,-133364,"(AMETHYSTS, MARKET << US, 9998, 1, 236800)","{""AMETHYSTS"": 11, ""STARFRUIT"": 5}",1843,5048,9997
237000,45046,-88318,"(AMETHYSTS, MARKET << US, 9998, 1, 237000)
(AMETHYSTS, MARKET << US, 9998, 1, 237000)
(AMETHYSTS, MARKET << US, 9998, 1, 237000)
(AMETHYSTS, MARKET << US, 9998, 1, 237000)
(STARFRUIT, MARKET << US, 5054, 1, 237000)","{""AMETHYSTS"": 7, ""STARFRUIT"": 4}",1861,5050,9997
237300,-30084,-118402,"(AMETHYSTS, US << MARKET, 9996, 1, 237300)
(AMETHYSTS, US << MARKET, 9996, 1, 237300)
(STARFRUIT, US << MARKET, 5046, 1, 237300)
(STARFRUIT, US << MARKET, 5046, 1, 237300)","{""AMETHYSTS"": 9, ""STARFRUIT"": 6}",1874,5046,10000
237400,-14950,-133352,"(AMETHYSTS, US << MARKET, 9998, 1, 237400)
(AMETHYSTS, US << MARKET, 9998, 1, 237400)
(STARFRUIT, MARKET << US, 5046, 1, 237400)","{""AMETHYSTS"": 11, ""STARFRUIT"": 5}",1844,5048,9996
237700,9998,-123354,"(AMETHYSTS, MARKET << US, 9998, 1, 237700)","{""AMETHYSTS"": 10, ""STARFRUIT"": 5}",1906,5050,10001
238000,-10092,-133446,"(STARFRUIT, US << MARKET, 5046, 1, 238000)
(STARFRUIT, US << MARKET, 5046, 1, 238000)","{""AMETHYSTS"": 10, ""STARFRUIT"": 7}",1897,5049,10000
238300,-89982,-223428,"(AMETHYSTS, US << MARKET, 9998, 1, 238300)
(AMETHYSTS, US << MARKET, 9998, 1, 238300)
(AMETHYSTS, US << MARKET, 9998, 1, 238300)
(AMETHYSTS, US << MARKET, 9998, 1, 238300)
(AMETHYSTS, US << MARKET, 9998, 1, 238300)
(AMETHYSTS, US << MARKET, 9998, 1, 238300)
(AMETHYSTS, US << MARKET, 9998, 1, 238300)
(AMETHYSTS, US << MARKET, 9998, 1, 238300)
(AMETHYSTS, US << MARKET, 9998, 1, 238300)","{""AMETHYSTS"": 19, ""STARFRUIT"": 7}",1927,5048,10001
238600,25225,-198203,"(STARFRUIT, MARKET << US, 5045, 1, 238600)
(STARFRUIT, MARKET << US, 5045, 1, 238600)
(STARFRUIT, MARKET << US, 5045, 1, 238600)
(STARFRUIT, MARKET << US, 5045, 1, 238600)
(STARFRUIT, MARKET << US, 5045, 1, 238600)","{""AMETHYSTS"": 19, ""STARFRUIT"": 2}",1893,5048,10000
238700,4948,-193255,"(AMETHYSTS, US << MARKET, 10002, 1, 238700)
(AMETHYSTS, MARKET << US, 10004, 1, 238700)
(AMETHYSTS, MARKET << US, 10004, 1, 238700)
(STARFRUIT, US << MARKET, 5052, 1, 238700)
(STARFRUIT, US << MARKET, 5052, 1, 238700)
(STARFRUIT, MARKET << US, 5046, 1, 238700)","{""AMETHYSTS"": 18, ""STARFRUIT"": 3}",1943,5048,10003
238800,5052,-188203,"(STARFRUIT, US << MARKET, 5052, 1, 238800)
(STARFRUIT, US << MARKET, 5052, 1, 238800)
(STARFRUIT, US << MARKET, 5052, 1, 238800)
(STARFRUIT, MARKET << US, 5052, 1, 238800)
(STARFRUIT, MARKET << US, 5052, 1, 238800)
(STARFRUIT, MARKET << US, 5052, 1, 238800)
(STARFRUIT, MARKET << US, 5052, 1, 238800)","{""AMETHYSTS"": 18, ""STARFRUIT"": 2}",1933,5050,10002
239300,98,-188105,"(AMETHYSTS, US << MARKET, 10004, 1, 239300)
(STARFRUIT, MARKET << US, 5051, 1, 239300)
(STARFRUIT, MARKET << US, 5051, 1, 239300)","{""AMETHYSTS"": 19, ""STARFRUIT"": 0}",1895,5048,10000
240100,15257,-172848,"(AMETHYSTS, US << MARKET, 9998, 1, 240100)
(STARFRUIT, MARKET << US, 5051, 1, 240100)
(STARFRUIT, MARKET << US, 5051, 1, 240100)
(STARFRUIT, MARKET << US, 5051, 1, 240100)
(STARFRUIT, MARKET << US, 5051, 1, 240100)
(STARFRUIT, MARKET << US, 5051, 1, 240100)","{""AMETHYSTS"": 20, ""STARFRUIT"": -5}",1907,5049,10000
240200,0,-172848,,"{""AMETHYSTS"": 20, ""STARFRUIT"": -5}",1872,5048,9998
240700,5052,-167796,"(STARFRUIT, MARKET << US, 5052, 1, 240700)","{""AMETHYSTS"": 20, ""STARFRUIT"": -6}",1926,5053,10002
241000,5053,-162743,"(STARFRUIT, MARKET << US, 5053, 1, 241000)","{""AMETHYSTS"": 20, ""STARFRUIT"": -7}",1854,5049,9997
241200,160064,-2679,"(AMETHYSTS, MARKET << US, 10004, 1, 241200)
(AMETHYSTS, MARKET << US, 10004, 1, 241200)
(AMETHYSTS, MARKET << US, 10004, 1, 241200)
(AMETHYSTS, MARKET << US, 10004, 1, 241200)
(AMETHYSTS, MARKET << US, 10004, 1, 241200)
(AMETHYSTS, MARKET << US, 10004, 1, 241200)
(AMETHYSTS, MARKET << US, 10004, 1, 241200)
(AMETHYSTS, MARKET << US, 10004, 1, 241200)
(AMETHYSTS, MARKET << US, 10004, 1, 241200)
(AMETHYSTS, MARKET << US, 10004, 1, 241200)
(AMETHYSTS, MARKET << US, 10004, 1, 241200)
(AMETHYSTS, MARKET << US, 10004, 1, 241200)
(AMETHYSTS, MARKET << US, 10004, 1, 241200)
(AMETHYSTS, MARKET << US, 10004, 1, 241200)
(AMETHYSTS, MARKET << US, 10004, 1, 241200)
(AMETHYSTS, MARKET << US, 10004, 1, 241200)","{""AMETHYSTS"": 4, ""STARFRUIT"": -7}",1978,5049,10000
241300,5047,2368,"(STARFRUIT, MARKET << US, 5047, 1, 241300)","{""AMETHYSTS"": 4, ""STARFRUIT"": -8}",2004,5046,10001
241400,9998,12366,"(AMETHYSTS, MARKET << US, 9998, 1, 241400)","{""AMETHYSTS"": 3, ""STARFRUIT"": -8}",1969,5050,10001
241600,0,12366,,"{""AMETHYSTS"": 3, ""STARFRUIT"": -8}",1990,5047,10000
242000,9998,22364,"(AMETHYSTS, MARKET << US, 9998, 1, 242000)","{""AMETHYSTS"": 2, ""STARFRUIT"": -8}",1972,5048,9996
242400,-10004,12360,"(AMETHYSTS, US << MARKET, 10004, 1, 242400)","{""AMETHYSTS"": 3, ""STARFRUIT"": -8}",1960,5050,10000
242800,0,12360,,"{""AMETHYSTS"": 3, ""STARFRUIT"": -8}",1968,5049,10000
243100,-30306,-17946,"(STARFRUIT, US << MARKET, 5051, 1, 243100)
(STARFRUIT, US << MARKET, 5051, 1, 243100)
(STARFRUIT, US << MARKET, 5051, 1, 243100)
(STARFRUIT, US << MARKET, 5051, 1, 243100)
(STARFRUIT, US << MARKET, 5051, 1, 243100)
(STARFRUIT, US << MARKET, 5051, 1, 243100)","{""AMETHYSTS"": 3, ""STARFRUIT"": -2}",1950,5052,10000
243500,20004,2058,"(AMETHYSTS, MARKET << US, 10002, 1, 243500)
(AMETHYSTS, MARKET << US, 10002, 1, 243500)","{""AMETHYSTS"": 1, ""STARFRUIT"": -2}",1963,5049,10003
243600,-19996,-17938,"(AMETHYSTS, US << MARKET, 9998, 1, 243600)
(AMETHYSTS, US << MARKET, 9998, 1, 243600)","{""AMETHYSTS"": 3, ""STARFRUIT"": -2}",1967,5049,10001
243900,9998,-7940,"(AMETHYSTS, MARKET << US, 9998, 1, 243900)","{""AMETHYSTS"": 2, ""STARFRUIT"": -2}",1954,5049,9996
244100,-14945,-22885,"(AMETHYSTS, US << MARKET, 9996, 1, 244100)
(AMETHYSTS, US << MARKET, 9996, 1, 244100)
(STARFRUIT, MARKET << US, 5047, 1, 244100)","{""AMETHYSTS"": 4, ""STARFRUIT"": -3}",1965,5050,10000
244300,10096,-12789,"(STARFRUIT, MARKET << US, 5048, 1, 244300)
(STARFRUIT, MARKET << US, 5048, 1, 244300)","{""AMETHYSTS"": 4, ""STARFRUIT"": -5}",1954,5049,9997
244500,5046,-7743,"(STARFRUIT, MARKET << US, 5046, 1, 244500)","{""AMETHYSTS"": 4, ""STARFRUIT"": -6}",1963,5049,10000
244900,-15136,-22879,"(STARFRUIT, US << MARKET, 5046, 1, 244900)
(STARFRUIT, US << MARKET, 5046, 1, 244900)
(STARFRUIT, US << MARKET, 5046, 1, 244900)
(STARFRUIT, US << MARKET, 5046, 1, 244900)
(STARFRUIT, US << MARKET, 5046, 1, 244900)
(STARFRUIT, MARKET << US, 5047, 1, 244900)
(STARFRUIT, MARKET << US, 5047, 1, 244900)","{""AMETHYSTS"": 4, ""STARFRUIT"": -3}",1987,5046,10001
245300,20004,-2875,"(AMETHYSTS, MARKET << US, 10002, 1, 245300)
(AMETHYSTS, MARKET << US, 10002, 1, 245300)","{""AMETHYSTS"": 2, ""STARFRUIT"": -3}",1987,5048,10003
245700,-35371,-38246,"(STARFRUIT, US << MARKET, 5053, 1, 245700)
(STARFRUIT, US << MARKET, 5053, 1, 245700)
(STARFRUIT, US << MARKET, 5053, 1, 245700)
(STARFRUIT, US << MARKET, 5053, 1, 245700)
(STARFRUIT, US << MARKET, 5053, 1, 245700)
(STARFRUIT, US << MARKET, 5053, 1, 245700)
(STARFRUIT, US << MARKET, 5053, 1, 245700)","{""AMETHYSTS"": 2, ""STARFRUIT"": 4}",1946,5049,9998
246000,5052,-33194,"(STARFRUIT, MARKET << US, 5052, 1, 246000)","{""AMETHYSTS"": 2, ""STARFRUIT"": 3}",1962,5052,10000
246100,20184,-13010,"(STARFRUIT, MARKET << US, 5046, 1, 246100)
(STARFRUIT, MARKET << US, 5046, 1, 246100)
(STARFRUIT, MARKET << US, 5046, 1, 246100)
(STARFRUIT, MARKET << US, 5046, 1, 246100)","{""AMETHYSTS"": 2, ""STARFRUIT"": -1}",1941,5049,10000
246800,5046,-7964,"(STARFRUIT, MARKET << US, 5046, 1, 246800)","{""AMETHYSTS"": 2, ""STARFRUIT"": -2}",1946,5045,10000
247000,89930,81966,"(AMETHYSTS, MARKET << US, 10002, 1, 247000)
(AMETHYSTS, MARKET << US, 10002, 1, 247000)
(AMETHYSTS, MARKET << US, 10002, 1, 247000)
(AMETHYSTS, MARKET << US, 10002, 1, 247000)
(AMETHYSTS, MARKET << US, 10002, 1, 247000)
(AMETHYSTS, MARKET << US, 10002, 1, 247000)
(AMETHYSTS, MARKET << US, 10002, 1, 247000)
(AMETHYSTS, MARKET << US, 10002, 1, 247000)
(AMETHYSTS, MARKET << US, 10002, 1, 247000)
(AMETHYSTS, MARKET << US, 10002, 1, 247000)
(STARFRUIT, US << MARKET, 5045, 1, 247000)
(STARFRUIT, US << MARKET, 5045, 1, 247000)","{""AMETHYSTS"": -8, ""STARFRUIT"": 0}",1942,5048,10003
247200,5049,87015,"(STARFRUIT, MARKET << US, 5049, 1, 247200)","{""AMETHYSTS"": -8, ""STARFRUIT"": -1}",1973,5050,9999
247500,-159920,-72905,"(AMETHYSTS, US << MARKET, 9995, 1, 247500)
(AMETHYSTS, US << MARKET, 9995, 1, 247500)
(AMETHYSTS, US << MARKET, 9995, 1, 247500)
(AMETHYSTS, US << MARKET, 9995, 1, 247500)
(AMETHYSTS, US << MARKET, 9995, 1, 247500)
(AMETHYSTS, US << MARKET, 9995, 1, 247500)
(AMETHYSTS, US << MARKET, 9995, 1, 247500)
(AMETHYSTS, US << MARKET, 9995, 1, 247500)
(AMETHYSTS, US << MARKET, 9995, 1, 247500)
(AMETHYSTS, US << MARKET, 9995, 1, 247500)
(AMETHYSTS, US << MARKET, 9995, 1, 247500)
(AMETHYSTS, US << MARKET, 9995, 1, 247500)
(AMETHYSTS, US << MARKET, 9995, 1, 247500)
(AMETHYSTS, US << MARKET, 9995, 1, 247500)
(AMETHYSTS, US << MARKET, 9995, 1, 247500)
(AMETHYSTS, US << MARKET, 9995, 1, 247500)","{""AMETHYSTS"": 8, ""STARFRUIT"": -1}",2016,5047,9996
247600,69965,-2940,"(AMETHYSTS, MARKET << US, 9995, 1, 247600)
(AMETHYSTS, MARKET << US, 9995, 1, 247600)
(AMETHYSTS, MARKET << US, 9995, 1, 247600)
(AMETHYSTS, MARKET << US, 9995, 1, 247600)
(AMETHYSTS, MARKET << US, 9995, 1, 247600)
(AMETHYSTS, MARKET << US, 9995, 1, 247600)
(AMETHYSTS, MARKET << US, 9995, 1, 247600)","{""AMETHYSTS"": 1, ""STARFRUIT"": -1}",2012,5048,10000
248100,-34939,-37879,"(AMETHYSTS, US << MARKET, 9998, 1, 248100)
(AMETHYSTS, US << MARKET, 9998, 1, 248100)
(AMETHYSTS, US << MARKET, 9998, 1, 248100)
(AMETHYSTS, US << MARKET, 9998, 1, 248100)
(STARFRUIT, US << MARKET, 5050, 1, 248100)
(STARFRUIT, US << MARKET, 5050, 1, 248100)
(STARFRUIT, MARKET << US, 5051, 1, 248100)
(STARFRUIT, MARKET << US, 5051, 1, 248100)
(STARFRUIT, MARKET << US, 5051, 1, 248100)","{""AMETHYSTS"": 5, ""STARFRUIT"": -2}",2032,5047,10001
248200,5045,-32834,"(STARFRUIT, MARKET << US, 5045, 1, 248200)","{""AMETHYSTS"": 5, ""STARFRUIT"": -3}",2022,5048,10000
248300,-35343,-68177,"(STARFRUIT, US << MARKET, 5049, 1, 248300)
(STARFRUIT, US << MARKET, 5049, 1, 248300)
(STARFRUIT, US << MARKET, 5049, 1, 248300)
(STARFRUIT, US << MARKET, 5049, 1, 248300)
(STARFRUIT, US << MARKET, 5049, 1, 248300)
(STARFRUIT, US << MARKET, 5049, 1, 248300)
(STARFRUIT, US << MARKET, 5049, 1, 248300)","{""AMETHYSTS"": 5, ""STARFRUIT"": 4}",2028,5050,10001
248400,50124,-18053,"(AMETHYSTS, MARKET << US, 10005, 1, 248400)
(AMETHYSTS, MARKET << US, 10005, 1, 248400)
(AMETHYSTS, MARKET << US, 10005, 1, 248400)
(AMETHYSTS, MARKET << US, 10005, 1, 248400)
(STARFRUIT, MARKET << US, 5052, 1, 248400)
(STARFRUIT, MARKET << US, 5052, 1, 248400)","{""AMETHYSTS"": 1, ""STARFRUIT"": 2}",2043,5048,10000
248600,-25250,-43303,"(STARFRUIT, US << MARKET, 5050, 1, 248600)
(STARFRUIT, US << MARKET, 5050, 1, 248600)
(STARFRUIT, US << MARKET, 5050, 1, 248600)
(STARFRUIT, US << MARKET, 5050, 1, 248600)
(STARFRUIT, US << MARKET, 5050, 1, 248600)","{""AMETHYSTS"": 1, ""STARFRUIT"": 7}",2054,5051,10000
248700,-40020,-83323,"(AMETHYSTS, US << MARKET, 10005, 1, 248700)
(AMETHYSTS, US << MARKET, 10005, 1, 248700)
(AMETHYSTS, US << MARKET, 10005, 1, 248700)
(AMETHYSTS, US << MARKET, 10005, 1, 248700)","{""AMETHYSTS"": 5, ""STARFRUIT"": 7}",2020,5049,10000
248800,5046,-78277,"(STARFRUIT, MARKET << US, 5046, 1, 248800)","{""AMETHYSTS"": 5, ""STARFRUIT"": 6}",2006,5048,9999
248900,5046,-73231,"(STARFRUIT, MARKET << US, 5046, 1, 248900)","{""AMETHYSTS"": 5, ""STARFRUIT"": 5}",2014,5048,10001
249100,9998,-63233,"(AMETHYSTS, MARKET << US, 9998, 1, 249100)","{""AMETHYSTS"": 4, ""STARFRUIT"": 5}",2000,5049,9997
249200,20200,-43033,"(STARFRUIT, MARKET << US, 5050, 1, 249200)
(STARFRUIT, MARKET << US, 5050, 1, 249200)
(STARFRUIT, MARKET << US, 5050, 1, 249200)
(STARFRUIT, MARKET << US, 5050, 1, 249200)","{""AMETHYSTS"": 4, ""STARFRUIT"": 1}",2017,5050,10000
249400,29898,-13135,"(AMETHYSTS, MARKET << US, 9998, 1, 249400)
(AMETHYSTS, MARKET << US, 9998, 1, 249400)
(AMETHYSTS, MARKET << US, 9998, 1, 249400)
(AMETHYSTS, MARKET << US, 9998, 1, 249400)
(STARFRUIT, US << MARKET, 5047, 1, 249400)
(STARFRUIT, US << MARKET, 5047, 1, 249400)","{""AMETHYSTS"": 0, ""STARFRUIT"": 3}",2015,5050,9996
249500,-19996,-33131,"(AMETHYSTS, US << MARKET, 9998, 1, 249500)
(AMETHYSTS, US << MARKET, 9998, 1, 249500)","{""AMETHYSTS"": 2, ""STARFRUIT"": 3}",2021,5050,10001
249600,5048,-28083,"(STARFRUIT, US << MARKET, 5048, 1, 249600)
(STARFRUIT, US << MARKET, 5048, 1, 249600)
(STARFRUIT, US << MARKET, 5048, 1, 249600)
(STARFRUIT, MARKET << US, 5048, 1, 249600)
(STARFRUIT, MARKET << US, 5048, 1, 249600)
(STARFRUIT, MARKET << US, 5048, 1, 249600)
(STARFRUIT, MARKET << US, 5048, 1, 249600)","{""AMETHYSTS"": 2, ""STARFRUIT"": 2}",2019,5051,10000
249700,30000,1917,"(AMETHYSTS, MARKET << US, 10002, 1, 249700)
(AMETHYSTS, MARKET << US, 10002, 1, 249700)
(AMETHYSTS, MARKET << US, 9996, 1, 249700)","{""AMETHYSTS"": -1, ""STARFRUIT"": 2}",2018,5050,9999
249800,-25270,-23353,"(STARFRUIT, US << MARKET, 5054, 1, 249800)
(STARFRUIT, US << MARKET, 5054, 1, 249800)
(STARFRUIT, US << MARKET, 5054, 1, 249800)
(STARFRUIT, US << MARKET, 5054, 1, 249800)
(STARFRUIT, US << MARKET, 5054, 1, 249800)","{""AMETHYSTS"": -1, ""STARFRUIT"": 7}",2004,5051,10000
250000,-50010,-73363,"(AMETHYSTS, US << MARKET, 10002, 1, 250000)
(AMETHYSTS, US << MARKET, 10002, 1, 250000)
(AMETHYSTS, US << MARKET, 10002, 1, 250000)
(AMETHYSTS, US << MARKET, 10002, 1, 250000)
(AMETHYSTS, US << MARKET, 10002, 1, 250000)","{""AMETHYSTS"": 4, ""STARFRUIT"": 7}",2006,5051,10003
250100,-20188,-93551,"(STARFRUIT, US << MARKET, 5047, 1, 250100)
(STARFRUIT, US << MARKET, 5047, 1, 250100)
(STARFRUIT, US << MARKET, 5047, 1, 250100)
(STARFRUIT, US << MARKET, 5047, 1, 250100)","{""AMETHYSTS"": 4, ""STARFRUIT"": 11}",1999,5050,10000
250200,-149925,-243476,"(AMETHYSTS, US << MARKET, 9995, 1, 250200)
(AMETHYSTS, US << MARKET, 9995, 1, 250200)
(AMETHYSTS, US << MARKET, 9995, 1, 250200)
(AMETHYSTS, US << MARKET, 9995, 1, 250200)
(AMETHYSTS, US << MARKET, 9995, 1, 250200)
(AMETHYSTS, US << MARKET, 9995, 1, 250200)
(AMETHYSTS, US << MARKET, 9995, 1, 250200)
(AMETHYSTS, US << MARKET, 9995, 1, 250200)
(AMETHYSTS, US << MARKET, 9995, 1, 250200)
(AMETHYSTS, US << MARKET, 9995, 1, 250200)
(AMETHYSTS, US << MARKET, 9995, 1, 250200)
(AMETHYSTS, US << MARKET, 9995, 1, 250200)
(AMETHYSTS, US << MARKET, 9995, 1, 250200)
(AMETHYSTS, US << MARKET, 9995, 1, 250200)
(AMETHYSTS, US << MARKET, 9995, 1, 250200)","{""AMETHYSTS"": 19, ""STARFRUIT"": 11}",2074,5050,10000
250400,-20106,-263582,"(AMETHYSTS, US << MARKET, 9998, 1, 250400)
(STARFRUIT, US << MARKET, 5054, 1, 250400)
(STARFRUIT, US << MARKET, 5054, 1, 250400)","{""AMETHYSTS"": 20, ""STARFRUIT"": 13}",1988,5050,9996
250700,20204,-243378,"(STARFRUIT, MARKET << US, 5051, 1, 250700)
(STARFRUIT, MARKET << US, 5051, 1, 250700)
(STARFRUIT, MARKET << US, 5051, 1, 250700)
(STARFRUIT, MARKET << US, 5051, 1, 250700)","{""AMETHYSTS"": 20, ""STARFRUIT"": 9}",2090,5052,10000
251400,-15150,-258528,"(STARFRUIT, US << MARKET, 5051, 1, 251400)
(STARFRUIT, US << MARKET, 5051, 1, 251400)
(STARFRUIT, US << MARKET, 5051, 1, 251400)
(STARFRUIT, US << MARKET, 5051, 1, 251400)
(STARFRUIT, MARKET << US, 5054, 1, 251400)","{""AMETHYSTS"": 20, ""STARFRUIT"": 12}",2020,5049,9998
251700,-5054,-263582,"(STARFRUIT, US << MARKET, 5054, 1, 251700)","{""AMETHYSTS"": 20, ""STARFRUIT"": 13}",2133,5055,10000
252000,4949,-258633,"(AMETHYSTS, MARKET << US, 9998, 1, 252000)
(STARFRUIT, US << MARKET, 5049, 1, 252000)","{""AMETHYSTS"": 19, ""STARFRUIT"": 14}",1963,5048,9996
252100,-15150,-273783,"(STARFRUIT, US << MARKET, 5050, 1, 252100)
(STARFRUIT, US << MARKET, 5050, 1, 252100)
(STARFRUIT, US << MARKET, 5050, 1, 252100)","{""AMETHYSTS"": 19, ""STARFRUIT"": 17}",2050,5049,10000
252700,5054,-268729,"(STARFRUIT, MARKET << US, 5054, 1, 252700)","{""AMETHYSTS"": 19, ""STARFRUIT"": 16}",2068,5051,9999
252800,25063,-243666,"(AMETHYSTS, MARKET << US, 10004, 1, 252800)
(AMETHYSTS, MARKET << US, 10004, 1, 252800)
(STARFRUIT, MARKET << US, 5055, 1, 252800)","{""AMETHYSTS"": 17, ""STARFRUIT"": 15}",2114,5052,10000
253100,-4950,-248616,"(AMETHYSTS, US << MARKET, 10004, 1, 253100)
(STARFRUIT, MARKET << US, 5054, 1, 253100)","{""AMETHYSTS"": 18, ""STARFRUIT"": 14}",2084,5050,10000
253400,-5047,-253663,"(STARFRUIT, US << MARKET, 5047, 1, 253400)","{""AMETHYSTS"": 18, ""STARFRUIT"": 15}",2087,5050,10000
253600,-5053,-258716,"(STARFRUIT, US << MARKET, 5053, 1, 253600)","{""AMETHYSTS"": 18, ""STARFRUIT"": 16}",2114,5053,9999
253800,-10002,-268718,"(AMETHYSTS, US << MARKET, 10002, 1, 253800)","{""AMETHYSTS"": 19, ""STARFRUIT"": 16}",2044,5050,9998
254000,5048,-263670,"(STARFRUIT, MARKET << US, 5048, 1, 254000)","{""AMETHYSTS"": 19, ""STARFRUIT"": 15}",2095,5051,10000
254200,190076,-73594,"(AMETHYSTS, US << MARKET, 10004, 1, 254200)
(AMETHYSTS, MARKET << US, 10004, 1, 254200)
(AMETHYSTS, MARKET << US, 10004, 1, 254200)
(AMETHYSTS, MARKET << US, 10004, 1, 254200)
(AMETHYSTS, MARKET << US, 10004, 1, 254200)
(AMETHYSTS, MARKET << US, 10004, 1, 254200)
(AMETHYSTS, MARKET << US, 10004, 1, 254200)
(AMETHYSTS, MARKET << US, 10004, 1, 254200)
(AMETHYSTS, MARKET << US, 10004, 1, 254200)
(AMETHYSTS, MARKET << US, 10004, 1, 254200)
(AMETHYSTS, MARKET << US, 10004, 1, 254200)
(AMETHYSTS, MARKET << US, 10004, 1, 254200)
(AMETHYSTS, MARKET << US, 10004, 1, 254200)
(AMETHYSTS, MARKET << US, 10004, 1, 254200)
(AMETHYSTS, MARKET << US, 10004, 1, 254200)
(AMETHYSTS, MARKET << US, 10004, 1, 254200)
(AMETHYSTS, MARKET << US, 10004, 1, 254200)
(AMETHYSTS, MARKET << US, 10004, 1, 254200)
(AMETHYSTS, MARKET << US, 10004, 1, 254200)
(AMETHYSTS, MARKET << US, 10004, 1, 254200)
(AMETHYSTS, MARKET << US, 10004, 1, 254200)","{""AMETHYSTS"": 0, ""STARFRUIT"": 15}",2156,5050,10001
254800,-39984,-113578,"(AMETHYSTS, US << MARKET, 9996, 1, 254800)
(AMETHYSTS, US << MARKET, 9996, 1, 254800)
(AMETHYSTS, US << MARKET, 9996, 1, 254800)
(AMETHYSTS, US << MARKET, 9996, 1, 254800)","{""AMETHYSTS"": 4, ""STARFRUIT"": 15}",2160,5050,9997
254900,-39992,-153570,"(AMETHYSTS, US << MARKET, 9998, 1, 254900)
(AMETHYSTS, US << MARKET, 9998, 1, 254900)
(AMETHYSTS, US << MARKET, 9998, 1, 254900)
(AMETHYSTS, US << MARKET, 9998, 1, 254900)","{""AMETHYSTS"": 8, ""STARFRUIT"": 15}",2186,5052,9997
255100,-19996,-173566,"(AMETHYSTS, US << MARKET, 9998, 1, 255100)
(AMETHYSTS, US << MARKET, 9998, 1, 255100)","{""AMETHYSTS"": 10, ""STARFRUIT"": 15}",2239,5053,10001
255500,-9998,-183564,"(AMETHYSTS, US << MARKET, 10005, 1, 255500)
(STARFRUIT, US << MARKET, 5047, 1, 255500)
(STARFRUIT, MARKET << US, 5054, 1, 255500)","{""AMETHYSTS"": 11, ""STARFRUIT"": 15}",2186,5050,10000
255800,-74922,-258486,"(AMETHYSTS, US << MARKET, 9998, 1, 255800)
(AMETHYSTS, US << MARKET, 9998, 1, 255800)
(AMETHYSTS, US << MARKET, 9998, 1, 255800)
(AMETHYSTS, US << MARKET, 9998, 1, 255800)
(AMETHYSTS, US << MARKET, 9998, 1, 255800)
(AMETHYSTS, US << MARKET, 9998, 1, 255800)
(AMETHYSTS, US << MARKET, 9998, 1, 255800)
(AMETHYSTS, US << MARKET, 9998, 1, 255800)
(STARFRUIT, US << MARKET, 5047, 1, 255800)
(STARFRUIT, US << MARKET, 5047, 1, 255800)
(STARFRUIT, US << MARKET, 5047, 1, 255800)
(STARFRUIT, US << MARKET, 5047, 1, 255800)
(STARFRUIT, MARKET << US, 5050, 1, 255800)
(STARFRUIT, MARKET << US, 5050, 1, 255800)
(STARFRUIT, MARKET << US, 5050, 1, 255800)
(STARFRUIT, MARKET << US, 5050, 1, 255800)
(STARFRUIT, MARKET << US, 5050, 1, 255800)","{""AMETHYSTS"": 19, ""STARFRUIT"": 14}",2101,5046,9997
255900,-9998,-268484,"(AMETHYSTS, US << MARKET, 9998, 1, 255900)","{""AMETHYSTS"": 20, ""STARFRUIT"": 14}",2256,5050,10002
256000,5051,-263433,"(STARFRUIT, MARKET << US, 5051, 1, 256000)","{""AMETHYSTS"": 20, ""STARFRUIT"": 13}",2230,5051,10000
256100,-5046,-268479,"(STARFRUIT, US << MARKET, 5046, 1, 256100)","{""AMETHYSTS"": 20, ""STARFRUIT"": 14}",2151,5045,10000
256200,5050,-263429,"(STARFRUIT, MARKET << US, 5050, 1, 256200)","{""AMETHYSTS"": 20, ""STARFRUIT"": 13}",2182,5047,10000
256400,5045,-258384,"(STARFRUIT, MARKET << US, 5045, 1, 256400)","{""AMETHYSTS"": 20, ""STARFRUIT"": 12}",2224,5049,10001
256500,-5045,-263429,"(STARFRUIT, US << MARKET, 5045, 1, 256500)","{""AMETHYSTS"": 20, ""STARFRUIT"": 13}",2215,5048,10001
257200,5045,-258384,"(STARFRUIT, MARKET << US, 5045, 1, 257200)","{""AMETHYSTS"": 20, ""STARFRUIT"": 12}",2144,5044,10000
257400,0,-258384,,"{""AMETHYSTS"": 20, ""STARFRUIT"": 12}",2120,5047,9997
257500,20004,-238380,"(AMETHYSTS, MARKET << US, 10002, 1, 257500)
(AMETHYSTS, MARKET << US, 10002, 1, 257500)","{""AMETHYSTS"": 18, ""STARFRUIT"": 12}",2238,5047,10003
257800,-19990,-258370,"(AMETHYSTS, US << MARKET, 9995, 1, 257800)
(AMETHYSTS, US << MARKET, 9995, 1, 257800)","{""AMETHYSTS"": 20, ""STARFRUIT"": 12}",2194,5047,10000
257900,-104,-258474,"(AMETHYSTS, MARKET << US, 9998, 1, 257900)
(STARFRUIT, US << MARKET, 5051, 1, 257900)
(STARFRUIT, US << MARKET, 5051, 1, 257900)","{""AMETHYSTS"": 19, ""STARFRUIT"": 14}",2150,5050,9996
258000,49990,-208484,"(AMETHYSTS, MARKET << US, 9998, 1, 258000)
(AMETHYSTS, MARKET << US, 9998, 1, 258000)
(AMETHYSTS, MARKET << US, 9998, 1, 258000)
(AMETHYSTS, MARKET << US, 9998, 1, 258000)
(AMETHYSTS, MARKET << US, 9998, 1, 258000)","{""AMETHYSTS"": 14, ""STARFRUIT"": 14}",2202,5048,10001
258200,-20184,-228668,"(STARFRUIT, US << MARKET, 5046, 1, 258200)
(STARFRUIT, US << MARKET, 5046, 1, 258200)
(STARFRUIT, US << MARKET, 5046, 1, 258200)
(STARFRUIT, US << MARKET, 5046, 1, 258200)","{""AMETHYSTS"": 14, ""STARFRUIT"": 18}",2214,5049,10000
258500,69908,-158760,"(AMETHYSTS, MARKET << US, 10002, 1, 258500)
(AMETHYSTS, MARKET << US, 10002, 1, 258500)
(AMETHYSTS, MARKET << US, 10002, 1, 258500)
(AMETHYSTS, MARKET << US, 10002, 1, 258500)
(AMETHYSTS, MARKET << US, 10002, 1, 258500)
(AMETHYSTS, MARKET << US, 10002, 1, 258500)
(AMETHYSTS, MARKET << US, 10002, 1, 258500)
(AMETHYSTS, MARKET << US, 10002, 1, 258500)
(STARFRUIT, US << MARKET, 5054, 1, 258500)
(STARFRUIT, US << MARKET, 5054, 1, 258500)","{""AMETHYSTS"": 6, ""STARFRUIT"": 20}",2254,5051,9999
258900,20004,-138756,"(AMETHYSTS, MARKET << US, 10002, 1, 258900)
(AMETHYSTS, MARKET << US, 10002, 1, 258900)","{""AMETHYSTS"": 4, ""STARFRUIT"": 20}",2196,5047,10003
259000,40016,-98740,"(AMETHYSTS, MARKET << US, 10004, 1, 259000)
(AMETHYSTS, MARKET << US, 10004, 1, 259000)
(AMETHYSTS, MARKET << US, 10004, 1, 259000)
(AMETHYSTS, MARKET << US, 10004, 1, 259000)","{""AMETHYSTS"": 0, ""STARFRUIT"": 20}",2260,5050,10000
259400,5047,-93693,"(STARFRUIT, MARKET << US, 5047, 1, 259400)","{""AMETHYSTS"": 0, ""STARFRUIT"": 19}",2257,5050,10001
259700,-5047,-98740,"(STARFRUIT, US << MARKET, 5047, 1, 259700)","{""AMETHYSTS"": 0, ""STARFRUIT"": 20}",2260,5050,10001
260300,-10002,-108742,"(AMETHYSTS, US << MARKET, 10002, 1, 260300)","{""AMETHYSTS"": 1, ""STARFRUIT"": 20}",2257,5050,9999
260700,15045,-93697,"(AMETHYSTS, MARKET << US, 9998, 1, 260700)
(STARFRUIT, MARKET << US, 5047, 1, 260700)","{""AMETHYSTS"": 0, ""STARFRUIT"": 19}",2196,5047,10001
260800,5052,-88645,"(STARFRUIT, MARKET << US, 5052, 1, 260800)","{""AMETHYSTS"": 0, ""STARFRUIT"": 18}",2291,5052,10000
261000,25240,-63405,"(STARFRUIT, MARKET << US, 5048, 1, 261000)
(STARFRUIT, MARKET << US, 5048, 1, 261000)
(STARFRUIT, MARKET << US, 5048, 1, 261000)
(STARFRUIT, MARKET << US, 5048, 1, 261000)
(STARFRUIT, MARKET << US, 5048, 1, 261000)","{""AMETHYSTS"": 0, ""STARFRUIT"": 13}",2206,5047,10000
261100,50470,-12935,"(STARFRUIT, MARKET << US, 5047, 1, 261100)
(STARFRUIT, MARKET << US, 5047, 1, 261100)
(STARFRUIT, MARKET << US, 5047, 1, 261100)
(STARFRUIT, MARKET << US, 5047, 1, 261100)
(STARFRUIT, MARKET << US, 5047, 1, 261100)
(STARFRUIT, MARKET << US, 5047, 1, 261100)
(STARFRUIT, MARKET << US, 5047, 1, 261100)
(STARFRUIT, MARKET << US, 5047, 1, 261100)
(STARFRUIT, MARKET << US, 5047, 1, 261100)
(STARFRUIT, MARKET << US, 5047, 1, 261100)","{""AMETHYSTS"": 0, ""STARFRUIT"": 3}",2215,5050,10000
261200,10106,-2829,"(STARFRUIT, MARKET << US, 5053, 1, 261200)
(STARFRUIT, MARKET << US, 5053, 1, 261200)","{""AMETHYSTS"": 0, ""STARFRUIT"": 1}",2220,5049,9998
261400,10096,7267,"(STARFRUIT, MARKET << US, 5048, 1, 261400)
(STARFRUIT, MARKET << US, 5048, 1, 261400)","{""AMETHYSTS"": 0, ""STARFRUIT"": -1}",2218,5049,10000
261600,49990,57257,"(AMETHYSTS, MARKET << US, 9998, 1, 261600)
(AMETHYSTS, MARKET << US, 9998, 1, 261600)
(AMETHYSTS, MARKET << US, 9998, 1, 261600)
(AMETHYSTS, MARKET << US, 9998, 1, 261600)
(AMETHYSTS, MARKET << US, 9998, 1, 261600)","{""AMETHYSTS"": -5, ""STARFRUIT"": -1}",2221,5051,9997
261800,-14944,42313,"(AMETHYSTS, US << MARKET, 9995, 1, 261800)
(AMETHYSTS, US << MARKET, 9995, 1, 261800)
(STARFRUIT, MARKET << US, 5046, 1, 261800)","{""AMETHYSTS"": -3, ""STARFRUIT"": -2}",2223,5048,9998
262100,-4954,37359,"(AMETHYSTS, US << MARKET, 10002, 1, 262100)
(STARFRUIT, MARKET << US, 5048, 1, 262100)","{""AMETHYSTS"": -2, ""STARFRUIT"": -3}",2212,5047,10003
262700,5048,42407,"(STARFRUIT, MARKET << US, 5048, 1, 262700)","{""AMETHYSTS"": -2, ""STARFRUIT"": -4}",2205,5050,10001
263200,40016,82423,"(AMETHYSTS, MARKET << US, 10004, 1, 263200)
(AMETHYSTS, MARKET << US, 10004, 1, 263200)
(AMETHYSTS, MARKET << US, 10004, 1, 263200)
(AMETHYSTS, MARKET << US, 10004, 1, 263200)","{""AMETHYSTS"": -6, ""STARFRUIT"": -4}",2199,5053,10002
263300,0,82423,"(AMETHYSTS, US << MARKET, 9998, 1, 263300)
(AMETHYSTS, US << MARKET, 9998, 1, 263300)
(AMETHYSTS, MARKET << US, 9998, 1, 263300)
(AMETHYSTS, MARKET << US, 9998, 1, 263300)","{""AMETHYSTS"": -6, ""STARFRUIT"": -4}",2233,5052,9997
263900,100020,182443,"(AMETHYSTS, MARKET << US, 10002, 1, 263900)
(AMETHYSTS, MARKET << US, 10002, 1, 263900)
(AMETHYSTS, MARKET << US, 10002, 1, 263900)
(AMETHYSTS, MARKET << US, 10002, 1, 263900)
(AMETHYSTS, MARKET << US, 10002, 1, 263900)
(AMETHYSTS, MARKET << US, 10002, 1, 263900)
(AMETHYSTS, MARKET << US, 10002, 1, 263900)
(AMETHYSTS, MARKET << US, 10002, 1, 263900)
(AMETHYSTS, MARKET << US, 10002, 1, 263900)
(AMETHYSTS, MARKET << US, 10002, 1, 263900)","{""AMETHYSTS"": -16, ""STARFRUIT"": -4}",2191,5051,10003
264100,40125,222568,"(AMETHYSTS, MARKET << US, 10005, 1, 264100)
(AMETHYSTS, MARKET << US, 10005, 1, 264100)
(AMETHYSTS, MARKET << US, 10005, 1, 264100)
(STARFRUIT, MARKET << US, 5055, 1, 264100)
(STARFRUIT, MARKET << US, 5055, 1, 264100)","{""AMETHYSTS"": -19, ""STARFRUIT"": -6}",2262,5051,10000
264300,-40392,182176,"(STARFRUIT, US << MARKET, 5049, 1, 264300)
(STARFRUIT, US << MARKET, 5049, 1, 264300)
(STARFRUIT, US << MARKET, 5049, 1, 264300)
(STARFRUIT, US << MARKET, 5049, 1, 264300)
(STARFRUIT, US << MARKET, 5049, 1, 264300)
(STARFRUIT, US << MARKET, 5049, 1, 264300)
(STARFRUIT, US << MARKET, 5049, 1, 264300)
(STARFRUIT, US << MARKET, 5049, 1, 264300)","{""AMETHYSTS"": -19, ""STARFRUIT"": 2}",2253,5048,10001
264500,20098,202274,"(AMETHYSTS, MARKET << US, 9998, 1, 264500)
(STARFRUIT, MARKET << US, 5050, 1, 264500)
(STARFRUIT, MARKET << US, 5050, 1, 264500)","{""AMETHYSTS"": -20, ""STARFRUIT"": 0}",2254,5049,10001
264700,-30102,172172,"(AMETHYSTS, US << MARKET, 9998, 1, 264700)
(AMETHYSTS, US << MARKET, 9998, 1, 264700)
(STARFRUIT, US << MARKET, 5053, 1, 264700)
(STARFRUIT, US << MARKET, 5053, 1, 264700)
(STARFRUIT, US << MARKET, 5053, 1, 264700)
(STARFRUIT, US << MARKET, 5053, 1, 264700)
(STARFRUIT, US << MARKET, 5053, 1, 264700)
(STARFRUIT, MARKET << US, 5053, 1, 264700)
(STARFRUIT, MARKET << US, 5053, 1, 264700)
(STARFRUIT, MARKET << US, 5053, 1, 264700)","{""AMETHYSTS"": -18, ""STARFRUIT"": 2}",2328,5051,9997
264800,20008,192180,"(AMETHYSTS, MARKET << US, 10004, 1, 264800)
(AMETHYSTS, MARKET << US, 10004, 1, 264800)","{""AMETHYSTS"": -20, ""STARFRUIT"": 2}",2264,5052,10001
265200,5055,197235,"(STARFRUIT, MARKET << US, 5055, 1, 265200)","{""AMETHYSTS"": -20, ""STARFRUIT"": 1}",2326,5051,9998
265600,-19996,177239,"(AMETHYSTS, US << MARKET, 9998, 1, 265600)
(AMETHYSTS, US << MARKET, 9998, 1, 265600)","{""AMETHYSTS"": -18, ""STARFRUIT"": 1}",2346,5053,9997
265900,-79960,97279,"(AMETHYSTS, US << MARKET, 9995, 1, 265900)
(AMETHYSTS, US << MARKET, 9995, 1, 265900)
(AMETHYSTS, US << MARKET, 9995, 1, 265900)
(AMETHYSTS, US << MARKET, 9995, 1, 265900)
(AMETHYSTS, US << MARKET, 9995, 1, 265900)
(AMETHYSTS, US << MARKET, 9995, 1, 265900)
(AMETHYSTS, US << MARKET, 9995, 1, 265900)
(AMETHYSTS, US << MARKET, 9995, 1, 265900)","{""AMETHYSTS"": -10, ""STARFRUIT"": 1}",2354,5055,9998
266000,9998,107277,"(AMETHYSTS, MARKET << US, 9998, 1, 266000)","{""AMETHYSTS"": -11, ""STARFRUIT"": 1}",2364,5054,9997
266100,5056,112333,"(STARFRUIT, MARKET << US, 5056, 1, 266100)","{""AMETHYSTS"": -11, ""STARFRUIT"": 0}",2322,5053,10001
266700,50132,162465,"(AMETHYSTS, MARKET << US, 10005, 1, 266700)
(AMETHYSTS, MARKET << US, 10005, 1, 266700)
(AMETHYSTS, MARKET << US, 10005, 1, 266700)
(AMETHYSTS, MARKET << US, 10005, 1, 266700)
(STARFRUIT, MARKET << US, 5056, 1, 266700)
(STARFRUIT, MARKET << US, 5056, 1, 266700)","{""AMETHYSTS"": -15, ""STARFRUIT"": -2}",2361,5052,10000
267100,-20004,142461,"(AMETHYSTS, US << MARKET, 10002, 1, 267100)
(AMETHYSTS, US << MARKET, 10002, 1, 267100)","{""AMETHYSTS"": -13, ""STARFRUIT"": -2}",2318,5052,10003
267900,-20008,122453,"(AMETHYSTS, US << MARKET, 10004, 1, 267900)
(AMETHYSTS, US << MARKET, 10004, 1, 267900)
(AMETHYSTS, US << MARKET, 10004, 1, 267900)
(AMETHYSTS, US << MARKET, 10004, 1, 267900)
(AMETHYSTS, MARKET << US, 10004, 1, 267900)
(AMETHYSTS, MARKET << US, 10004, 1, 267900)","{""AMETHYSTS"": -11, ""STARFRUIT"": -2}",2351,5051,10000
268200,-19996,102457,"(AMETHYSTS, US << MARKET, 10005, 1, 268200)
(AMETHYSTS, US << MARKET, 10005, 1, 268200)
(STARFRUIT, US << MARKET, 5049, 1, 268200)
(STARFRUIT, US << MARKET, 5049, 1, 268200)
(STARFRUIT, MARKET << US, 5056, 1, 268200)
(STARFRUIT, MARKET << US, 5056, 1, 268200)","{""AMETHYSTS"": -9, ""STARFRUIT"": -2}",2351,5053,10000
268300,-101,102356,"(AMETHYSTS, MARKET << US, 9995, 1, 268300)
(STARFRUIT, US << MARKET, 5048, 1, 268300)
(STARFRUIT, US << MARKET, 5048, 1, 268300)","{""AMETHYSTS"": -10, ""STARFRUIT"": 0}",2356,5051,10000
268400,-10108,92248,"(STARFRUIT, US << MARKET, 5054, 1, 268400)
(STARFRUIT, US << MARKET, 5054, 1, 268400)","{""AMETHYSTS"": -10, ""STARFRUIT"": 2}",2346,5054,10001
268500,-10096,82152,"(STARFRUIT, US << MARKET, 5048, 1, 268500)
(STARFRUIT, US << MARKET, 5048, 1, 268500)","{""AMETHYSTS"": -10, ""STARFRUIT"": 4}",2362,5050,9999
269200,-10108,72044,"(STARFRUIT, US << MARKET, 5054, 1, 269200)
(STARFRUIT, US << MARKET, 5054, 1, 269200)","{""AMETHYSTS"": -10, ""STARFRUIT"": 6}",2350,5051,10000
269400,5049,77093,"(STARFRUIT, MARKET << US, 5049, 1, 269400)","{""AMETHYSTS"": -10, ""STARFRUIT"": 5}",2353,5052,10000
269700,5054,82147,"(STARFRUIT, MARKET << US, 5054, 1, 269700)","{""AMETHYSTS"": -10, ""STARFRUIT"": 4}",2367,5055,10000
270100,-79970,2177,"(AMETHYSTS, US << MARKET, 9996, 1, 270100)
(AMETHYSTS, US << MARKET, 9996, 1, 270100)
(AMETHYSTS, US << MARKET, 9996, 1, 270100)
(AMETHYSTS, US << MARKET, 9996, 1, 270100)
(AMETHYSTS, US << MARKET, 9996, 1, 270100)
(AMETHYSTS, US << MARKET, 9996, 1, 270100)
(AMETHYSTS, US << MARKET, 9996, 1, 270100)
(AMETHYSTS, US << MARKET, 9996, 1, 270100)
(AMETHYSTS, US << MARKET, 9996, 1, 270100)
(AMETHYSTS, US << MARKET, 9998, 1, 270100)
(AMETHYSTS, MARKET << US, 9996, 1, 270100)
(AMETHYSTS, MARKET << US, 9996, 1, 270100)","{""AMETHYSTS"": -2, ""STARFRUIT"": 4}",2399,5054,9997
270300,20228,22405,"(STARFRUIT, MARKET << US, 5057, 1, 270300)
(STARFRUIT, MARKET << US, 5057, 1, 270300)
(STARFRUIT, MARKET << US, 5057, 1, 270300)
(STARFRUIT, MARKET << US, 5057, 1, 270300)","{""AMETHYSTS"": -2, ""STARFRUIT"": 0}",2405,5054,10000
270500,-4948,17457,"(AMETHYSTS, US << MARKET, 10002, 1, 270500)
(STARFRUIT, MARKET << US, 5054, 1, 270500)","{""AMETHYSTS"": -1, ""STARFRUIT"": -1}",2407,5051,9999
271200,-10106,7351,"(STARFRUIT, US << MARKET, 5053, 1, 271200)
(STARFRUIT, US << MARKET, 5053, 1, 271200)","{""AMETHYSTS"": -1, ""STARFRUIT"": 1}",2401,5050,10000
271400,20004,27355,"(AMETHYSTS, MARKET << US, 10002, 1, 271400)
(AMETHYSTS, MARKET << US, 10002, 1, 271400)","{""AMETHYSTS"": -3, ""STARFRUIT"": 1}",2397,5051,10003
271500,-60030,-32675,"(AMETHYSTS, US << MARKET, 10005, 1, 271500)
(AMETHYSTS, US << MARKET, 10005, 1, 271500)
(AMETHYSTS, US << MARKET, 10005, 1, 271500)
(AMETHYSTS, US << MARKET, 10005, 1, 271500)
(AMETHYSTS, US << MARKET, 10005, 1, 271500)
(AMETHYSTS, US << MARKET, 10005, 1, 271500)","{""AMETHYSTS"": 3, ""STARFRUIT"": 1}",2375,5050,10000
272500,-188,-32863,"(AMETHYSTS, MARKET << US, 9996, 1, 272500)
(AMETHYSTS, MARKET << US, 9996, 1, 272500)
(STARFRUIT, US << MARKET, 5045, 1, 272500)
(STARFRUIT, US << MARKET, 5045, 1, 272500)
(STARFRUIT, US << MARKET, 5045, 1, 272500)
(STARFRUIT, US << MARKET, 5045, 1, 272500)","{""AMETHYSTS"": 1, ""STARFRUIT"": 5}",2372,5047,10000
272900,5047,-27816,"(STARFRUIT, MARKET << US, 5047, 1, 272900)","{""AMETHYSTS"": 1, ""STARFRUIT"": 4}",2384,5050,10000
273100,40008,12192,"(AMETHYSTS, MARKET << US, 10002, 1, 273100)
(AMETHYSTS, MARKET << US, 10002, 1, 273100)
(AMETHYSTS, MARKET << US, 10002, 1, 273100)
(AMETHYSTS, MARKET << US, 10002, 1, 273100)","{""AMETHYSTS"": -3, ""STARFRUIT"": 4}",2379,5049,10003
273400,20184,32376,"(STARFRUIT, MARKET << US, 5046, 1, 273400)
(STARFRUIT, MARKET << US, 5046, 1, 273400)
(STARFRUIT, MARKET << US, 5046, 1, 273400)
(STARFRUIT, MARKET << US, 5046, 1, 273400)","{""AMETHYSTS"": -3, ""STARFRUIT"": 0}",2379,5049,9999
273500,-179896,-147520,"(AMETHYSTS, US << MARKET, 9995, 1, 273500)
(AMETHYSTS, US << MARKET, 9995, 1, 273500)
(AMETHYSTS, US << MARKET, 9995, 1, 273500)
(AMETHYSTS, US << MARKET, 9995, 1, 273500)
(AMETHYSTS, US << MARKET, 9995, 1, 273500)
(AMETHYSTS, US << MARKET, 9995, 1, 273500)
(AMETHYSTS, US << MARKET, 9995, 1, 273500)
(AMETHYSTS, US << MARKET, 9995, 1, 273500)
(AMETHYSTS, US << MARKET, 9995, 1, 273500)
(AMETHYSTS, US << MARKET, 9995, 1, 273500)
(AMETHYSTS, US << MARKET, 9995, 1, 273500)
(AMETHYSTS, US << MARKET, 9995, 1, 273500)
(AMETHYSTS, US << MARKET, 9995, 1, 273500)
(AMETHYSTS, US << MARKET, 9995, 1, 273500)
(AMETHYSTS, US << MARKET, 9995, 1, 273500)
(AMETHYSTS, US << MARKET, 9995, 1, 273500)
(AMETHYSTS, US << MARKET, 9995, 1, 273500)
(AMETHYSTS, US << MARKET, 9995, 1, 273500)
(AMETHYSTS, US << MARKET, 9995, 1, 273500)
(AMETHYSTS, US << MARKET, 9995, 1, 273500)
(AMETHYSTS, MARKET << US, 10002, 1, 273500)
(AMETHYSTS, MARKET << US, 10002, 1, 273500)","{""AMETHYSTS"": 15, ""STARFRUIT"": 0}",2450,5048,9998
273700,-10004,-157524,"(AMETHYSTS, US << MARKET, 10004, 1, 273700)","{""AMETHYSTS"": 16, ""STARFRUIT"": 0}",2524,5048,10003
274000,9996,-147528,"(AMETHYSTS, MARKET << US, 9996, 1, 274000)","{""AMETHYSTS"": 15, ""STARFRUIT"": 0}",2472,5047,10000
274300,9906,-137622,"(AMETHYSTS, MARKET << US, 10004, 1, 274300)
(AMETHYSTS, MARKET << US, 10004, 1, 274300)
(STARFRUIT, US << MARKET, 5051, 1, 274300)
(STARFRUIT, US << MARKET, 5051, 1, 274300)","{""AMETHYSTS"": 13, ""STARFRUIT"": 2}",2474,5048,10000
274700,20200,-117422,"(STARFRUIT, MARKET << US, 5050, 1, 274700)
(STARFRUIT, MARKET << US, 5050, 1, 274700)
(STARFRUIT, MARKET << US, 5050, 1, 274700)
(STARFRUIT, MARKET << US, 5050, 1, 274700)","{""AMETHYSTS"": 13, ""STARFRUIT"": -2}",2484,5047,10000
274900,-60164,-177586,"(AMETHYSTS, US << MARKET, 9996, 1, 274900)
(AMETHYSTS, US << MARKET, 9996, 1, 274900)
(AMETHYSTS, US << MARKET, 9996, 1, 274900)
(AMETHYSTS, US << MARKET, 9996, 1, 274900)
(STARFRUIT, US << MARKET, 5045, 1, 274900)
(STARFRUIT, US << MARKET, 5045, 1, 274900)
(STARFRUIT, US << MARKET, 5045, 1, 274900)
(STARFRUIT, US << MARKET, 5045, 1, 274900)","{""AMETHYSTS"": 17, ""STARFRUIT"": 2}",2510,5048,10000
275500,-19992,-197578,"(AMETHYSTS, US << MARKET, 9996, 1, 275500)
(AMETHYSTS, US << MARKET, 9996, 1, 275500)","{""AMETHYSTS"": 19, ""STARFRUIT"": 2}",2516,5047,10000
275600,-9998,-207576,"(AMETHYSTS, US << MARKET, 9998, 1, 275600)","{""AMETHYSTS"": 20, ""STARFRUIT"": 2}",2458,5047,9997
275700,0,-207576,,"{""AMETHYSTS"": 20, ""STARFRUIT"": 2}",2440,5048,9996
276300,5052,-202524,"(STARFRUIT, MARKET << US, 5052, 1, 276300)","{""AMETHYSTS"": 20, ""STARFRUIT"": 1}",2527,5051,10000
276800,-25225,-227749,"(STARFRUIT, US << MARKET, 5045, 1, 276800)
(STARFRUIT, US << MARKET, 5045, 1, 276800)
(STARFRUIT, US << MARKET, 5045, 1, 276800)
(STARFRUIT, US << MARKET, 5045, 1, 276800)
(STARFRUIT, US << MARKET, 5045, 1, 276800)","{""AMETHYSTS"": 20, ""STARFRUIT"": 6}",2539,5048,10000
277300,-20180,-247929,"(STARFRUIT, US << MARKET, 5045, 1, 277300)
(STARFRUIT, US << MARKET, 5045, 1, 277300)
(STARFRUIT, US << MARKET, 5045, 1, 277300)
(STARFRUIT, US << MARKET, 5045, 1, 277300)","{""AMETHYSTS"": 20, ""STARFRUIT"": 10}",2611,5048,10003
277600,5045,-242884,"(STARFRUIT, MARKET << US, 5045, 1, 277600)","{""AMETHYSTS"": 20, ""STARFRUIT"": 9}",2548,5048,10000
277800,20004,-222880,"(AMETHYSTS, MARKET << US, 10002, 1, 277800)
(AMETHYSTS, MARKET << US, 10002, 1, 277800)","{""AMETHYSTS"": 18, ""STARFRUIT"": 9}",2543,5049,9999
278000,-5148,-228028,"(AMETHYSTS, MARKET << US, 9996, 1, 278000)
(STARFRUIT, US << MARKET, 5048, 1, 278000)
(STARFRUIT, US << MARKET, 5048, 1, 278000)
(STARFRUIT, US << MARKET, 5048, 1, 278000)","{""AMETHYSTS"": 17, ""STARFRUIT"": 12}",2584,5051,10000
278100,5047,-222981,"(STARFRUIT, MARKET << US, 5047, 1, 278100)","{""AMETHYSTS"": 17, ""STARFRUIT"": 11}",2580,5051,10000
278500,-5053,-228034,"(STARFRUIT, US << MARKET, 5053, 1, 278500)","{""AMETHYSTS"": 17, ""STARFRUIT"": 12}",2532,5050,9998
278700,50111,-177923,"(AMETHYSTS, MARKET << US, 10002, 1, 278700)
(AMETHYSTS, MARKET << US, 10002, 1, 278700)
(AMETHYSTS, MARKET << US, 10002, 1, 278700)
(AMETHYSTS, MARKET << US, 10002, 1, 278700)
(STARFRUIT, US << MARKET, 5053, 1, 278700)
(STARFRUIT, MARKET << US, 5052, 1, 278700)
(STARFRUIT, MARKET << US, 5052, 1, 278700)
(STARFRUIT, MARKET << US, 5052, 1, 278700)","{""AMETHYSTS"": 13, ""STARFRUIT"": 10}",2646,5053,10003
279000,5053,-172870,"(STARFRUIT, MARKET << US, 5053, 1, 279000)","{""AMETHYSTS"": 13, ""STARFRUIT"": 9}",2580,5050,10000
279300,5049,-167821,"(STARFRUIT, MARKET << US, 5049, 1, 279300)","{""AMETHYSTS"": 13, ""STARFRUIT"": 8}",2595,5052,10000
279600,96,-167725,"(AMETHYSTS, US << MARKET, 10002, 1, 279600)
(STARFRUIT, MARKET << US, 5049, 1, 279600)
(STARFRUIT, MARKET << US, 5049, 1, 279600)","{""AMETHYSTS"": 14, ""STARFRUIT"": 6}",2623,5051,10003
280000,19992,-147733,"(AMETHYSTS, MARKET << US, 9996, 1, 280000)
(AMETHYSTS, MARKET << US, 9996, 1, 280000)","{""AMETHYSTS"": 12, ""STARFRUIT"": 6}",2579,5052,10000
280500,-30086,-177819,"(AMETHYSTS, US << MARKET, 9996, 1, 280500)
(AMETHYSTS, US << MARKET, 9996, 1, 280500)
(STARFRUIT, US << MARKET, 5047, 1, 280500)
(STARFRUIT, US << MARKET, 5047, 1, 280500)","{""AMETHYSTS"": 14, ""STARFRUIT"": 8}",2581,5050,10000
280700,5053,-172766,"(STARFRUIT, MARKET << US, 5053, 1, 280700)","{""AMETHYSTS"": 14, ""STARFRUIT"": 7}",2619,5053,10001
280800,40008,-132758,"(AMETHYSTS, MARKET << US, 10002, 1, 280800)
(AMETHYSTS, MARKET << US, 10002, 1, 280800)
(AMETHYSTS, MARKET << US, 10002, 1, 280800)
(AMETHYSTS, MARKET << US, 10002, 1, 280800)","{""AMETHYSTS"": 10, ""STARFRUIT"": 7}",2629,5051,10003
280900,25265,-107493,"(STARFRUIT, MARKET << US, 5053, 1, 280900)
(STARFRUIT, MARKET << US, 5053, 1, 280900)
(STARFRUIT, MARKET << US, 5053, 1, 280900)
(STARFRUIT, MARKET << US, 5053, 1, 280900)
(STARFRUIT, MARKET << US, 5053, 1, 280900)","{""AMETHYSTS"": 10, ""STARFRUIT"": 2}",2615,5054,10000
281200,-89982,-197475,"(AMETHYSTS, US << MARKET, 9998, 1, 281200)
(AMETHYSTS, US << MARKET, 9998, 1, 281200)
(AMETHYSTS, US << MARKET, 9998, 1, 281200)
(AMETHYSTS, US << MARKET, 9998, 1, 281200)
(AMETHYSTS, US << MARKET, 9998, 1, 281200)
(AMETHYSTS, US << MARKET, 9998, 1, 281200)
(AMETHYSTS, US << MARKET, 9998, 1, 281200)
(AMETHYSTS, US << MARKET, 9998, 1, 281200)
(AMETHYSTS, US << MARKET, 9998, 1, 281200)","{""AMETHYSTS"": 19, ""STARFRUIT"": 2}",2648,5052,10001
281300,-10106,-207581,"(STARFRUIT, US << MARKET, 5053, 1, 281300)
(STARFRUIT, US << MARKET, 5053, 1, 281300)","{""AMETHYSTS"": 19, ""STARFRUIT"": 4}",2631,5053,10000
281400,-15147,-222728,"(STARFRUIT, US << MARKET, 5049, 1, 281400)
(STARFRUIT, US << MARKET, 5049, 1, 281400)
(STARFRUIT, US << MARKET, 5049, 1, 281400)","{""AMETHYSTS"": 19, ""STARFRUIT"": 7}",2589,5048,9999
281700,25063,-197665,"(AMETHYSTS, MARKET << US, 10004, 1, 281700)
(AMETHYSTS, MARKET << US, 10004, 1, 281700)
(STARFRUIT, MARKET << US, 5055, 1, 281700)","{""AMETHYSTS"": 17, ""STARFRUIT"": 6}",2647,5052,10000
282100,-10100,-207765,"(STARFRUIT, US << MARKET, 5050, 1, 282100)
(STARFRUIT, US << MARKET, 5050, 1, 282100)","{""AMETHYSTS"": 17, ""STARFRUIT"": 8}",2627,5049,10000
282800,9998,-197767,"(AMETHYSTS, MARKET << US, 9998, 1, 282800)","{""AMETHYSTS"": 16, ""STARFRUIT"": 8}",2673,5053,10001
282900,5056,-192711,"(STARFRUIT, MARKET << US, 5056, 1, 282900)","{""AMETHYSTS"": 16, ""STARFRUIT"": 7}",2681,5056,10000
283400,5051,-187660,"(STARFRUIT, MARKET << US, 5051, 1, 283400)","{""AMETHYSTS"": 16, ""STARFRUIT"": 6}",2648,5054,9999
283500,-20208,-207868,"(STARFRUIT, US << MARKET, 5052, 1, 283500)
(STARFRUIT, US << MARKET, 5052, 1, 283500)
(STARFRUIT, US << MARKET, 5052, 1, 283500)
(STARFRUIT, US << MARKET, 5052, 1, 283500)","{""AMETHYSTS"": 16, ""STARFRUIT"": 10}",2658,5051,10001
283600,-4843,-212711,"(AMETHYSTS, US << MARKET, 10004, 1, 283600)
(AMETHYSTS, US << MARKET, 10004, 1, 283600)
(STARFRUIT, MARKET << US, 5057, 1, 283600)
(STARFRUIT, MARKET << US, 5057, 1, 283600)
(STARFRUIT, MARKET << US, 5051, 1, 283600)","{""AMETHYSTS"": 18, ""STARFRUIT"": 7}",2667,5054,10000
283700,5057,-207654,"(STARFRUIT, MARKET << US, 5057, 1, 283700)","{""AMETHYSTS"": 18, ""STARFRUIT"": 6}",2664,5053,10000
283900,-10102,-217756,"(STARFRUIT, US << MARKET, 5051, 1, 283900)
(STARFRUIT, US << MARKET, 5051, 1, 283900)","{""AMETHYSTS"": 18, ""STARFRUIT"": 8}",2694,5054,10001
284200,30342,-187414,"(STARFRUIT, MARKET << US, 5057, 1, 284200)
(STARFRUIT, MARKET << US, 5057, 1, 284200)
(STARFRUIT, MARKET << US, 5057, 1, 284200)
(STARFRUIT, MARKET << US, 5057, 1, 284200)
(STARFRUIT, MARKET << US, 5057, 1, 284200)
(STARFRUIT, MARKET << US, 5057, 1, 284200)","{""AMETHYSTS"": 18, ""STARFRUIT"": 2}",2692,5053,10000
284700,-40192,-227606,"(AMETHYSTS, US << MARKET, 9996, 1, 284700)
(AMETHYSTS, US << MARKET, 9996, 1, 284700)
(STARFRUIT, US << MARKET, 5050, 1, 284700)
(STARFRUIT, US << MARKET, 5050, 1, 284700)
(STARFRUIT, US << MARKET, 5050, 1, 284700)
(STARFRUIT, US << MARKET, 5050, 1, 284700)","{""AMETHYSTS"": 20, ""STARFRUIT"": 6}",2712,5053,10000
284800,-10100,-237706,"(STARFRUIT, US << MARKET, 5050, 1, 284800)
(STARFRUIT, US << MARKET, 5050, 1, 284800)","{""AMETHYSTS"": 20, ""STARFRUIT"": 8}",2686,5049,10000
285000,9996,-227710,"(AMETHYSTS, MARKET << US, 9996, 1, 285000)","{""AMETHYSTS"": 19, ""STARFRUIT"": 8}",2695,5053,9999
285500,-5050,-232760,"(STARFRUIT, US << MARKET, 5050, 1, 285500)","{""AMETHYSTS"": 19, ""STARFRUIT"": 9}",2773,5055,10002
285700,5051,-227709,"(STARFRUIT, MARKET << US, 5051, 1, 285700)","{""AMETHYSTS"": 19, ""STARFRUIT"": 8}",2726,5052,10001
286400,-15061,-242770,"(AMETHYSTS, US << MARKET, 10004, 1, 286400)
(STARFRUIT, US << MARKET, 5057, 1, 286400)","{""AMETHYSTS"": 20, ""STARFRUIT"": 9}",2707,5053,10000
286500,5056,-237714,"(STARFRUIT, MARKET << US, 5056, 1, 286500)","{""AMETHYSTS"": 20, ""STARFRUIT"": 8}",2702,5052,10000
286600,5058,-232656,"(STARFRUIT, MARKET << US, 5058, 1, 286600)","{""AMETHYSTS"": 20, ""STARFRUIT"": 7}",2729,5055,10000
286800,0,-232656,,"{""AMETHYSTS"": 20, ""STARFRUIT"": 7}",2655,5053,9997
287000,-5056,-237712,"(STARFRUIT, US << MARKET, 5056, 1, 287000)","{""AMETHYSTS"": 20, ""STARFRUIT"": 8}",2756,5056,10001
287200,20004,-217708,"(AMETHYSTS, MARKET << US, 10002, 1, 287200)
(AMETHYSTS, MARKET << US, 10002, 1, 287200)","{""AMETHYSTS"": 18, ""STARFRUIT"": 8}",2762,5052,10003
287900,-20188,-237896,"(STARFRUIT, US << MARKET, 5047, 1, 287900)
(STARFRUIT, US << MARKET, 5047, 1, 287900)
(STARFRUIT, US << MARKET, 5047, 1, 287900)
(STARFRUIT, US << MARKET, 5047, 1, 287900)","{""AMETHYSTS"": 18, ""STARFRUIT"": 12}",2704,5050,10000
288900,-20220,-258116,"(STARFRUIT, US << MARKET, 5055, 1, 288900)
(STARFRUIT, US << MARKET, 5055, 1, 288900)
(STARFRUIT, US << MARKET, 5055, 1, 288900)
(STARFRUIT, US << MARKET, 5055, 1, 288900)","{""AMETHYSTS"": 18, ""STARFRUIT"": 16}",2700,5051,10000
289300,20216,-237900,"(STARFRUIT, US << MARKET, 5054, 1, 289300)
(STARFRUIT, US << MARKET, 5054, 1, 289300)
(STARFRUIT, MARKET << US, 5054, 1, 289300)
(STARFRUIT, MARKET << US, 5054, 1, 289300)
(STARFRUIT, MARKET << US, 5054, 1, 289300)
(STARFRUIT, MARKET << US, 5054, 1, 289300)
(STARFRUIT, MARKET << US, 5054, 1, 289300)
(STARFRUIT, MARKET << US, 5054, 1, 289300)","{""AMETHYSTS"": 18, ""STARFRUIT"": 12}",2748,5054,10000
289600,-20200,-258100,"(STARFRUIT, US << MARKET, 5050, 1, 289600)
(STARFRUIT, US << MARKET, 5050, 1, 289600)
(STARFRUIT, US << MARKET, 5050, 1, 289600)
(STARFRUIT, US << MARKET, 5050, 1, 289600)","{""AMETHYSTS"": 18, ""STARFRUIT"": 16}",2748,5053,10000
289900,30130,-227970,"(AMETHYSTS, US << MARKET, 9995, 1, 289900)
(AMETHYSTS, US << MARKET, 9995, 1, 289900)
(AMETHYSTS, MARKET << US, 10005, 1, 289900)
(AMETHYSTS, MARKET << US, 10005, 1, 289900)
(AMETHYSTS, MARKET << US, 10005, 1, 289900)
(AMETHYSTS, MARKET << US, 10005, 1, 289900)
(STARFRUIT, MARKET << US, 5050, 1, 289900)
(STARFRUIT, MARKET << US, 5050, 1, 289900)","{""AMETHYSTS"": 16, ""STARFRUIT"": 14}",2758,5052,10000
290200,-5056,-233026,"(STARFRUIT, US << MARKET, 5056, 1, 290200)","{""AMETHYSTS"": 16, ""STARFRUIT"": 15}",2754,5052,10000
290400,-15060,-248086,"(AMETHYSTS, US << MARKET, 10004, 1, 290400)
(AMETHYSTS, US << MARKET, 10004, 1, 290400)
(AMETHYSTS, US << MARKET, 10004, 1, 290400)
(AMETHYSTS, MARKET << US, 10005, 1, 290400)
(AMETHYSTS, MARKET << US, 10005, 1, 290400)
(STARFRUIT, US << MARKET, 5058, 1, 290400)","{""AMETHYSTS"": 17, ""STARFRUIT"": 16}",2778,5054,10000
290800,-40200,-288286,"(AMETHYSTS, US << MARKET, 9998, 1, 290800)
(AMETHYSTS, US << MARKET, 9998, 1, 290800)
(STARFRUIT, US << MARKET, 5051, 1, 290800)
(STARFRUIT, US << MARKET, 5051, 1, 290800)
(STARFRUIT, US << MARKET, 5051, 1, 290800)
(STARFRUIT, US << MARKET, 5051, 1, 290800)","{""AMETHYSTS"": 19, ""STARFRUIT"": 20}",2657,5050,9997
290900,-9996,-298282,"(AMETHYSTS, US << MARKET, 9996, 1, 290900)","{""AMETHYSTS"": 20, ""STARFRUIT"": 20}",2778,5053,10000
291200,0,-298282,,"{""AMETHYSTS"": 20, ""STARFRUIT"": 20}",2758,5051,10001
291400,5049,-293233,"(STARFRUIT, MARKET << US, 5049, 1, 291400)","{""AMETHYSTS"": 20, ""STARFRUIT"": 19}",2755,5052,10000
291500,0,-293233,,"{""AMETHYSTS"": 20, ""STARFRUIT"": 19}",2755,5052,10000
291600,0,-293233,,"{""AMETHYSTS"": 20, ""STARFRUIT"": 19}",2794,5053,10001
291900,10100,-283133,"(STARFRUIT, MARKET << US, 5050, 1, 291900)
(STARFRUIT, MARKET << US, 5050, 1, 291900)","{""AMETHYSTS"": 20, ""STARFRUIT"": 17}",2700,5049,10000
292200,45504,-237629,"(STARFRUIT, MARKET << US, 5056, 1, 292200)
(STARFRUIT, MARKET << US, 5056, 1, 292200)
(STARFRUIT, MARKET << US, 5056, 1, 292200)
(STARFRUIT, MARKET << US, 5056, 1, 292200)
(STARFRUIT, MARKET << US, 5056, 1, 292200)
(STARFRUIT, MARKET << US, 5056, 1, 292200)
(STARFRUIT, MARKET << US, 5056, 1, 292200)
(STARFRUIT, MARKET << US, 5056, 1, 292200)
(STARFRUIT, MARKET << US, 5056, 1, 292200)","{""AMETHYSTS"": 20, ""STARFRUIT"": 8}",2783,5054,9999
292400,30342,-207287,"(STARFRUIT, MARKET << US, 5057, 1, 292400)
(STARFRUIT, MARKET << US, 5057, 1, 292400)
(STARFRUIT, MARKET << US, 5057, 1, 292400)
(STARFRUIT, MARKET << US, 5057, 1, 292400)
(STARFRUIT, MARKET << US, 5057, 1, 292400)
(STARFRUIT, MARKET << US, 5057, 1, 292400)","{""AMETHYSTS"": 20, ""STARFRUIT"": 2}",2839,5053,10001
292500,9998,-197289,"(AMETHYSTS, MARKET << US, 9998, 1, 292500)","{""AMETHYSTS"": 19, ""STARFRUIT"": 2}",2760,5053,9997
292600,-20118,-217407,"(AMETHYSTS, US << MARKET, 10004, 1, 292600)
(STARFRUIT, US << MARKET, 5057, 1, 292600)
(STARFRUIT, US << MARKET, 5057, 1, 292600)","{""AMETHYSTS"": 20, ""STARFRUIT"": 4}",2809,5054,10000
292800,-10112,-227519,"(STARFRUIT, US << MARKET, 5056, 1, 292800)
(STARFRUIT, US << MARKET, 5056, 1, 292800)","{""AMETHYSTS"": 20, ""STARFRUIT"": 6}",2883,5057,10003
292900,40016,-187503,"(AMETHYSTS, MARKET << US, 10004, 1, 292900)
(AMETHYSTS, MARKET << US, 10004, 1, 292900)
(AMETHYSTS, MARKET << US, 10004, 1, 292900)
(AMETHYSTS, MARKET << US, 10004, 1, 292900)","{""AMETHYSTS"": 16, ""STARFRUIT"": 6}",2815,5053,10000
293500,-25159,-212662,"(AMETHYSTS, US << MARKET, 10000, 1, 293500)
(STARFRUIT, US << MARKET, 5053, 1, 293500)
(STARFRUIT, US << MARKET, 5053, 1, 293500)
(STARFRUIT, US << MARKET, 5053, 1, 293500)
(STARFRUIT, US << MARKET, 5053, 1, 293500)
(STARFRUIT, MARKET << US, 5053, 1, 293500)","{""AMETHYSTS"": 17, ""STARFRUIT"": 9}",2772,5052,9998
293800,5053,-207609,"(STARFRUIT, MARKET << US, 5053, 1, 293800)","{""AMETHYSTS"": 17, ""STARFRUIT"": 8}",2839,5056,10000
293900,15056,-192553,"(AMETHYSTS, MARKET << US, 9998, 1, 293900)
(STARFRUIT, MARKET << US, 5058, 1, 293900)","{""AMETHYSTS"": 16, ""STARFRUIT"": 7}",2869,5058,10001
294200,-20212,-212765,"(STARFRUIT, US << MARKET, 5053, 1, 294200)
(STARFRUIT, US << MARKET, 5053, 1, 294200)
(STARFRUIT, US << MARKET, 5053, 1, 294200)
(STARFRUIT, US << MARKET, 5053, 1, 294200)","{""AMETHYSTS"": 16, ""STARFRUIT"": 11}",2839,5052,10002
294300,20098,-192667,"(AMETHYSTS, MARKET << US, 9996, 1, 294300)
(STARFRUIT, MARKET << US, 5051, 1, 294300)
(STARFRUIT, MARKET << US, 5051, 1, 294300)","{""AMETHYSTS"": 15, ""STARFRUIT"": 9}",2819,5054,10000
294400,-30015,-222682,"(AMETHYSTS, US << MARKET, 10005, 1, 294400)
(AMETHYSTS, US << MARKET, 10005, 1, 294400)
(AMETHYSTS, US << MARKET, 10005, 1, 294400)","{""AMETHYSTS"": 18, ""STARFRUIT"": 9}",2822,5056,10000
294500,9998,-212684,"(AMETHYSTS, MARKET << US, 9998, 1, 294500)","{""AMETHYSTS"": 17, ""STARFRUIT"": 9}",2742,5053,9997
294600,-20228,-232912,"(STARFRUIT, US << MARKET, 5057, 1, 294600)
(STARFRUIT, US << MARKET, 5057, 1, 294600)
(STARFRUIT, US << MARKET, 5057, 1, 294600)
(STARFRUIT, US << MARKET, 5057, 1, 294600)","{""AMETHYSTS"": 17, ""STARFRUIT"": 13}",2765,5056,9997
295000,35357,-197555,"(STARFRUIT, MARKET << US, 5051, 1, 295000)
(STARFRUIT, MARKET << US, 5051, 1, 295000)
(STARFRUIT, MARKET << US, 5051, 1, 295000)
(STARFRUIT, MARKET << US, 5051, 1, 295000)
(STARFRUIT, MARKET << US, 5051, 1, 295000)
(STARFRUIT, MARKET << US, 5051, 1, 295000)
(STARFRUIT, MARKET << US, 5051, 1, 295000)","{""AMETHYSTS"": 17, ""STARFRUIT"": 6}",2728,5050,9999
295600,-10098,-207653,"(STARFRUIT, US << MARKET, 5049, 1, 295600)
(STARFRUIT, US << MARKET, 5049, 1, 295600)","{""AMETHYSTS"": 17, ""STARFRUIT"": 8}",2695,5052,9996
296400,-29994,-237647,"(AMETHYSTS, US << MARKET, 9998, 1, 296400)
(AMETHYSTS, US << MARKET, 9998, 1, 296400)
(AMETHYSTS, US << MARKET, 9998, 1, 296400)","{""AMETHYSTS"": 20, ""STARFRUIT"": 8}",2797,5053,10001
296800,100020,-137627,"(AMETHYSTS, MARKET << US, 10002, 1, 296800)
(AMETHYSTS, MARKET << US, 10002, 1, 296800)
(AMETHYSTS, MARKET << US, 10002, 1, 296800)
(AMETHYSTS, MARKET << US, 10002, 1, 296800)
(AMETHYSTS, MARKET << US, 10002, 1, 296800)
(AMETHYSTS, MARKET << US, 10002, 1, 296800)
(AMETHYSTS, MARKET << US, 10002, 1, 296800)
(AMETHYSTS, MARKET << US, 10002, 1, 296800)
(AMETHYSTS, MARKET << US, 10002, 1, 296800)
(AMETHYSTS, MARKET << US, 10002, 1, 296800)","{""AMETHYSTS"": 10, ""STARFRUIT"": 8}",2819,5052,10003
297100,-20104,-157731,"(AMETHYSTS, US << MARKET, 10004, 1, 297100)
(STARFRUIT, US << MARKET, 5050, 1, 297100)
(STARFRUIT, US << MARKET, 5050, 1, 297100)","{""AMETHYSTS"": 11, ""STARFRUIT"": 10}",2799,5053,10000
297600,29910,-127821,"(AMETHYSTS, MARKET << US, 10002, 1, 297600)
(AMETHYSTS, MARKET << US, 10002, 1, 297600)
(AMETHYSTS, MARKET << US, 10002, 1, 297600)
(AMETHYSTS, MARKET << US, 10002, 1, 297600)
(STARFRUIT, US << MARKET, 5049, 1, 297600)
(STARFRUIT, US << MARKET, 5049, 1, 297600)","{""AMETHYSTS"": 7, ""STARFRUIT"": 12}",2824,5052,10003
298400,-19996,-147817,"(AMETHYSTS, US << MARKET, 9998, 1, 298400)
(AMETHYSTS, US << MARKET, 9998, 1, 298400)","{""AMETHYSTS"": 9, ""STARFRUIT"": 12}",2756,5050,9997
298700,-20180,-167997,"(STARFRUIT, US << MARKET, 5045, 1, 298700)
(STARFRUIT, US << MARKET, 5045, 1, 298700)
(STARFRUIT, US << MARKET, 5045, 1, 298700)
(STARFRUIT, US << MARKET, 5045, 1, 298700)","{""AMETHYSTS"": 9, ""STARFRUIT"": 16}",2780,5048,10001
298900,-14945,-182942,"(AMETHYSTS, US << MARKET, 9995, 1, 298900)
(AMETHYSTS, US << MARKET, 9995, 1, 298900)
(STARFRUIT, MARKET << US, 5045, 1, 298900)","{""AMETHYSTS"": 11, ""STARFRUIT"": 15}",2763,5047,10000
299200,-69972,-252914,"(AMETHYSTS, US << MARKET, 9996, 1, 299200)
(AMETHYSTS, US << MARKET, 9996, 1, 299200)
(AMETHYSTS, US << MARKET, 9996, 1, 299200)
(AMETHYSTS, US << MARKET, 9996, 1, 299200)
(AMETHYSTS, US << MARKET, 9996, 1, 299200)
(AMETHYSTS, US << MARKET, 9996, 1, 299200)
(AMETHYSTS, US << MARKET, 9996, 1, 299200)
(AMETHYSTS, US << MARKET, 9996, 1, 299200)
(AMETHYSTS, US << MARKET, 9996, 1, 299200)
(AMETHYSTS, MARKET << US, 9996, 1, 299200)
(AMETHYSTS, MARKET << US, 9996, 1, 299200)","{""AMETHYSTS"": 18, ""STARFRUIT"": 15}",2821,5049,10000
299400,-35133,-288047,"(AMETHYSTS, US << MARKET, 9996, 1, 299400)
(AMETHYSTS, US << MARKET, 9996, 1, 299400)
(STARFRUIT, US << MARKET, 5047, 1, 299400)
(STARFRUIT, US << MARKET, 5047, 1, 299400)
(STARFRUIT, US << MARKET, 5047, 1, 299400)","{""AMETHYSTS"": 20, ""STARFRUIT"": 18}",2815,5049,9999
299500,-10100,-298147,"(STARFRUIT, US << MARKET, 5050, 1, 299500)
(STARFRUIT, US << MARKET, 5050, 1, 299500)","{""AMETHYSTS"": 20, ""STARFRUIT"": 20}",2753,5048,9997
299600,0,-298147,,"{""AMETHYSTS"": 20, ""STARFRUIT"": 20}",2853,5050,10000
299700,10098,-288049,"(STARFRUIT, MARKET << US, 5049, 1, 299700)
(STARFRUIT, MARKET << US, 5049, 1, 299700)","{""AMETHYSTS"": 20, ""STARFRUIT"": 18}",2815,5048,10000
299800,14954,-273095,"(AMETHYSTS, MARKET << US, 10004, 1, 299800)
(AMETHYSTS, MARKET << US, 10004, 1, 299800)
(STARFRUIT, US << MARKET, 5054, 1, 299800)","{""AMETHYSTS"": 18, ""STARFRUIT"": 19}",2801,5050,9997
299900,-25040,-298135,"(AMETHYSTS, US << MARKET, 9996, 1, 299900)
(AMETHYSTS, US << MARKET, 9996, 1, 299900)
(STARFRUIT, US << MARKET, 5048, 1, 299900)","{""AMETHYSTS"": 20, ""STARFRUIT"": 20}",2805,5050,9997
300300,0,-298135,,"{""AMETHYSTS"": 20, ""STARFRUIT"": 20}",2885,5051,10000
300400,15144,-282991,"(STARFRUIT, MARKET << US, 5048, 1, 300400)
(STARFRUIT, MARKET << US, 5048, 1, 300400)
(STARFRUIT, MARKET << US, 5048, 1, 300400)","{""AMETHYSTS"": 20, ""STARFRUIT"": 17}",2876,5051,10000
300700,-5054,-288045,"(STARFRUIT, US << MARKET, 5054, 1, 300700)","{""AMETHYSTS"": 20, ""STARFRUIT"": 18}",2855,5050,10000
300800,5049,-282996,"(STARFRUIT, MARKET << US, 5049, 1, 300800)","{""AMETHYSTS"": 20, ""STARFRUIT"": 17}",2888,5052,10000
301200,65488,-217508,"(AMETHYSTS, MARKET << US, 10004, 1, 301200)
(AMETHYSTS, MARKET << US, 10004, 1, 301200)
(STARFRUIT, MARKET << US, 5054, 1, 301200)
(STARFRUIT, MARKET << US, 5054, 1, 301200)
(STARFRUIT, MARKET << US, 5054, 1, 301200)
(STARFRUIT, MARKET << US, 5053, 1, 301200)
(STARFRUIT, MARKET << US, 5053, 1, 301200)
(STARFRUIT, MARKET << US, 5053, 1, 301200)
(STARFRUIT, MARKET << US, 5053, 1, 301200)
(STARFRUIT, MARKET << US, 5053, 1, 301200)
(STARFRUIT, MARKET << US, 5053, 1, 301200)","{""AMETHYSTS"": 18, ""STARFRUIT"": 8}",2924,5054,10000
301800,30282,-187226,"(STARFRUIT, MARKET << US, 5047, 1, 301800)
(STARFRUIT, MARKET << US, 5047, 1, 301800)
(STARFRUIT, MARKET << US, 5047, 1, 301800)
(STARFRUIT, MARKET << US, 5047, 1, 301800)
(STARFRUIT, MARKET << US, 5047, 1, 301800)
(STARFRUIT, MARKET << US, 5047, 1, 301800)","{""AMETHYSTS"": 18, ""STARFRUIT"": 2}",2928,5050,10003
301900,-10002,-197228,"(AMETHYSTS, US << MARKET, 10002, 1, 301900)","{""AMETHYSTS"": 19, ""STARFRUIT"": 2}",2927,5049,10003
302100,-9998,-207226,"(AMETHYSTS, US << MARKET, 9998, 1, 302100)","{""AMETHYSTS"": 20, ""STARFRUIT"": 2}",2896,5051,10001
302400,-10094,-217320,"(STARFRUIT, US << MARKET, 5047, 1, 302400)
(STARFRUIT, US << MARKET, 5047, 1, 302400)","{""AMETHYSTS"": 20, ""STARFRUIT"": 4}",2884,5051,10000
302600,9998,-207322,"(AMETHYSTS, MARKET << US, 9998, 1, 302600)","{""AMETHYSTS"": 19, ""STARFRUIT"": 4}",2821,5050,9997
302700,-9998,-217320,"(AMETHYSTS, US << MARKET, 9998, 1, 302700)","{""AMETHYSTS"": 20, ""STARFRUIT"": 4}",2800,5050,9996
303000,0,-217320,,"{""AMETHYSTS"": 20, ""STARFRUIT"": 4}",2908,5052,10001
303100,-100,-217420,"(AMETHYSTS, MARKET << US, 9998, 1, 303100)
(STARFRUIT, US << MARKET, 5049, 1, 303100)
(STARFRUIT, US << MARKET, 5049, 1, 303100)","{""AMETHYSTS"": 19, ""STARFRUIT"": 6}",2911,5052,10001
303500,-20216,-237636,"(STARFRUIT, US << MARKET, 5054, 1, 303500)
(STARFRUIT, US << MARKET, 5054, 1, 303500)
(STARFRUIT, US << MARKET, 5054, 1, 303500)
(STARFRUIT, US << MARKET, 5054, 1, 303500)","{""AMETHYSTS"": 19, ""STARFRUIT"": 10}",2914,5055,10000
303900,9998,-227638,"(AMETHYSTS, MARKET << US, 9998, 1, 303900)","{""AMETHYSTS"": 18, ""STARFRUIT"": 10}",2838,5053,9997
304400,-5054,-232692,"(STARFRUIT, US << MARKET, 5054, 1, 304400)","{""AMETHYSTS"": 18, ""STARFRUIT"": 11}",2902,5054,10000
304600,-5052,-237744,"(STARFRUIT, US << MARKET, 5052, 1, 304600)","{""AMETHYSTS"": 18, ""STARFRUIT"": 12}",2820,5050,9998
305100,-10002,-247746,"(AMETHYSTS, US << MARKET, 10002, 1, 305100)","{""AMETHYSTS"": 19, ""STARFRUIT"": 12}",2935,5052,10003
305200,20004,-227742,"(AMETHYSTS, MARKET << US, 10002, 1, 305200)
(AMETHYSTS, MARKET << US, 10002, 1, 305200)","{""AMETHYSTS"": 17, ""STARFRUIT"": 12}",2945,5053,10003
305300,-29994,-257736,"(AMETHYSTS, US << MARKET, 9998, 1, 305300)
(AMETHYSTS, US << MARKET, 9998, 1, 305300)
(AMETHYSTS, US << MARKET, 9998, 1, 305300)","{""AMETHYSTS"": 20, ""STARFRUIT"": 12}",2828,5052,9997
305500,-20212,-277948,"(STARFRUIT, US << MARKET, 5053, 1, 305500)
(STARFRUIT, US << MARKET, 5053, 1, 305500)
(STARFRUIT, US << MARKET, 5053, 1, 305500)
(STARFRUIT, US << MARKET, 5053, 1, 305500)","{""AMETHYSTS"": 20, ""STARFRUIT"": 16}",2808,5051,9997
305700,15157,-262791,"(STARFRUIT, US << MARKET, 5051, 1, 305700)
(STARFRUIT, MARKET << US, 5052, 1, 305700)
(STARFRUIT, MARKET << US, 5052, 1, 305700)
(STARFRUIT, MARKET << US, 5052, 1, 305700)
(STARFRUIT, MARKET << US, 5052, 1, 305700)","{""AMETHYSTS"": 20, ""STARFRUIT"": 13}",2859,5050,10000
305900,15039,-247752,"(AMETHYSTS, MARKET << US, 9996, 1, 305900)
(STARFRUIT, US << MARKET, 5055, 1, 305900)
(STARFRUIT, MARKET << US, 5049, 1, 305900)
(STARFRUIT, MARKET << US, 5049, 1, 305900)","{""AMETHYSTS"": 19, ""STARFRUIT"": 12}",2860,5051,10000
306100,34963,-212789,"(AMETHYSTS, MARKET << US, 10005, 1, 306100)
(AMETHYSTS, MARKET << US, 10005, 1, 306100)
(AMETHYSTS, MARKET << US, 10005, 1, 306100)
(AMETHYSTS, MARKET << US, 10004, 1, 306100)
(STARFRUIT, US << MARKET, 5056, 1, 306100)","{""AMETHYSTS"": 15, ""STARFRUIT"": 13}",2887,5052,10000
306500,19992,-192797,"(AMETHYSTS, MARKET << US, 9996, 1, 306500)
(AMETHYSTS, MARKET << US, 9996, 1, 306500)","{""AMETHYSTS"": 13, ""STARFRUIT"": 13}",2853,5050,10000
306800,35322,-157475,"(STARFRUIT, MARKET << US, 5046, 1, 306800)
(STARFRUIT, MARKET << US, 5046, 1, 306800)
(STARFRUIT, MARKET << US, 5046, 1, 306800)
(STARFRUIT, MARKET << US, 5046, 1, 306800)
(STARFRUIT, MARKET << US, 5046, 1, 306800)
(STARFRUIT, MARKET << US, 5046, 1, 306800)
(STARFRUIT, MARKET << US, 5046, 1, 306800)","{""AMETHYSTS"": 13, ""STARFRUIT"": 6}",2813,5048,10000
307000,-59988,-217463,"(AMETHYSTS, US << MARKET, 9998, 1, 307000)
(AMETHYSTS, US << MARKET, 9998, 1, 307000)
(AMETHYSTS, US << MARKET, 9998, 1, 307000)
(AMETHYSTS, US << MARKET, 9998, 1, 307000)
(AMETHYSTS, US << MARKET, 9998, 1, 307000)
(AMETHYSTS, US << MARKET, 9998, 1, 307000)","{""AMETHYSTS"": 19, ""STARFRUIT"": 6}",2850,5049,10001
307200,95,-217368,"(AMETHYSTS, US << MARKET, 9995, 1, 307200)
(STARFRUIT, MARKET << US, 5045, 1, 307200)
(STARFRUIT, MARKET << US, 5045, 1, 307200)","{""AMETHYSTS"": 20, ""STARFRUIT"": 4}",2828,5049,10000
307300,-20196,-237564,"(STARFRUIT, US << MARKET, 5049, 1, 307300)
(STARFRUIT, US << MARKET, 5049, 1, 307300)
(STARFRUIT, US << MARKET, 5049, 1, 307300)
(STARFRUIT, US << MARKET, 5049, 1, 307300)","{""AMETHYSTS"": 20, ""STARFRUIT"": 8}",2752,5047,9997
307500,-5051,-242615,"(STARFRUIT, US << MARKET, 5051, 1, 307500)","{""AMETHYSTS"": 20, ""STARFRUIT"": 9}",2813,5052,9998
307700,5045,-237570,"(STARFRUIT, MARKET << US, 5045, 1, 307700)","{""AMETHYSTS"": 20, ""STARFRUIT"": 8}",2834,5048,10001
308500,-5050,-242620,"(STARFRUIT, US << MARKET, 5050, 1, 308500)","{""AMETHYSTS"": 20, ""STARFRUIT"": 9}",2839,5051,10000
308600,5045,-237575,"(STARFRUIT, MARKET << US, 5045, 1, 308600)","{""AMETHYSTS"": 20, ""STARFRUIT"": 8}",2797,5044,10001
308900,-20172,-257747,"(STARFRUIT, US << MARKET, 5043, 1, 308900)
(STARFRUIT, US << MARKET, 5043, 1, 308900)
(STARFRUIT, US << MARKET, 5043, 1, 308900)
(STARFRUIT, US << MARKET, 5043, 1, 308900)","{""AMETHYSTS"": 20, ""STARFRUIT"": 12}",2817,5047,10000
309000,-5044,-262791,"(STARFRUIT, US << MARKET, 5044, 1, 309000)","{""AMETHYSTS"": 20, ""STARFRUIT"": 13}",2807,5046,10000
309200,-10094,-272885,"(STARFRUIT, US << MARKET, 5047, 1, 309200)
(STARFRUIT, US << MARKET, 5047, 1, 309200)","{""AMETHYSTS"": 20, ""STARFRUIT"": 15}",2745,5046,9997
309300,9998,-262887,"(AMETHYSTS, MARKET << US, 9998, 1, 309300)","{""AMETHYSTS"": 19, ""STARFRUIT"": 15}",2803,5046,10000
309400,25054,-237833,"(AMETHYSTS, MARKET << US, 10002, 1, 309400)
(AMETHYSTS, MARKET << US, 10002, 1, 309400)
(STARFRUIT, MARKET << US, 5050, 1, 309400)","{""AMETHYSTS"": 17, ""STARFRUIT"": 14}",2918,5050,10003
309800,20004,-217829,"(AMETHYSTS, MARKET << US, 10002, 1, 309800)
(AMETHYSTS, MARKET << US, 10002, 1, 309800)","{""AMETHYSTS"": 15, ""STARFRUIT"": 14}",2902,5049,10003
310000,-10002,-227831,"(AMETHYSTS, US << MARKET, 10002, 1, 310000)","{""AMETHYSTS"": 16, ""STARFRUIT"": 14}",2889,5048,10003
310100,5050,-222781,"(STARFRUIT, MARKET << US, 5050, 1, 310100)","{""AMETHYSTS"": 16, ""STARFRUIT"": 13}",2830,5047,10000
310500,-19996,-242777,"(AMETHYSTS, US << MARKET, 9998, 1, 310500)
(AMETHYSTS, US << MARKET, 9998, 1, 310500)","{""AMETHYSTS"": 18, ""STARFRUIT"": 13}",2806,5049,9997
310700,15150,-227627,"(STARFRUIT, MARKET << US, 5050, 1, 310700)
(STARFRUIT, MARKET << US, 5050, 1, 310700)
(STARFRUIT, MARKET << US, 5050, 1, 310700)","{""AMETHYSTS"": 18, ""STARFRUIT"": 10}",2883,5051,10000
310800,-5050,-232677,"(STARFRUIT, US << MARKET, 5050, 1, 310800)","{""AMETHYSTS"": 18, ""STARFRUIT"": 11}",2884,5051,10000
310900,5046,-227631,"(STARFRUIT, MARKET << US, 5046, 1, 310900)","{""AMETHYSTS"": 18, ""STARFRUIT"": 10}",2837,5045,10001
311000,9998,-217633,"(AMETHYSTS, MARKET << US, 9998, 1, 311000)","{""AMETHYSTS"": 17, ""STARFRUIT"": 10}",2796,5048,9997
311100,-5050,-222683,"(STARFRUIT, US << MARKET, 5050, 1, 311100)","{""AMETHYSTS"": 17, ""STARFRUIT"": 11}",2878,5051,10000
311300,-5047,-227730,"(STARFRUIT, US << MARKET, 5047, 1, 311300)","{""AMETHYSTS"": 17, ""STARFRUIT"": 12}",2822,5046,10000
311600,30282,-197448,"(STARFRUIT, MARKET << US, 5048, 1, 311600)
(STARFRUIT, MARKET << US, 5048, 1, 311600)
(STARFRUIT, MARKET << US, 5048, 1, 311600)
(STARFRUIT, MARKET << US, 5046, 1, 311600)
(STARFRUIT, MARKET << US, 5046, 1, 311600)
(STARFRUIT, MARKET << US, 5046, 1, 311600)","{""AMETHYSTS"": 17, ""STARFRUIT"": 6}",2788,5045,9998
311700,5045,-192403,"(STARFRUIT, MARKET << US, 5045, 1, 311700)","{""AMETHYSTS"": 17, ""STARFRUIT"": 5}",2820,5048,9999
311800,20004,-172399,"(AMETHYSTS, MARKET << US, 10002, 1, 311800)
(AMETHYSTS, MARKET << US, 10002, 1, 311800)","{""AMETHYSTS"": 15, ""STARFRUIT"": 5}",2826,5048,9999
312100,-10090,-182489,"(STARFRUIT, US << MARKET, 5045, 1, 312100)
(STARFRUIT, US << MARKET, 5045, 1, 312100)","{""AMETHYSTS"": 15, ""STARFRUIT"": 7}",2840,5047,10000
312300,15041,-167448,"(AMETHYSTS, MARKET << US, 9996, 1, 312300)
(STARFRUIT, MARKET << US, 5045, 1, 312300)","{""AMETHYSTS"": 14, ""STARFRUIT"": 6}",2826,5048,9999
312400,-19996,-187444,"(AMETHYSTS, US << MARKET, 9998, 1, 312400)
(AMETHYSTS, US << MARKET, 9998, 1, 312400)","{""AMETHYSTS"": 16, ""STARFRUIT"": 6}",2774,5047,9996
312500,15155,-172289,"(STARFRUIT, US << MARKET, 5045, 1, 312500)
(STARFRUIT, US << MARKET, 5045, 1, 312500)
(STARFRUIT, MARKET << US, 5049, 1, 312500)
(STARFRUIT, MARKET << US, 5049, 1, 312500)
(STARFRUIT, MARKET << US, 5049, 1, 312500)
(STARFRUIT, MARKET << US, 5049, 1, 312500)
(STARFRUIT, MARKET << US, 5049, 1, 312500)","{""AMETHYSTS"": 16, ""STARFRUIT"": 3}",2849,5046,10000
312700,5051,-167238,"(STARFRUIT, MARKET << US, 5051, 1, 312700)","{""AMETHYSTS"": 16, ""STARFRUIT"": 2}",2842,5048,9999
313500,160064,-7174,"(AMETHYSTS, MARKET << US, 10004, 1, 313500)
(AMETHYSTS, MARKET << US, 10004, 1, 313500)
(AMETHYSTS, MARKET << US, 10004, 1, 313500)
(AMETHYSTS, MARKET << US, 10004, 1, 313500)
(AMETHYSTS, MARKET << US, 10004, 1, 313500)
(AMETHYSTS, MARKET << US, 10004, 1, 313500)
(AMETHYSTS, MARKET << US, 10004, 1, 313500)
(AMETHYSTS, MARKET << US, 10004, 1, 313500)
(AMETHYSTS, MARKET << US, 10004, 1, 313500)
(AMETHYSTS, MARKET << US, 10004, 1, 313500)
(AMETHYSTS, MARKET << US, 10004, 1, 313500)
(AMETHYSTS, MARKET << US, 10004, 1, 313500)
(AMETHYSTS, MARKET << US, 10004, 1, 313500)
(AMETHYSTS, MARKET << US, 10004, 1, 313500)
(AMETHYSTS, MARKET << US, 10004, 1, 313500)
(AMETHYSTS, MARKET << US, 10004, 1, 313500)","{""AMETHYSTS"": 0, ""STARFRUIT"": 2}",2916,5045,10000
314200,-10176,-17350,"(AMETHYSTS, MARKET << US, 9996, 1, 314200)
(STARFRUIT, US << MARKET, 5043, 1, 314200)
(STARFRUIT, US << MARKET, 5043, 1, 314200)
(STARFRUIT, US << MARKET, 5043, 1, 314200)
(STARFRUIT, US << MARKET, 5043, 1, 314200)","{""AMETHYSTS"": -1, ""STARFRUIT"": 6}",2927,5046,9999
314400,-30080,-47430,"(AMETHYSTS, US << MARKET, 9996, 1, 314400)
(AMETHYSTS, US << MARKET, 9996, 1, 314400)
(STARFRUIT, US << MARKET, 5044, 1, 314400)
(STARFRUIT, US << MARKET, 5044, 1, 314400)","{""AMETHYSTS"": 1, ""STARFRUIT"": 8}",2946,5047,10000
314800,-40008,-87438,"(AMETHYSTS, US << MARKET, 10002, 1, 314800)
(AMETHYSTS, US << MARKET, 10002, 1, 314800)
(AMETHYSTS, US << MARKET, 10002, 1, 314800)
(AMETHYSTS, US << MARKET, 10002, 1, 314800)","{""AMETHYSTS"": 5, ""STARFRUIT"": 8}",2953,5047,10003
314900,-14949,-102387,"(AMETHYSTS, US << MARKET, 9996, 1, 314900)
(AMETHYSTS, US << MARKET, 9996, 1, 314900)
(STARFRUIT, MARKET << US, 5043, 1, 314900)","{""AMETHYSTS"": 7, ""STARFRUIT"": 7}",2928,5046,9999
315100,4955,-97432,"(AMETHYSTS, MARKET << US, 9998, 1, 315100)
(STARFRUIT, US << MARKET, 5043, 1, 315100)","{""AMETHYSTS"": 6, ""STARFRUIT"": 8}",2942,5046,10001
315200,30294,-67138,"(STARFRUIT, MARKET << US, 5049, 1, 315200)
(STARFRUIT, MARKET << US, 5049, 1, 315200)
(STARFRUIT, MARKET << US, 5049, 1, 315200)
(STARFRUIT, MARKET << US, 5049, 1, 315200)
(STARFRUIT, MARKET << US, 5049, 1, 315200)
(STARFRUIT, MARKET << US, 5049, 1, 315200)","{""AMETHYSTS"": 6, ""STARFRUIT"": 2}",2936,5046,9997
315800,20188,-46950,"(STARFRUIT, MARKET << US, 5047, 1, 315800)
(STARFRUIT, MARKET << US, 5047, 1, 315800)
(STARFRUIT, MARKET << US, 5047, 1, 315800)
(STARFRUIT, MARKET << US, 5047, 1, 315800)","{""AMETHYSTS"": 6, ""STARFRUIT"": -2}",2958,5046,10000
316000,5048,-41902,"(STARFRUIT, MARKET << US, 5048, 1, 316000)","{""AMETHYSTS"": 6, ""STARFRUIT"": -3}",2954,5048,10000
316400,45244,3342,"(AMETHYSTS, MARKET << US, 10002, 1, 316400)
(AMETHYSTS, MARKET << US, 10002, 1, 316400)
(STARFRUIT, MARKET << US, 5048, 1, 316400)
(STARFRUIT, MARKET << US, 5048, 1, 316400)
(STARFRUIT, MARKET << US, 5048, 1, 316400)
(STARFRUIT, MARKET << US, 5048, 1, 316400)
(STARFRUIT, MARKET << US, 5048, 1, 316400)","{""AMETHYSTS"": 4, ""STARFRUIT"": -8}",2962,5049,10003
316600,-60160,-56818,"(AMETHYSTS, US << MARKET, 9996, 1, 316600)
(AMETHYSTS, US << MARKET, 9996, 1, 316600)
(AMETHYSTS, US << MARKET, 9996, 1, 316600)
(AMETHYSTS, US << MARKET, 9996, 1, 316600)
(STARFRUIT, US << MARKET, 5044, 1, 316600)
(STARFRUIT, US << MARKET, 5044, 1, 316600)
(STARFRUIT, US << MARKET, 5044, 1, 316600)
(STARFRUIT, US << MARKET, 5044, 1, 316600)","{""AMETHYSTS"": 8, ""STARFRUIT"": -4}",2970,5047,9997
317000,15049,-41769,"(AMETHYSTS, MARKET << US, 9998, 1, 317000)
(STARFRUIT, MARKET << US, 5051, 1, 317000)","{""AMETHYSTS"": 7, ""STARFRUIT"": -5}",2970,5048,9997
317100,-10090,-51859,"(STARFRUIT, US << MARKET, 5045, 1, 317100)
(STARFRUIT, US << MARKET, 5045, 1, 317100)","{""AMETHYSTS"": 7, ""STARFRUIT"": -3}",2986,5047,9998
317200,5046,-46813,"(STARFRUIT, MARKET << US, 5046, 1, 317200)","{""AMETHYSTS"": 7, ""STARFRUIT"": -4}",2993,5045,9998
317300,9998,-36815,"(AMETHYSTS, MARKET << US, 9998, 1, 317300)","{""AMETHYSTS"": 6, ""STARFRUIT"": -4}",2969,5048,9996
317400,-25236,-62051,"(STARFRUIT, US << MARKET, 5046, 1, 317400)
(STARFRUIT, US << MARKET, 5046, 1, 317400)
(STARFRUIT, US << MARKET, 5048, 1, 317400)
(STARFRUIT, US << MARKET, 5048, 1, 317400)
(STARFRUIT, US << MARKET, 5048, 1, 317400)","{""AMETHYSTS"": 6, ""STARFRUIT"": 1}",2988,5045,9999
317500,5051,-57000,"(STARFRUIT, MARKET << US, 5051, 1, 317500)","{""AMETHYSTS"": 6, ""STARFRUIT"": 0}",3000,5048,10000
317900,5050,-51950,"(STARFRUIT, MARKET << US, 5050, 1, 317900)","{""AMETHYSTS"": 6, ""STARFRUIT"": -1}",2999,5051,10000
318500,5047,-46903,"(STARFRUIT, US << MARKET, 5050, 1, 318500)
(STARFRUIT, US << MARKET, 5050, 1, 318500)
(STARFRUIT, MARKET << US, 5049, 1, 318500)
(STARFRUIT, MARKET << US, 5049, 1, 318500)
(STARFRUIT, MARKET << US, 5049, 1, 318500)","{""AMETHYSTS"": 6, ""STARFRUIT"": -2}",2999,5046,9999
318600,-184,-47087,"(AMETHYSTS, MARKET << US, 9996, 1, 318600)
(AMETHYSTS, MARKET << US, 9996, 1, 318600)
(STARFRUIT, US << MARKET, 5044, 1, 318600)
(STARFRUIT, US << MARKET, 5044, 1, 318600)
(STARFRUIT, US << MARKET, 5044, 1, 318600)
(STARFRUIT, US << MARKET, 5044, 1, 318600)","{""AMETHYSTS"": 4, ""STARFRUIT"": 2}",3007,5047,10000
319000,5050,-42037,"(STARFRUIT, MARKET << US, 5050, 1, 319000)","{""AMETHYSTS"": 4, ""STARFRUIT"": 1}",3013,5050,10000
319300,-19992,-62029,"(AMETHYSTS, US << MARKET, 9996, 1, 319300)
(AMETHYSTS, US << MARKET, 9996, 1, 319300)","{""AMETHYSTS"": 6, ""STARFRUIT"": 1}",3013,5048,9999
319500,160032,98003,"(AMETHYSTS, MARKET << US, 10002, 1, 319500)
(AMETHYSTS, MARKET << US, 10002, 1, 319500)
(AMETHYSTS, MARKET << US, 10002, 1, 319500)
(AMETHYSTS, MARKET << US, 10002, 1, 319500)
(AMETHYSTS, MARKET << US, 10002, 1, 319500)
(AMETHYSTS, MARKET << US, 10002, 1, 319500)
(AMETHYSTS, MARKET << US, 10002, 1, 319500)
(AMETHYSTS, MARKET << US, 10002, 1, 319500)
(AMETHYSTS, MARKET << US, 10002, 1, 319500)
(AMETHYSTS, MARKET << US, 10002, 1, 319500)
(AMETHYSTS, MARKET << US, 10002, 1, 319500)
(AMETHYSTS, MARKET << US, 10002, 1, 319500)
(AMETHYSTS, MARKET << US, 10002, 1, 319500)
(AMETHYSTS, MARKET << US, 10002, 1, 319500)
(AMETHYSTS, MARKET << US, 10002, 1, 319500)
(AMETHYSTS, MARKET << US, 10002, 1, 319500)","{""AMETHYSTS"": -10, ""STARFRUIT"": 1}",3061,5048,9999
319800,15138,113141,"(STARFRUIT, MARKET << US, 5046, 1, 319800)
(STARFRUIT, MARKET << US, 5046, 1, 319800)
(STARFRUIT, MARKET << US, 5046, 1, 319800)","{""AMETHYSTS"": -10, ""STARFRUIT"": -2}",3041,5045,10001
320000,20004,133145,"(AMETHYSTS, MARKET << US, 10002, 1, 320000)
(AMETHYSTS, MARKET << US, 10002, 1, 320000)","{""AMETHYSTS"": -12, ""STARFRUIT"": -2}",3013,5048,10003
320100,-20010,113135,"(AMETHYSTS, US << MARKET, 10005, 1, 320100)
(AMETHYSTS, US << MARKET, 10005, 1, 320100)","{""AMETHYSTS"": -10, ""STARFRUIT"": -2}",3011,5047,10003
320300,20004,133139,"(AMETHYSTS, MARKET << US, 10002, 1, 320300)
(AMETHYSTS, MARKET << US, 10002, 1, 320300)","{""AMETHYSTS"": -12, ""STARFRUIT"": -2}",3059,5046,9999
320600,-92,133047,"(AMETHYSTS, MARKET << US, 9996, 1, 320600)
(STARFRUIT, US << MARKET, 5044, 1, 320600)
(STARFRUIT, US << MARKET, 5044, 1, 320600)","{""AMETHYSTS"": -13, ""STARFRUIT"": 0}",3047,5046,10000
320900,5044,138091,"(STARFRUIT, MARKET << US, 5044, 1, 320900)","{""AMETHYSTS"": -13, ""STARFRUIT"": -1}",3044,5047,10000
321000,5043,143134,"(STARFRUIT, MARKET << US, 5043, 1, 321000)","{""AMETHYSTS"": -13, ""STARFRUIT"": -2}",3042,5046,10000
321200,-19996,123138,"(AMETHYSTS, US << MARKET, 9998, 1, 321200)
(AMETHYSTS, US << MARKET, 9998, 1, 321200)","{""AMETHYSTS"": -11, ""STARFRUIT"": -2}",3035,5046,10001
321500,-10002,113136,"(AMETHYSTS, US << MARKET, 10002, 1, 321500)","{""AMETHYSTS"": -10, ""STARFRUIT"": -2}",3016,5045,10003
321600,-19996,93140,"(AMETHYSTS, US << MARKET, 9998, 1, 321600)
(AMETHYSTS, US << MARKET, 9998, 1, 321600)","{""AMETHYSTS"": -8, ""STARFRUIT"": -2}",3080,5046,9996
321700,40008,133148,"(AMETHYSTS, MARKET << US, 10002, 1, 321700)
(AMETHYSTS, MARKET << US, 10002, 1, 321700)
(AMETHYSTS, MARKET << US, 10002, 1, 321700)
(AMETHYSTS, MARKET << US, 10002, 1, 321700)","{""AMETHYSTS"": -12, ""STARFRUIT"": -2}",3054,5047,10000
322400,10086,143234,"(STARFRUIT, MARKET << US, 5043, 1, 322400)
(STARFRUIT, MARKET << US, 5043, 1, 322400)","{""AMETHYSTS"": -12, ""STARFRUIT"": -4}",3054,5045,10000
322600,30098,173332,"(AMETHYSTS, MARKET << US, 10002, 1, 322600)
(AMETHYSTS, MARKET << US, 10002, 1, 322600)
(STARFRUIT, MARKET << US, 5047, 1, 322600)
(STARFRUIT, MARKET << US, 5047, 1, 322600)","{""AMETHYSTS"": -14, ""STARFRUIT"": -6}",3002,5048,10003
322700,-40344,132988,"(STARFRUIT, US << MARKET, 5043, 1, 322700)
(STARFRUIT, US << MARKET, 5043, 1, 322700)
(STARFRUIT, US << MARKET, 5043, 1, 322700)
(STARFRUIT, US << MARKET, 5043, 1, 322700)
(STARFRUIT, US << MARKET, 5043, 1, 322700)
(STARFRUIT, US << MARKET, 5043, 1, 322700)
(STARFRUIT, US << MARKET, 5043, 1, 322700)
(STARFRUIT, US << MARKET, 5043, 1, 322700)","{""AMETHYSTS"": -14, ""STARFRUIT"": 2}",3080,5046,10000
322900,29818,162806,"(AMETHYSTS, MARKET << US, 9998, 1, 322900)
(AMETHYSTS, MARKET << US, 9998, 1, 322900)
(AMETHYSTS, MARKET << US, 9998, 1, 322900)
(AMETHYSTS, MARKET << US, 9998, 1, 322900)
(AMETHYSTS, MARKET << US, 9998, 1, 322900)
(STARFRUIT, US << MARKET, 5043, 1, 322900)
(STARFRUIT, US << MARKET, 5043, 1, 322900)
(STARFRUIT, US << MARKET, 5043, 1, 322900)
(STARFRUIT, US << MARKET, 5043, 1, 322900)","{""AMETHYSTS"": -19, ""STARFRUIT"": 6}",3057,5045,10001
323000,5048,167854,"(STARFRUIT, MARKET << US, 5048, 1, 323000)","{""AMETHYSTS"": -19, ""STARFRUIT"": 5}",3099,5049,10000
323600,5049,172903,"(STARFRUIT, MARKET << US, 5049, 1, 323600)","{""AMETHYSTS"": -19, ""STARFRUIT"": 4}",3080,5049,10001
323700,-40184,132719,"(AMETHYSTS, US << MARKET, 10002, 1, 323700)
(AMETHYSTS, US << MARKET, 10002, 1, 323700)
(STARFRUIT, US << MARKET, 5045, 1, 323700)
(STARFRUIT, US << MARKET, 5045, 1, 323700)
(STARFRUIT, US << MARKET, 5045, 1, 323700)
(STARFRUIT, US << MARKET, 5045, 1, 323700)","{""AMETHYSTS"": -17, ""STARFRUIT"": 8}",3020,5044,10003
324100,-96,132623,"(AMETHYSTS, US << MARKET, 10004, 1, 324100)
(AMETHYSTS, MARKET << US, 10004, 1, 324100)
(AMETHYSTS, MARKET << US, 10004, 1, 324100)
(STARFRUIT, US << MARKET, 5050, 1, 324100)
(STARFRUIT, US << MARKET, 5050, 1, 324100)","{""AMETHYSTS"": -18, ""STARFRUIT"": 10}",3075,5047,10001
324600,-20088,112535,"(AMETHYSTS, US << MARKET, 10002, 1, 324600)
(STARFRUIT, US << MARKET, 5043, 1, 324600)
(STARFRUIT, US << MARKET, 5043, 1, 324600)
(STARFRUIT, US << MARKET, 5043, 1, 324600)
(STARFRUIT, US << MARKET, 5043, 1, 324600)
(STARFRUIT, MARKET << US, 5043, 1, 324600)
(STARFRUIT, MARKET << US, 5043, 1, 324600)","{""AMETHYSTS"": -17, ""STARFRUIT"": 12}",3024,5045,10003
324800,35312,147847,"(STARFRUIT, MARKET << US, 5048, 1, 324800)
(STARFRUIT, MARKET << US, 5044, 1, 324800)
(STARFRUIT, MARKET << US, 5044, 1, 324800)
(STARFRUIT, MARKET << US, 5044, 1, 324800)
(STARFRUIT, MARKET << US, 5044, 1, 324800)
(STARFRUIT, MARKET << US, 5044, 1, 324800)
(STARFRUIT, MARKET << US, 5044, 1, 324800)","{""AMETHYSTS"": -17, ""STARFRUIT"": 5}",3045,5043,10001
325200,-15138,132709,"(STARFRUIT, US << MARKET, 5046, 1, 325200)
(STARFRUIT, US << MARKET, 5046, 1, 325200)
(STARFRUIT, US << MARKET, 5046, 1, 325200)","{""AMETHYSTS"": -17, ""STARFRUIT"": 8}",3103,5045,9998
325400,-14952,117757,"(AMETHYSTS, US << MARKET, 9998, 1, 325400)
(AMETHYSTS, US << MARKET, 9998, 1, 325400)
(STARFRUIT, MARKET << US, 5044, 1, 325400)","{""AMETHYSTS"": -15, ""STARFRUIT"": 7}",3071,5047,10001
325600,14958,132715,"(AMETHYSTS, MARKET << US, 10004, 1, 325600)
(AMETHYSTS, MARKET << US, 10004, 1, 325600)
(STARFRUIT, US << MARKET, 5050, 1, 325600)","{""AMETHYSTS"": -17, ""STARFRUIT"": 8}",3083,5046,10000
326200,4955,137670,"(AMETHYSTS, US << MARKET, 10002, 1, 326200)
(AMETHYSTS, MARKET << US, 10004, 1, 326200)
(AMETHYSTS, MARKET << US, 10004, 1, 326200)
(STARFRUIT, US << MARKET, 5051, 1, 326200)","{""AMETHYSTS"": -18, ""STARFRUIT"": 9}",3048,5048,10003
326500,-20192,117478,"(STARFRUIT, US << MARKET, 5048, 1, 326500)
(STARFRUIT, US << MARKET, 5048, 1, 326500)
(STARFRUIT, US << MARKET, 5048, 1, 326500)
(STARFRUIT, US << MARKET, 5048, 1, 326500)","{""AMETHYSTS"": -18, ""STARFRUIT"": 13}",3094,5046,9999
326800,-20184,97294,"(STARFRUIT, US << MARKET, 5046, 1, 326800)
(STARFRUIT, US << MARKET, 5046, 1, 326800)
(STARFRUIT, US << MARKET, 5046, 1, 326800)
(STARFRUIT, US << MARKET, 5046, 1, 326800)","{""AMETHYSTS"": -18, ""STARFRUIT"": 17}",3127,5049,10000
326900,14958,112252,"(AMETHYSTS, MARKET << US, 10002, 1, 326900)
(AMETHYSTS, MARKET << US, 10002, 1, 326900)
(STARFRUIT, US << MARKET, 5046, 1, 326900)","{""AMETHYSTS"": -20, ""STARFRUIT"": 18}",3056,5048,10003
327300,5054,117306,"(STARFRUIT, MARKET << US, 5054, 1, 327300)","{""AMETHYSTS"": -20, ""STARFRUIT"": 17}",3156,5050,10000
327400,94,117400,"(AMETHYSTS, US << MARKET, 10002, 1, 327400)
(STARFRUIT, MARKET << US, 5048, 1, 327400)
(STARFRUIT, MARKET << US, 5048, 1, 327400)","{""AMETHYSTS"": -19, ""STARFRUIT"": 15}",3108,5051,10003
327800,-5047,112353,"(STARFRUIT, US << MARKET, 5047, 1, 327800)","{""AMETHYSTS"": -19, ""STARFRUIT"": 16}",3153,5050,10000
328400,-5052,107301,"(STARFRUIT, US << MARKET, 5052, 1, 328400)","{""AMETHYSTS"": -19, ""STARFRUIT"": 17}",3202,5053,10000
328700,-50072,57229,"(AMETHYSTS, US << MARKET, 9995, 1, 328700)
(AMETHYSTS, US << MARKET, 9995, 1, 328700)
(AMETHYSTS, US << MARKET, 9995, 1, 328700)
(AMETHYSTS, US << MARKET, 9995, 1, 328700)
(STARFRUIT, US << MARKET, 5046, 1, 328700)
(STARFRUIT, US << MARKET, 5046, 1, 328700)","{""AMETHYSTS"": -15, ""STARFRUIT"": 19}",3141,5048,10000
329500,34968,92197,"(AMETHYSTS, MARKET << US, 10005, 1, 329500)
(AMETHYSTS, MARKET << US, 10005, 1, 329500)
(AMETHYSTS, MARKET << US, 10005, 1, 329500)
(AMETHYSTS, MARKET << US, 10005, 1, 329500)
(STARFRUIT, US << MARKET, 5052, 1, 329500)","{""AMETHYSTS"": -19, ""STARFRUIT"": 20}",3157,5048,10000
329700,5045,97242,"(STARFRUIT, MARKET << US, 5045, 1, 329700)","{""AMETHYSTS"": -19, ""STARFRUIT"": 19}",3135,5047,10000
330200,-5050,92192,"(STARFRUIT, US << MARKET, 5050, 1, 330200)","{""AMETHYSTS"": -19, ""STARFRUIT"": 20}",3212,5051,10000
330300,-14954,77238,"(AMETHYSTS, US << MARKET, 10002, 1, 330300)
(AMETHYSTS, US << MARKET, 10002, 1, 330300)
(STARFRUIT, MARKET << US, 5050, 1, 330300)","{""AMETHYSTS"": -17, ""STARFRUIT"": 19}",3165,5047,9998
330400,-4,77234,"(STARFRUIT, US << MARKET, 5050, 1, 330400)
(STARFRUIT, MARKET << US, 5046, 1, 330400)","{""AMETHYSTS"": -17, ""STARFRUIT"": 19}",3186,5051,10001
330600,5045,82279,"(STARFRUIT, MARKET << US, 5045, 1, 330600)","{""AMETHYSTS"": -17, ""STARFRUIT"": 18}",3178,5049,9999
330800,14956,97235,"(AMETHYSTS, MARKET << US, 10004, 1, 330800)
(AMETHYSTS, MARKET << US, 10004, 1, 330800)
(STARFRUIT, US << MARKET, 5052, 1, 330800)","{""AMETHYSTS"": -19, ""STARFRUIT"": 19}",3147,5049,10001
331000,25235,122470,"(STARFRUIT, MARKET << US, 5047, 1, 331000)
(STARFRUIT, MARKET << US, 5047, 1, 331000)
(STARFRUIT, MARKET << US, 5047, 1, 331000)
(STARFRUIT, MARKET << US, 5047, 1, 331000)
(STARFRUIT, MARKET << US, 5047, 1, 331000)","{""AMETHYSTS"": -19, ""STARFRUIT"": 14}",3152,5046,9998
331100,-5046,117424,"(STARFRUIT, US << MARKET, 5046, 1, 331100)","{""AMETHYSTS"": -19, ""STARFRUIT"": 15}",3216,5049,9997
331200,-15047,102377,"(AMETHYSTS, US << MARKET, 10002, 1, 331200)
(STARFRUIT, US << MARKET, 5045, 1, 331200)","{""AMETHYSTS"": -18, ""STARFRUIT"": 16}",3091,5048,10003
331400,-19996,82381,"(AMETHYSTS, US << MARKET, 9998, 1, 331400)
(AMETHYSTS, US << MARKET, 9998, 1, 331400)","{""AMETHYSTS"": -16, ""STARFRUIT"": 16}",3133,5048,10001
331800,30102,112483,"(AMETHYSTS, MARKET << US, 10002, 1, 331800)
(AMETHYSTS, MARKET << US, 10002, 1, 331800)
(STARFRUIT, MARKET << US, 5049, 1, 331800)
(STARFRUIT, MARKET << US, 5049, 1, 331800)","{""AMETHYSTS"": -18, ""STARFRUIT"": 14}",3129,5050,10003
332100,-25040,87443,"(AMETHYSTS, US << MARKET, 9998, 1, 332100)
(AMETHYSTS, US << MARKET, 9998, 1, 332100)
(STARFRUIT, US << MARKET, 5044, 1, 332100)","{""AMETHYSTS"": -16, ""STARFRUIT"": 15}",3132,5047,10001
332300,-4957,82486,"(AMETHYSTS, US << MARKET, 10002, 1, 332300)
(STARFRUIT, MARKET << US, 5045, 1, 332300)","{""AMETHYSTS"": -15, ""STARFRUIT"": 14}",3113,5048,10003
332400,29916,112402,"(AMETHYSTS, MARKET << US, 10005, 1, 332400)
(AMETHYSTS, MARKET << US, 10005, 1, 332400)
(AMETHYSTS, MARKET << US, 10005, 1, 332400)
(AMETHYSTS, MARKET << US, 10005, 1, 332400)
(STARFRUIT, US << MARKET, 5052, 1, 332400)
(STARFRUIT, US << MARKET, 5052, 1, 332400)","{""AMETHYSTS"": -19, ""STARFRUIT"": 16}",3186,5049,10000
332600,10092,122494,"(STARFRUIT, MARKET << US, 5046, 1, 332600)
(STARFRUIT, MARKET << US, 5046, 1, 332600)","{""AMETHYSTS"": -19, ""STARFRUIT"": 14}",3190,5047,9998
332700,10004,132498,"(AMETHYSTS, MARKET << US, 10004, 1, 332700)","{""AMETHYSTS"": -20, ""STARFRUIT"": 14}",3184,5049,10000
332900,-20176,112322,"(STARFRUIT, US << MARKET, 5044, 1, 332900)
(STARFRUIT, US << MARKET, 5044, 1, 332900)
(STARFRUIT, US << MARKET, 5044, 1, 332900)
(STARFRUIT, US << MARKET, 5044, 1, 332900)","{""AMETHYSTS"": -20, ""STARFRUIT"": 18}",3148,5047,10001
333700,-10086,102236,"(STARFRUIT, US << MARKET, 5043, 1, 333700)
(STARFRUIT, US << MARKET, 5043, 1, 333700)","{""AMETHYSTS"": -20, ""STARFRUIT"": 20}",3156,5046,10000
334000,30273,132509,"(STARFRUIT, MARKET << US, 5048, 1, 334000)
(STARFRUIT, MARKET << US, 5045, 1, 334000)
(STARFRUIT, MARKET << US, 5045, 1, 334000)
(STARFRUIT, MARKET << US, 5045, 1, 334000)
(STARFRUIT, MARKET << US, 5045, 1, 334000)
(STARFRUIT, MARKET << US, 5045, 1, 334000)","{""AMETHYSTS"": -20, ""STARFRUIT"": 14}",3131,5043,9999
336100,5040,137549,"(STARFRUIT, MARKET << US, 5040, 1, 336100)","{""AMETHYSTS"": -20, ""STARFRUIT"": 13}",3108,5043,10000
336700,30282,167831,"(STARFRUIT, US << MARKET, 5047, 1, 336700)
(STARFRUIT, MARKET << US, 5047, 1, 336700)
(STARFRUIT, MARKET << US, 5047, 1, 336700)
(STARFRUIT, MARKET << US, 5047, 1, 336700)
(STARFRUIT, MARKET << US, 5047, 1, 336700)
(STARFRUIT, MARKET << US, 5047, 1, 336700)
(STARFRUIT, MARKET << US, 5047, 1, 336700)
(STARFRUIT, MARKET << US, 5047, 1, 336700)","{""AMETHYSTS"": -20, ""STARFRUIT"": 7}",3139,5044,10000
336900,40352,208183,"(STARFRUIT, MARKET << US, 5044, 1, 336900)
(STARFRUIT, MARKET << US, 5044, 1, 336900)
(STARFRUIT, MARKET << US, 5044, 1, 336900)
(STARFRUIT, MARKET << US, 5044, 1, 336900)
(STARFRUIT, MARKET << US, 5044, 1, 336900)
(STARFRUIT, MARKET << US, 5044, 1, 336900)
(STARFRUIT, MARKET << US, 5044, 1, 336900)
(STARFRUIT, MARKET << US, 5044, 1, 336900)","{""AMETHYSTS"": -20, ""STARFRUIT"": -1}",3181,5042,9998
337000,-19996,188187,"(AMETHYSTS, US << MARKET, 9998, 1, 337000)
(AMETHYSTS, US << MARKET, 9998, 1, 337000)","{""AMETHYSTS"": -18, ""STARFRUIT"": -1}",3196,5045,9997
337100,9998,198185,"(AMETHYSTS, MARKET << US, 9998, 1, 337100)","{""AMETHYSTS"": -19, ""STARFRUIT"": -1}",3121,5045,10001
337500,-30294,167891,"(STARFRUIT, US << MARKET, 5049, 1, 337500)
(STARFRUIT, US << MARKET, 5049, 1, 337500)
(STARFRUIT, US << MARKET, 5049, 1, 337500)
(STARFRUIT, US << MARKET, 5049, 1, 337500)
(STARFRUIT, US << MARKET, 5049, 1, 337500)
(STARFRUIT, US << MARKET, 5049, 1, 337500)","{""AMETHYSTS"": -19, ""STARFRUIT"": 5}",3131,5048,10000
337900,5049,172940,"(STARFRUIT, MARKET << US, 5049, 1, 337900)","{""AMETHYSTS"": -19, ""STARFRUIT"": 4}",3139,5045,9999
338100,20172,193112,"(STARFRUIT, MARKET << US, 5043, 1, 338100)
(STARFRUIT, MARKET << US, 5043, 1, 338100)
(STARFRUIT, MARKET << US, 5043, 1, 338100)
(STARFRUIT, MARKET << US, 5043, 1, 338100)","{""AMETHYSTS"": -19, ""STARFRUIT"": 0}",3112,5046,10000
338200,9996,203108,"(AMETHYSTS, MARKET << US, 9996, 1, 338200)
(STARFRUIT, US << MARKET, 5045, 1, 338200)
(STARFRUIT, US << MARKET, 5045, 1, 338200)
(STARFRUIT, MARKET << US, 5045, 1, 338200)
(STARFRUIT, MARKET << US, 5045, 1, 338200)","{""AMETHYSTS"": -20, ""STARFRUIT"": 0}",3108,5048,10000
338300,-10090,193018,"(STARFRUIT, US << MARKET, 5045, 1, 338300)
(STARFRUIT, US << MARKET, 5045, 1, 338300)","{""AMETHYSTS"": -20, ""STARFRUIT"": 2}",3112,5047,10000
338400,-19996,173022,"(AMETHYSTS, US << MARKET, 9998, 1, 338400)
(AMETHYSTS, US << MARKET, 9998, 1, 338400)","{""AMETHYSTS"": -18, ""STARFRUIT"": 2}",3188,5047,9996
339700,9995,183017,"(AMETHYSTS, MARKET << US, 9995, 1, 339700)","{""AMETHYSTS"": -19, ""STARFRUIT"": 2}",3103,5043,10000
340400,-86,182931,"(AMETHYSTS, MARKET << US, 9996, 1, 340400)
(STARFRUIT, US << MARKET, 5041, 1, 340400)
(STARFRUIT, US << MARKET, 5041, 1, 340400)","{""AMETHYSTS"": -20, ""STARFRUIT"": 4}",3095,5041,10000
340900,-20164,162767,"(STARFRUIT, US << MARKET, 5041, 1, 340900)
(STARFRUIT, US << MARKET, 5041, 1, 340900)
(STARFRUIT, US << MARKET, 5041, 1, 340900)
(STARFRUIT, US << MARKET, 5041, 1, 340900)","{""AMETHYSTS"": -20, ""STARFRUIT"": 8}",3119,5044,10000
341100,-40184,122583,"(AMETHYSTS, US << MARKET, 9998, 1, 341100)
(AMETHYSTS, US << MARKET, 9998, 1, 341100)
(STARFRUIT, US << MARKET, 5047, 1, 341100)
(STARFRUIT, US << MARKET, 5047, 1, 341100)
(STARFRUIT, US << MARKET, 5047, 1, 341100)
(STARFRUIT, US << MARKET, 5047, 1, 341100)","{""AMETHYSTS"": -18, ""STARFRUIT"": 12}",3183,5044,9996
341400,-5049,117534,"(STARFRUIT, US << MARKET, 5049, 1, 341400)","{""AMETHYSTS"": -18, ""STARFRUIT"": 13}",3171,5049,10000
342000,20004,137538,"(AMETHYSTS, MARKET << US, 10002, 1, 342000)
(AMETHYSTS, MARKET << US, 10002, 1, 342000)","{""AMETHYSTS"": -20, ""STARFRUIT"": 13}",3102,5048,10003
342700,15156,152694,"(STARFRUIT, MARKET << US, 5052, 1, 342700)
(STARFRUIT, MARKET << US, 5052, 1, 342700)
(STARFRUIT, MARKET << US, 5052, 1, 342700)","{""AMETHYSTS"": -20, ""STARFRUIT"": 10}",3224,5053,10000
342800,-4957,147737,"(AMETHYSTS, US << MARKET, 10004, 1, 342800)
(STARFRUIT, MARKET << US, 5047, 1, 342800)","{""AMETHYSTS"": -19, ""STARFRUIT"": 9}",3187,5050,10000
342900,4950,152687,"(AMETHYSTS, MARKET << US, 9996, 1, 342900)
(STARFRUIT, US << MARKET, 5047, 1, 342900)
(STARFRUIT, US << MARKET, 5047, 1, 342900)
(STARFRUIT, MARKET << US, 5048, 1, 342900)","{""AMETHYSTS"": -20, ""STARFRUIT"": 10}",3187,5050,10000
343200,-30006,122681,"(AMETHYSTS, US << MARKET, 10002, 1, 343200)
(AMETHYSTS, US << MARKET, 10002, 1, 343200)
(AMETHYSTS, US << MARKET, 10002, 1, 343200)","{""AMETHYSTS"": -17, ""STARFRUIT"": 10}",3140,5051,10003
343300,5048,127729,"(STARFRUIT, MARKET << US, 5048, 1, 343300)","{""AMETHYSTS"": -17, ""STARFRUIT"": 9}",3205,5051,9999
343400,-20220,107509,"(STARFRUIT, US << MARKET, 5055, 1, 343400)
(STARFRUIT, US << MARKET, 5055, 1, 343400)
(STARFRUIT, US << MARKET, 5055, 1, 343400)
(STARFRUIT, US << MARKET, 5055, 1, 343400)","{""AMETHYSTS"": -17, ""STARFRUIT"": 13}",3211,5054,10000
343800,5053,112562,"(STARFRUIT, MARKET << US, 5053, 1, 343800)","{""AMETHYSTS"": -17, ""STARFRUIT"": 12}",3210,5054,10000
344100,-19996,92566,"(AMETHYSTS, US << MARKET, 9998, 1, 344100)
(AMETHYSTS, US << MARKET, 9998, 1, 344100)","{""AMETHYSTS"": -15, ""STARFRUIT"": 12}",3211,5050,9997
344300,-30006,62560,"(AMETHYSTS, US << MARKET, 10002, 1, 344300)
(AMETHYSTS, US << MARKET, 10002, 1, 344300)
(AMETHYSTS, US << MARKET, 10002, 1, 344300)","{""AMETHYSTS"": -12, ""STARFRUIT"": 12}",3136,5051,10003
344800,-99950,-37390,"(AMETHYSTS, US << MARKET, 9995, 1, 344800)
(AMETHYSTS, US << MARKET, 9995, 1, 344800)
(AMETHYSTS, US << MARKET, 9995, 1, 344800)
(AMETHYSTS, US << MARKET, 9995, 1, 344800)
(AMETHYSTS, US << MARKET, 9995, 1, 344800)
(AMETHYSTS, US << MARKET, 9995, 1, 344800)
(AMETHYSTS, US << MARKET, 9995, 1, 344800)
(AMETHYSTS, US << MARKET, 9995, 1, 344800)
(AMETHYSTS, US << MARKET, 9995, 1, 344800)
(AMETHYSTS, US << MARKET, 9995, 1, 344800)","{""AMETHYSTS"": -2, ""STARFRUIT"": 12}",3222,5051,10000
344900,-29884,-67274,"(AMETHYSTS, US << MARKET, 9995, 1, 344900)
(AMETHYSTS, US << MARKET, 9995, 1, 344900)
(AMETHYSTS, US << MARKET, 9995, 1, 344900)
(AMETHYSTS, US << MARKET, 9995, 1, 344900)
(STARFRUIT, MARKET << US, 5048, 1, 344900)
(STARFRUIT, MARKET << US, 5048, 1, 344900)","{""AMETHYSTS"": 2, ""STARFRUIT"": 10}",3228,5051,9996
345200,-5054,-72328,"(STARFRUIT, US << MARKET, 5054, 1, 345200)","{""AMETHYSTS"": 2, ""STARFRUIT"": 11}",3244,5052,10000
345300,9998,-62330,"(AMETHYSTS, MARKET << US, 9998, 1, 345300)","{""AMETHYSTS"": 1, ""STARFRUIT"": 11}",3228,5051,9997
345500,5054,-57276,"(STARFRUIT, MARKET << US, 5054, 1, 345500)","{""AMETHYSTS"": 1, ""STARFRUIT"": 10}",3273,5055,9999
346100,15147,-42129,"(STARFRUIT, US << MARKET, 5049, 1, 346100)
(STARFRUIT, MARKET << US, 5049, 1, 346100)
(STARFRUIT, MARKET << US, 5049, 1, 346100)
(STARFRUIT, MARKET << US, 5049, 1, 346100)
(STARFRUIT, MARKET << US, 5049, 1, 346100)","{""AMETHYSTS"": 1, ""STARFRUIT"": 7}",3235,5052,10000
346800,-50025,-92154,"(AMETHYSTS, US << MARKET, 10005, 1, 346800)
(AMETHYSTS, US << MARKET, 10005, 1, 346800)
(AMETHYSTS, US << MARKET, 10005, 1, 346800)
(AMETHYSTS, US << MARKET, 10005, 1, 346800)
(AMETHYSTS, US << MARKET, 10005, 1, 346800)","{""AMETHYSTS"": 6, ""STARFRUIT"": 7}",3196,5050,10000
346900,9998,-82156,"(AMETHYSTS, MARKET << US, 9998, 1, 346900)","{""AMETHYSTS"": 5, ""STARFRUIT"": 7}",3181,5051,9996
347100,20004,-62152,"(AMETHYSTS, MARKET << US, 10002, 1, 347100)
(AMETHYSTS, MARKET << US, 10002, 1, 347100)","{""AMETHYSTS"": 3, ""STARFRUIT"": 7}",3207,5050,10003
347300,-20008,-82160,"(AMETHYSTS, US << MARKET, 10004, 1, 347300)
(AMETHYSTS, US << MARKET, 10004, 1, 347300)","{""AMETHYSTS"": 5, ""STARFRUIT"": 7}",3190,5050,10000
347900,-139930,-222090,"(AMETHYSTS, US << MARKET, 9995, 1, 347900)
(AMETHYSTS, US << MARKET, 9995, 1, 347900)
(AMETHYSTS, US << MARKET, 9995, 1, 347900)
(AMETHYSTS, US << MARKET, 9995, 1, 347900)
(AMETHYSTS, US << MARKET, 9995, 1, 347900)
(AMETHYSTS, US << MARKET, 9995, 1, 347900)
(AMETHYSTS, US << MARKET, 9995, 1, 347900)
(AMETHYSTS, US << MARKET, 9995, 1, 347900)
(AMETHYSTS, US << MARKET, 9995, 1, 347900)
(AMETHYSTS, US << MARKET, 9995, 1, 347900)
(AMETHYSTS, US << MARKET, 9995, 1, 347900)
(AMETHYSTS, US << MARKET, 9995, 1, 347900)
(AMETHYSTS, US << MARKET, 9995, 1, 347900)
(AMETHYSTS, US << MARKET, 9995, 1, 347900)","{""AMETHYSTS"": 19, ""STARFRUIT"": 7}",3253,5049,10000
348100,49990,-172100,"(AMETHYSTS, MARKET << US, 9998, 1, 348100)
(AMETHYSTS, MARKET << US, 9998, 1, 348100)
(AMETHYSTS, MARKET << US, 9998, 1, 348100)
(AMETHYSTS, MARKET << US, 9998, 1, 348100)
(AMETHYSTS, MARKET << US, 9998, 1, 348100)","{""AMETHYSTS"": 14, ""STARFRUIT"": 7}",3257,5049,10001
348700,-20180,-192280,"(STARFRUIT, US << MARKET, 5045, 1, 348700)
(STARFRUIT, US << MARKET, 5045, 1, 348700)
(STARFRUIT, US << MARKET, 5045, 1, 348700)
(STARFRUIT, US << MARKET, 5045, 1, 348700)","{""AMETHYSTS"": 14, ""STARFRUIT"": 11}",3248,5048,10000
349300,5050,-187230,"(STARFRUIT, MARKET << US, 5050, 1, 349300)","{""AMETHYSTS"": 14, ""STARFRUIT"": 10}",3280,5051,10000
350300,-20004,-207234,"(AMETHYSTS, US << MARKET, 10002, 1, 350300)
(AMETHYSTS, US << MARKET, 10002, 1, 350300)","{""AMETHYSTS"": 16, ""STARFRUIT"": 10}",3304,5049,10003
350400,5046,-202188,"(STARFRUIT, MARKET << US, 5046, 1, 350400)","{""AMETHYSTS"": 16, ""STARFRUIT"": 9}",3212,5048,9998
350600,30312,-171876,"(STARFRUIT, MARKET << US, 5052, 1, 350600)
(STARFRUIT, MARKET << US, 5052, 1, 350600)
(STARFRUIT, MARKET << US, 5052, 1, 350600)
(STARFRUIT, MARKET << US, 5052, 1, 350600)
(STARFRUIT, MARKET << US, 5052, 1, 350600)
(STARFRUIT, MARKET << US, 5052, 1, 350600)","{""AMETHYSTS"": 16, ""STARFRUIT"": 3}",3271,5049,10000
350900,-10106,-181982,"(STARFRUIT, US << MARKET, 5053, 1, 350900)
(STARFRUIT, US << MARKET, 5053, 1, 350900)","{""AMETHYSTS"": 16, ""STARFRUIT"": 5}",3288,5054,10000
351000,20004,-161978,"(AMETHYSTS, MARKET << US, 10002, 1, 351000)
(AMETHYSTS, MARKET << US, 10002, 1, 351000)","{""AMETHYSTS"": 14, ""STARFRUIT"": 5}",3324,5052,10003
351700,9998,-151980,"(AMETHYSTS, MARKET << US, 9998, 1, 351700)","{""AMETHYSTS"": 13, ""STARFRUIT"": 5}",3273,5048,10001
351900,-4956,-156936,"(AMETHYSTS, US << MARKET, 10002, 1, 351900)
(STARFRUIT, MARKET << US, 5046, 1, 351900)","{""AMETHYSTS"": 14, ""STARFRUIT"": 4}",3264,5050,10000
352800,-20192,-177128,"(STARFRUIT, US << MARKET, 5048, 1, 352800)
(STARFRUIT, US << MARKET, 5048, 1, 352800)
(STARFRUIT, US << MARKET, 5048, 1, 352800)
(STARFRUIT, US << MARKET, 5048, 1, 352800)","{""AMETHYSTS"": 14, ""STARFRUIT"": 8}",3262,5047,10001
353100,-10002,-187130,"(AMETHYSTS, US << MARKET, 10002, 1, 353100)","{""AMETHYSTS"": 15, ""STARFRUIT"": 8}",3246,5047,10000
353200,5050,-182080,"(STARFRUIT, MARKET << US, 5050, 1, 353200)","{""AMETHYSTS"": 15, ""STARFRUIT"": 7}",3249,5047,10000
353900,4952,-177128,"(AMETHYSTS, MARKET << US, 9996, 1, 353900)
(STARFRUIT, US << MARKET, 5044, 1, 353900)","{""AMETHYSTS"": 14, ""STARFRUIT"": 8}",3240,5046,10000
354600,5044,-172084,"(STARFRUIT, MARKET << US, 5044, 1, 354600)","{""AMETHYSTS"": 14, ""STARFRUIT"": 7}",3203,5045,9998
355000,14955,-157129,"(AMETHYSTS, MARKET << US, 10002, 1, 355000)
(AMETHYSTS, MARKET << US, 10002, 1, 355000)
(STARFRUIT, US << MARKET, 5049, 1, 355000)","{""AMETHYSTS"": 12, ""STARFRUIT"": 8}",3299,5049,10003
355600,-5044,-162173,"(STARFRUIT, US << MARKET, 5044, 1, 355600)","{""AMETHYSTS"": 12, ""STARFRUIT"": 9}",3271,5048,10001
355700,-40020,-202193,"(AMETHYSTS, US << MARKET, 10005, 1, 355700)
(AMETHYSTS, US << MARKET, 10005, 1, 355700)
(AMETHYSTS, US << MARKET, 10005, 1, 355700)
(AMETHYSTS, US << MARKET, 10005, 1, 355700)","{""AMETHYSTS"": 16, ""STARFRUIT"": 9}",3230,5047,10000
355800,-5044,-207237,"(STARFRUIT, US << MARKET, 5044, 1, 355800)","{""AMETHYSTS"": 16, ""STARFRUIT"": 10}",3259,5048,10001
356000,30294,-176943,"(STARFRUIT, MARKET << US, 5049, 1, 356000)
(STARFRUIT, MARKET << US, 5049, 1, 356000)
(STARFRUIT, MARKET << US, 5049, 1, 356000)
(STARFRUIT, MARKET << US, 5049, 1, 356000)
(STARFRUIT, MARKET << US, 5049, 1, 356000)
(STARFRUIT, MARKET << US, 5049, 1, 356000)","{""AMETHYSTS"": 16, ""STARFRUIT"": 4}",3241,5046,10000
356100,-20180,-197123,"(STARFRUIT, US << MARKET, 5045, 1, 356100)
(STARFRUIT, US << MARKET, 5045, 1, 356100)
(STARFRUIT, US << MARKET, 5045, 1, 356100)
(STARFRUIT, US << MARKET, 5045, 1, 356100)","{""AMETHYSTS"": 16, ""STARFRUIT"": 8}",3277,5048,10001
356800,39992,-157131,"(AMETHYSTS, MARKET << US, 9998, 1, 356800)
(AMETHYSTS, MARKET << US, 9998, 1, 356800)
(AMETHYSTS, MARKET << US, 9998, 1, 356800)
(AMETHYSTS, MARKET << US, 9998, 1, 356800)","{""AMETHYSTS"": 12, ""STARFRUIT"": 8}",3217,5048,9997
356900,5046,-152085,"(STARFRUIT, MARKET << US, 5046, 1, 356900)","{""AMETHYSTS"": 12, ""STARFRUIT"": 7}",3258,5049,10000
357100,-5046,-157131,"(STARFRUIT, US << MARKET, 5046, 1, 357100)","{""AMETHYSTS"": 12, ""STARFRUIT"": 8}",3213,5046,9998
357200,69986,-87145,"(AMETHYSTS, MARKET << US, 9998, 1, 357200)
(AMETHYSTS, MARKET << US, 9998, 1, 357200)
(AMETHYSTS, MARKET << US, 9998, 1, 357200)
(AMETHYSTS, MARKET << US, 9998, 1, 357200)
(AMETHYSTS, MARKET << US, 9998, 1, 357200)
(AMETHYSTS, MARKET << US, 9998, 1, 357200)
(AMETHYSTS, MARKET << US, 9998, 1, 357200)","{""AMETHYSTS"": 5, ""STARFRUIT"": 8}",3244,5048,10001
357400,-19996,-107141,"(AMETHYSTS, US << MARKET, 9998, 1, 357400)
(AMETHYSTS, US << MARKET, 9998, 1, 357400)","{""AMETHYSTS"": 7, ""STARFRUIT"": 8}",3230,5049,9997
357600,9900,-97241,"(AMETHYSTS, MARKET << US, 9995, 1, 357600)
(AMETHYSTS, MARKET << US, 9995, 1, 357600)
(STARFRUIT, US << MARKET, 5045, 1, 357600)
(STARFRUIT, US << MARKET, 5045, 1, 357600)","{""AMETHYSTS"": 5, ""STARFRUIT"": 10}",3239,5048,10000
358100,5046,-92195,"(STARFRUIT, MARKET << US, 5046, 1, 358100)","{""AMETHYSTS"": 5, ""STARFRUIT"": 9}",3255,5050,10000
358500,-19996,-112191,"(AMETHYSTS, US << MARKET, 9998, 1, 358500)
(AMETHYSTS, US << MARKET, 9998, 1, 358500)","{""AMETHYSTS"": 7, ""STARFRUIT"": 9}",3238,5050,9997
358600,-20216,-132407,"(STARFRUIT, US << MARKET, 5054, 1, 358600)
(STARFRUIT, US << MARKET, 5054, 1, 358600)
(STARFRUIT, US << MARKET, 5054, 1, 358600)
(STARFRUIT, US << MARKET, 5054, 1, 358600)","{""AMETHYSTS"": 7, ""STARFRUIT"": 13}",3250,5050,10001
358900,100,-132307,"(AMETHYSTS, US << MARKET, 10002, 1, 358900)
(STARFRUIT, US << MARKET, 5051, 1, 358900)
(STARFRUIT, MARKET << US, 5051, 1, 358900)
(STARFRUIT, MARKET << US, 5051, 1, 358900)
(STARFRUIT, MARKET << US, 5051, 1, 358900)","{""AMETHYSTS"": 8, ""STARFRUIT"": 11}",3289,5052,10003
359100,-10004,-142311,"(AMETHYSTS, US << MARKET, 10004, 1, 359100)","{""AMETHYSTS"": 9, ""STARFRUIT"": 11}",3261,5052,10000
359300,-15057,-157368,"(AMETHYSTS, US << MARKET, 10005, 1, 359300)
(STARFRUIT, US << MARKET, 5052, 1, 359300)","{""AMETHYSTS"": 10, ""STARFRUIT"": 12}",3220,5049,10000
359700,-10002,-167370,"(AMETHYSTS, US << MARKET, 10002, 1, 359700)","{""AMETHYSTS"": 11, ""STARFRUIT"": 12}",3263,5050,10003
359900,-14944,-182314,"(AMETHYSTS, US << MARKET, 9996, 1, 359900)
(AMETHYSTS, US << MARKET, 9996, 1, 359900)
(STARFRUIT, MARKET << US, 5048, 1, 359900)","{""AMETHYSTS"": 13, ""STARFRUIT"": 11}",3214,5048,10000
360000,-4950,-187264,"(AMETHYSTS, US << MARKET, 10005, 1, 360000)
(STARFRUIT, MARKET << US, 5055, 1, 360000)","{""AMETHYSTS"": 14, ""STARFRUIT"": 10}",3270,5052,10001
360200,30318,-156946,"(STARFRUIT, MARKET << US, 5053, 1, 360200)
(STARFRUIT, MARKET << US, 5053, 1, 360200)
(STARFRUIT, MARKET << US, 5053, 1, 360200)
(STARFRUIT, MARKET << US, 5053, 1, 360200)
(STARFRUIT, MARKET << US, 5053, 1, 360200)
(STARFRUIT, MARKET << US, 5053, 1, 360200)","{""AMETHYSTS"": 14, ""STARFRUIT"": 4}",3216,5051,9997
360300,-40224,-197170,"(AMETHYSTS, US << MARKET, 10002, 1, 360300)
(AMETHYSTS, US << MARKET, 10002, 1, 360300)
(STARFRUIT, US << MARKET, 5055, 1, 360300)
(STARFRUIT, US << MARKET, 5055, 1, 360300)
(STARFRUIT, US << MARKET, 5055, 1, 360300)
(STARFRUIT, US << MARKET, 5055, 1, 360300)","{""AMETHYSTS"": 16, ""STARFRUIT"": 8}",3286,5051,10003
360600,-19992,-217162,"(AMETHYSTS, US << MARKET, 9996, 1, 360600)
(AMETHYSTS, US << MARKET, 9996, 1, 360600)
(AMETHYSTS, US << MARKET, 9996, 1, 360600)
(AMETHYSTS, US << MARKET, 9996, 1, 360600)
(AMETHYSTS, MARKET << US, 9996, 1, 360600)
(AMETHYSTS, MARKET << US, 9996, 1, 360600)","{""AMETHYSTS"": 18, ""STARFRUIT"": 8}",3238,5050,10000
361100,20196,-196966,"(STARFRUIT, MARKET << US, 5049, 1, 361100)
(STARFRUIT, MARKET << US, 5049, 1, 361100)
(STARFRUIT, MARKET << US, 5049, 1, 361100)
(STARFRUIT, MARKET << US, 5049, 1, 361100)","{""AMETHYSTS"": 18, ""STARFRUIT"": 4}",3208,5048,9999
361400,20188,-176778,"(STARFRUIT, MARKET << US, 5047, 1, 361400)
(STARFRUIT, MARKET << US, 5047, 1, 361400)
(STARFRUIT, MARKET << US, 5047, 1, 361400)
(STARFRUIT, MARKET << US, 5047, 1, 361400)","{""AMETHYSTS"": 18, ""STARFRUIT"": 0}",3222,5050,10000
361800,25148,-151630,"(AMETHYSTS, MARKET << US, 9998, 1, 361800)
(STARFRUIT, MARKET << US, 5050, 1, 361800)
(STARFRUIT, MARKET << US, 5050, 1, 361800)
(STARFRUIT, MARKET << US, 5050, 1, 361800)","{""AMETHYSTS"": 17, ""STARFRUIT"": -3}",3166,5051,9997
362000,-29985,-181615,"(AMETHYSTS, US << MARKET, 9995, 1, 362000)
(AMETHYSTS, US << MARKET, 9995, 1, 362000)
(AMETHYSTS, US << MARKET, 9995, 1, 362000)","{""AMETHYSTS"": 20, ""STARFRUIT"": -3}",3238,5049,10000
362100,20004,-161611,"(AMETHYSTS, MARKET << US, 10002, 1, 362100)
(AMETHYSTS, MARKET << US, 10002, 1, 362100)","{""AMETHYSTS"": 18, ""STARFRUIT"": -3}",3212,5047,9998
362300,10100,-151511,"(STARFRUIT, MARKET << US, 5050, 1, 362300)
(STARFRUIT, MARKET << US, 5050, 1, 362300)","{""AMETHYSTS"": 18, ""STARFRUIT"": -5}",3234,5051,10000
362900,-10102,-161613,"(STARFRUIT, US << MARKET, 5051, 1, 362900)
(STARFRUIT, US << MARKET, 5051, 1, 362900)","{""AMETHYSTS"": 18, ""STARFRUIT"": -3}",3234,5051,10000
363100,9998,-151615,"(AMETHYSTS, MARKET << US, 9998, 1, 363100)","{""AMETHYSTS"": 17, ""STARFRUIT"": -3}",3173,5048,9996
363200,50126,-101489,"(AMETHYSTS, MARKET << US, 10005, 1, 363200)
(AMETHYSTS, MARKET << US, 10005, 1, 363200)
(AMETHYSTS, MARKET << US, 10005, 1, 363200)
(AMETHYSTS, MARKET << US, 10005, 1, 363200)
(STARFRUIT, MARKET << US, 5053, 1, 363200)
(STARFRUIT, MARKET << US, 5053, 1, 363200)","{""AMETHYSTS"": 13, ""STARFRUIT"": -5}",3266,5049,10000
363300,5046,-96443,"(STARFRUIT, MARKET << US, 5046, 1, 363300)","{""AMETHYSTS"": 13, ""STARFRUIT"": -6}",3275,5047,10000
363600,64971,-31472,"(AMETHYSTS, US << MARKET, 10002, 1, 363600)
(AMETHYSTS, MARKET << US, 10002, 1, 363600)
(AMETHYSTS, MARKET << US, 10002, 1, 363600)
(AMETHYSTS, MARKET << US, 10002, 1, 363600)
(AMETHYSTS, MARKET << US, 10002, 1, 363600)
(AMETHYSTS, MARKET << US, 10002, 1, 363600)
(AMETHYSTS, MARKET << US, 10002, 1, 363600)
(AMETHYSTS, MARKET << US, 10002, 1, 363600)
(AMETHYSTS, MARKET << US, 10002, 1, 363600)
(STARFRUIT, US << MARKET, 5046, 1, 363600)
(STARFRUIT, US << MARKET, 5046, 1, 363600)
(STARFRUIT, MARKET << US, 5049, 1, 363600)","{""AMETHYSTS"": 6, ""STARFRUIT"": -5}",3311,5047,10003
363700,20212,-11260,"(STARFRUIT, MARKET << US, 5053, 1, 363700)
(STARFRUIT, MARKET << US, 5053, 1, 363700)
(STARFRUIT, MARKET << US, 5053, 1, 363700)
(STARFRUIT, MARKET << US, 5053, 1, 363700)","{""AMETHYSTS"": 6, ""STARFRUIT"": -9}",3299,5049,10000
364000,70014,58754,"(AMETHYSTS, US << MARKET, 10002, 1, 364000)
(AMETHYSTS, MARKET << US, 10002, 1, 364000)
(AMETHYSTS, MARKET << US, 10002, 1, 364000)
(AMETHYSTS, MARKET << US, 10002, 1, 364000)
(AMETHYSTS, MARKET << US, 10002, 1, 364000)
(AMETHYSTS, MARKET << US, 10002, 1, 364000)
(AMETHYSTS, MARKET << US, 10002, 1, 364000)
(AMETHYSTS, MARKET << US, 10002, 1, 364000)
(AMETHYSTS, MARKET << US, 10002, 1, 364000)","{""AMETHYSTS"": -1, ""STARFRUIT"": -9}",3315,5049,9998
364100,-19996,38758,"(AMETHYSTS, US << MARKET, 9998, 1, 364100)
(AMETHYSTS, US << MARKET, 9998, 1, 364100)","{""AMETHYSTS"": 1, ""STARFRUIT"": -9}",3305,5050,9997
364300,0,38758,,"{""AMETHYSTS"": 1, ""STARFRUIT"": -9}",3272,5054,10000
364400,9998,48756,"(AMETHYSTS, MARKET << US, 9998, 1, 364400)","{""AMETHYSTS"": 0, ""STARFRUIT"": -9}",3297,5051,9996
365000,-50010,-1254,"(AMETHYSTS, US << MARKET, 10002, 1, 365000)
(AMETHYSTS, US << MARKET, 10002, 1, 365000)
(AMETHYSTS, US << MARKET, 10002, 1, 365000)
(AMETHYSTS, US << MARKET, 10002, 1, 365000)
(AMETHYSTS, US << MARKET, 10002, 1, 365000)","{""AMETHYSTS"": 5, ""STARFRUIT"": -9}",3302,5051,10003
365100,-19996,-21250,"(AMETHYSTS, US << MARKET, 9998, 1, 365100)
(AMETHYSTS, US << MARKET, 9998, 1, 365100)","{""AMETHYSTS"": 7, ""STARFRUIT"": -9}",3316,5049,10001
365200,-40220,-61470,"(AMETHYSTS, US << MARKET, 10004, 1, 365200)
(AMETHYSTS, US << MARKET, 10004, 1, 365200)
(STARFRUIT, US << MARKET, 5053, 1, 365200)
(STARFRUIT, US << MARKET, 5053, 1, 365200)
(STARFRUIT, US << MARKET, 5053, 1, 365200)
(STARFRUIT, US << MARKET, 5053, 1, 365200)","{""AMETHYSTS"": 9, ""STARFRUIT"": -5}",3275,5051,10000
365400,5048,-56422,"(STARFRUIT, MARKET << US, 5048, 1, 365400)","{""AMETHYSTS"": 9, ""STARFRUIT"": -6}",3245,5051,9997
365600,-14920,-71342,"(AMETHYSTS, US << MARKET, 9998, 1, 365600)
(AMETHYSTS, US << MARKET, 9998, 1, 365600)
(AMETHYSTS, US << MARKET, 9998, 1, 365600)
(AMETHYSTS, US << MARKET, 9998, 1, 365600)
(AMETHYSTS, US << MARKET, 9998, 1, 365600)
(AMETHYSTS, US << MARKET, 9998, 1, 365600)
(AMETHYSTS, MARKET << US, 10004, 1, 365600)
(AMETHYSTS, MARKET << US, 10004, 1, 365600)
(AMETHYSTS, MARKET << US, 10004, 1, 365600)
(AMETHYSTS, MARKET << US, 10004, 1, 365600)
(STARFRUIT, MARKET << US, 5052, 1, 365600)","{""AMETHYSTS"": 11, ""STARFRUIT"": -7}",3301,5051,10000
365900,-49980,-121322,"(AMETHYSTS, US << MARKET, 9996, 1, 365900)
(AMETHYSTS, US << MARKET, 9996, 1, 365900)
(AMETHYSTS, US << MARKET, 9996, 1, 365900)
(AMETHYSTS, US << MARKET, 9996, 1, 365900)
(AMETHYSTS, US << MARKET, 9996, 1, 365900)
(AMETHYSTS, US << MARKET, 9996, 1, 365900)
(AMETHYSTS, MARKET << US, 9996, 1, 365900)","{""AMETHYSTS"": 16, ""STARFRUIT"": -7}",3328,5050,10000
366000,-4950,-126272,"(AMETHYSTS, US << MARKET, 10002, 1, 366000)
(STARFRUIT, MARKET << US, 5052, 1, 366000)","{""AMETHYSTS"": 17, ""STARFRUIT"": -8}",3395,5048,10003
366100,0,-126272,,"{""AMETHYSTS"": 17, ""STARFRUIT"": -8}",3336,5049,10000
366700,0,-126272,,"{""AMETHYSTS"": 17, ""STARFRUIT"": -8}",3320,5051,10000
367000,20192,-106080,"(STARFRUIT, MARKET << US, 5048, 1, 367000)
(STARFRUIT, MARKET << US, 5048, 1, 367000)
(STARFRUIT, MARKET << US, 5048, 1, 367000)
(STARFRUIT, MARKET << US, 5048, 1, 367000)","{""AMETHYSTS"": 17, ""STARFRUIT"": -12}",3305,5047,9997
367400,-106,-106186,"(AMETHYSTS, MARKET << US, 9998, 1, 367400)
(STARFRUIT, US << MARKET, 5052, 1, 367400)
(STARFRUIT, US << MARKET, 5052, 1, 367400)","{""AMETHYSTS"": 16, ""STARFRUIT"": -10}",3270,5048,9996
367700,-40424,-146610,"(STARFRUIT, US << MARKET, 5053, 1, 367700)
(STARFRUIT, US << MARKET, 5053, 1, 367700)
(STARFRUIT, US << MARKET, 5053, 1, 367700)
(STARFRUIT, US << MARKET, 5053, 1, 367700)
(STARFRUIT, US << MARKET, 5053, 1, 367700)
(STARFRUIT, US << MARKET, 5053, 1, 367700)
(STARFRUIT, US << MARKET, 5053, 1, 367700)
(STARFRUIT, US << MARKET, 5053, 1, 367700)","{""AMETHYSTS"": 16, ""STARFRUIT"": -2}",3292,5049,10000
368000,-10002,-156612,"(AMETHYSTS, US << MARKET, 10002, 1, 368000)","{""AMETHYSTS"": 17, ""STARFRUIT"": -2}",3273,5049,9999
368700,39729,-116883,"(AMETHYSTS, US << MARKET, 10005, 1, 368700)
(AMETHYSTS, MARKET << US, 10002, 1, 368700)
(AMETHYSTS, MARKET << US, 10002, 1, 368700)
(AMETHYSTS, MARKET << US, 10002, 1, 368700)
(AMETHYSTS, MARKET << US, 10002, 1, 368700)
(AMETHYSTS, MARKET << US, 10002, 1, 368700)
(AMETHYSTS, MARKET << US, 10002, 1, 368700)
(AMETHYSTS, MARKET << US, 10002, 1, 368700)
(AMETHYSTS, MARKET << US, 10002, 1, 368700)
(STARFRUIT, US << MARKET, 5047, 1, 368700)
(STARFRUIT, US << MARKET, 5047, 1, 368700)
(STARFRUIT, US << MARKET, 5047, 1, 368700)
(STARFRUIT, US << MARKET, 5047, 1, 368700)
(STARFRUIT, US << MARKET, 5047, 1, 368700)
(STARFRUIT, US << MARKET, 5047, 1, 368700)","{""AMETHYSTS"": 10, ""STARFRUIT"": 4}",3335,5047,10003
368900,-19996,-136879,"(AMETHYSTS, US << MARKET, 9998, 1, 368900)
(AMETHYSTS, US << MARKET, 9998, 1, 368900)","{""AMETHYSTS"": 12, ""STARFRUIT"": 4}",3289,5051,9997
369000,-10096,-146975,"(STARFRUIT, US << MARKET, 5048, 1, 369000)
(STARFRUIT, US << MARKET, 5048, 1, 369000)","{""AMETHYSTS"": 12, ""STARFRUIT"": 6}",3313,5050,9999
369100,19992,-126983,"(AMETHYSTS, MARKET << US, 9996, 1, 369100)
(AMETHYSTS, MARKET << US, 9996, 1, 369100)","{""AMETHYSTS"": 10, ""STARFRUIT"": 6}",3287,5050,9997
369200,-10106,-137089,"(STARFRUIT, US << MARKET, 5053, 1, 369200)
(STARFRUIT, US << MARKET, 5053, 1, 369200)","{""AMETHYSTS"": 10, ""STARFRUIT"": 8}",3321,5050,10001
369600,-40008,-177097,"(AMETHYSTS, US << MARKET, 10002, 1, 369600)
(AMETHYSTS, US << MARKET, 10002, 1, 369600)
(AMETHYSTS, US << MARKET, 10002, 1, 369600)
(AMETHYSTS, US << MARKET, 10002, 1, 369600)","{""AMETHYSTS"": 14, ""STARFRUIT"": 8}",3329,5048,10003
369700,40316,-136781,"(AMETHYSTS, MARKET << US, 9998, 1, 369700)
(STARFRUIT, MARKET << US, 5053, 1, 369700)
(STARFRUIT, MARKET << US, 5053, 1, 369700)
(STARFRUIT, MARKET << US, 5053, 1, 369700)
(STARFRUIT, MARKET << US, 5053, 1, 369700)
(STARFRUIT, MARKET << US, 5053, 1, 369700)
(STARFRUIT, MARKET << US, 5053, 1, 369700)","{""AMETHYSTS"": 13, ""STARFRUIT"": 2}",3278,5049,9997
369900,-20204,-156985,"(STARFRUIT, US << MARKET, 5051, 1, 369900)
(STARFRUIT, US << MARKET, 5051, 1, 369900)
(STARFRUIT, US << MARKET, 5051, 1, 369900)
(STARFRUIT, US << MARKET, 5051, 1, 369900)","{""AMETHYSTS"": 13, ""STARFRUIT"": 6}",3327,5052,10000
370500,-10094,-167079,"(STARFRUIT, US << MARKET, 5047, 1, 370500)
(STARFRUIT, US << MARKET, 5047, 1, 370500)","{""AMETHYSTS"": 13, ""STARFRUIT"": 8}",3289,5046,10000
370900,-29736,-196815,"(AMETHYSTS, US << MARKET, 10002, 1, 370900)
(AMETHYSTS, US << MARKET, 10002, 1, 370900)
(AMETHYSTS, US << MARKET, 10002, 1, 370900)
(AMETHYSTS, US << MARKET, 10002, 1, 370900)
(AMETHYSTS, US << MARKET, 10002, 1, 370900)
(AMETHYSTS, US << MARKET, 10002, 1, 370900)
(STARFRUIT, MARKET << US, 5046, 1, 370900)
(STARFRUIT, MARKET << US, 5046, 1, 370900)
(STARFRUIT, MARKET << US, 5046, 1, 370900)
(STARFRUIT, MARKET << US, 5046, 1, 370900)
(STARFRUIT, MARKET << US, 5046, 1, 370900)
(STARFRUIT, MARKET << US, 5046, 1, 370900)","{""AMETHYSTS"": 19, ""STARFRUIT"": 2}",3264,5049,9999
371600,89928,-106887,"(AMETHYSTS, MARKET << US, 10002, 1, 371600)
(AMETHYSTS, MARKET << US, 10002, 1, 371600)
(AMETHYSTS, MARKET << US, 10002, 1, 371600)
(AMETHYSTS, MARKET << US, 10002, 1, 371600)
(AMETHYSTS, MARKET << US, 10002, 1, 371600)
(AMETHYSTS, MARKET << US, 10002, 1, 371600)
(AMETHYSTS, MARKET << US, 10002, 1, 371600)
(AMETHYSTS, MARKET << US, 10002, 1, 371600)
(AMETHYSTS, MARKET << US, 10002, 1, 371600)
(AMETHYSTS, MARKET << US, 10002, 1, 371600)
(STARFRUIT, US << MARKET, 5046, 1, 371600)
(STARFRUIT, US << MARKET, 5046, 1, 371600)","{""AMETHYSTS"": 9, ""STARFRUIT"": 4}",3336,5049,10003
372000,-10092,-116979,"(STARFRUIT, US << MARKET, 5046, 1, 372000)
(STARFRUIT, US << MARKET, 5046, 1, 372000)","{""AMETHYSTS"": 9, ""STARFRUIT"": 6}",3291,5045,10000
372700,25265,-91714,"(STARFRUIT, MARKET << US, 5053, 1, 372700)
(STARFRUIT, MARKET << US, 5053, 1, 372700)
(STARFRUIT, MARKET << US, 5053, 1, 372700)
(STARFRUIT, MARKET << US, 5053, 1, 372700)
(STARFRUIT, MARKET << US, 5053, 1, 372700)","{""AMETHYSTS"": 9, ""STARFRUIT"": 1}",3362,5049,10003
372800,9914,-81800,"(AMETHYSTS, MARKET << US, 10004, 1, 372800)
(AMETHYSTS, MARKET << US, 10004, 1, 372800)
(STARFRUIT, US << MARKET, 5047, 1, 372800)
(STARFRUIT, US << MARKET, 5047, 1, 372800)","{""AMETHYSTS"": 7, ""STARFRUIT"": 3}",3338,5046,10000
373200,-19996,-101796,"(AMETHYSTS, US << MARKET, 9998, 1, 373200)
(AMETHYSTS, US << MARKET, 9998, 1, 373200)","{""AMETHYSTS"": 9, ""STARFRUIT"": 3}",3384,5051,10003
373600,15043,-86753,"(AMETHYSTS, MARKET << US, 9998, 1, 373600)
(STARFRUIT, MARKET << US, 5045, 1, 373600)","{""AMETHYSTS"": 8, ""STARFRUIT"": 2}",3351,5048,10001
373800,-20184,-106937,"(STARFRUIT, US << MARKET, 5046, 1, 373800)
(STARFRUIT, US << MARKET, 5046, 1, 373800)
(STARFRUIT, US << MARKET, 5046, 1, 373800)
(STARFRUIT, US << MARKET, 5046, 1, 373800)","{""AMETHYSTS"": 8, ""STARFRUIT"": 6}",3333,5045,10000
373900,9998,-96939,"(AMETHYSTS, MARKET << US, 9998, 1, 373900)","{""AMETHYSTS"": 7, ""STARFRUIT"": 6}",3328,5048,9997
374700,-19996,-116935,"(AMETHYSTS, US << MARKET, 9998, 1, 374700)
(AMETHYSTS, US << MARKET, 9998, 1, 374700)","{""AMETHYSTS"": 9, ""STARFRUIT"": 6}",3344,5051,9997
375400,-10094,-127029,"(STARFRUIT, US << MARKET, 5047, 1, 375400)
(STARFRUIT, US << MARKET, 5047, 1, 375400)","{""AMETHYSTS"": 9, ""STARFRUIT"": 8}",3380,5050,10001
375500,10100,-116929,"(STARFRUIT, MARKET << US, 5050, 1, 375500)
(STARFRUIT, MARKET << US, 5050, 1, 375500)","{""AMETHYSTS"": 9, ""STARFRUIT"": 6}",3347,5049,9998
375700,-20192,-137121,"(STARFRUIT, US << MARKET, 5048, 1, 375700)
(STARFRUIT, US << MARKET, 5048, 1, 375700)
(STARFRUIT, US << MARKET, 5048, 1, 375700)
(STARFRUIT, US << MARKET, 5048, 1, 375700)","{""AMETHYSTS"": 9, ""STARFRUIT"": 10}",3349,5047,10000
375900,-19996,-157117,"(AMETHYSTS, US << MARKET, 9998, 1, 375900)
(AMETHYSTS, US << MARKET, 9998, 1, 375900)","{""AMETHYSTS"": 11, ""STARFRUIT"": 10}",3340,5049,9997
376000,-19996,-177113,"(AMETHYSTS, US << MARKET, 9998, 1, 376000)
(AMETHYSTS, US << MARKET, 9998, 1, 376000)","{""AMETHYSTS"": 13, ""STARFRUIT"": 10}",3348,5050,9997
376100,-20004,-197117,"(AMETHYSTS, US << MARKET, 10002, 1, 376100)
(AMETHYSTS, US << MARKET, 10002, 1, 376100)","{""AMETHYSTS"": 15, ""STARFRUIT"": 10}",3428,5050,10003
376400,24952,-172165,"(AMETHYSTS, US << MARKET, 10002, 1, 376400)
(AMETHYSTS, MARKET << US, 10002, 1, 376400)
(AMETHYSTS, MARKET << US, 10002, 1, 376400)
(AMETHYSTS, MARKET << US, 10002, 1, 376400)
(AMETHYSTS, MARKET << US, 10002, 1, 376400)
(STARFRUIT, US << MARKET, 5054, 1, 376400)","{""AMETHYSTS"": 12, ""STARFRUIT"": 11}",3419,5052,10001
376800,-112,-172277,"(AMETHYSTS, MARKET << US, 9998, 1, 376800)
(STARFRUIT, US << MARKET, 5055, 1, 376800)
(STARFRUIT, US << MARKET, 5055, 1, 376800)","{""AMETHYSTS"": 11, ""STARFRUIT"": 13}",3353,5051,9997
377000,-19996,-192273,"(AMETHYSTS, US << MARKET, 9998, 1, 377000)
(AMETHYSTS, US << MARKET, 9998, 1, 377000)","{""AMETHYSTS"": 13, ""STARFRUIT"": 13}",3403,5051,10001
377200,-5161,-197434,"(AMETHYSTS, MARKET << US, 9998, 1, 377200)
(STARFRUIT, US << MARKET, 5053, 1, 377200)
(STARFRUIT, US << MARKET, 5053, 1, 377200)
(STARFRUIT, US << MARKET, 5053, 1, 377200)","{""AMETHYSTS"": 12, ""STARFRUIT"": 16}",3378,5050,10001
377300,15156,-182278,"(STARFRUIT, US << MARKET, 5052, 1, 377300)
(STARFRUIT, MARKET << US, 5052, 1, 377300)
(STARFRUIT, MARKET << US, 5052, 1, 377300)
(STARFRUIT, MARKET << US, 5052, 1, 377300)
(STARFRUIT, MARKET << US, 5052, 1, 377300)","{""AMETHYSTS"": 12, ""STARFRUIT"": 13}",3387,5053,9998
377400,14954,-167324,"(AMETHYSTS, MARKET << US, 10004, 1, 377400)
(AMETHYSTS, MARKET << US, 10004, 1, 377400)
(STARFRUIT, US << MARKET, 5054, 1, 377400)","{""AMETHYSTS"": 10, ""STARFRUIT"": 14}",3376,5050,10000
377600,-20188,-187512,"(STARFRUIT, US << MARKET, 5047, 1, 377600)
(STARFRUIT, US << MARKET, 5047, 1, 377600)
(STARFRUIT, US << MARKET, 5047, 1, 377600)
(STARFRUIT, US << MARKET, 5047, 1, 377600)","{""AMETHYSTS"": 10, ""STARFRUIT"": 18}",3388,5050,10000
378000,9998,-177514,"(AMETHYSTS, MARKET << US, 9998, 1, 378000)","{""AMETHYSTS"": 9, ""STARFRUIT"": 18}",3359,5050,9997
378400,-10002,-187516,"(AMETHYSTS, US << MARKET, 10002, 1, 378400)
(AMETHYSTS, US << MARKET, 10002, 1, 378400)
(AMETHYSTS, US << MARKET, 10002, 1, 378400)
(AMETHYSTS, MARKET << US, 10002, 1, 378400)
(AMETHYSTS, MARKET << US, 10002, 1, 378400)","{""AMETHYSTS"": 10, ""STARFRUIT"": 18}",3338,5048,9999
378500,-4949,-192465,"(AMETHYSTS, US << MARKET, 10002, 1, 378500)
(STARFRUIT, MARKET << US, 5053, 1, 378500)","{""AMETHYSTS"": 11, ""STARFRUIT"": 17}",3469,5053,10003
379100,5054,-187411,"(STARFRUIT, MARKET << US, 5054, 1, 379100)","{""AMETHYSTS"": 11, ""STARFRUIT"": 16}",3453,5054,10000
379400,10100,-177311,"(STARFRUIT, MARKET << US, 5050, 1, 379400)
(STARFRUIT, MARKET << US, 5050, 1, 379400)","{""AMETHYSTS"": 11, ""STARFRUIT"": 14}",3375,5049,10000
379500,10108,-167203,"(STARFRUIT, MARKET << US, 5054, 1, 379500)
(STARFRUIT, MARKET << US, 5054, 1, 379500)","{""AMETHYSTS"": 11, ""STARFRUIT"": 12}",3445,5054,10000
379600,-5048,-172251,"(STARFRUIT, US << MARKET, 5048, 1, 379600)","{""AMETHYSTS"": 11, ""STARFRUIT"": 13}",3360,5047,10000
379800,5048,-167203,"(STARFRUIT, MARKET << US, 5048, 1, 379800)","{""AMETHYSTS"": 11, ""STARFRUIT"": 12}",3373,5048,10000
380200,5054,-162149,"(STARFRUIT, MARKET << US, 5054, 1, 380200)","{""AMETHYSTS"": 11, ""STARFRUIT"": 11}",3445,5054,10000
380900,5049,-157100,"(STARFRUIT, MARKET << US, 5049, 1, 380900)","{""AMETHYSTS"": 11, ""STARFRUIT"": 10}",3380,5048,10000
381100,-9906,-167006,"(AMETHYSTS, US << MARKET, 10002, 1, 381100)
(AMETHYSTS, US << MARKET, 10002, 1, 381100)
(AMETHYSTS, US << MARKET, 10002, 1, 381100)
(AMETHYSTS, US << MARKET, 10002, 1, 381100)
(AMETHYSTS, MARKET << US, 10002, 1, 381100)
(AMETHYSTS, MARKET << US, 10002, 1, 381100)
(STARFRUIT, MARKET << US, 5049, 1, 381100)
(STARFRUIT, MARKET << US, 5049, 1, 381100)","{""AMETHYSTS"": 13, ""STARFRUIT"": 8}",3397,5052,9999
381300,30120,-136886,"(AMETHYSTS, MARKET << US, 10004, 1, 381300)
(AMETHYSTS, MARKET << US, 10004, 1, 381300)
(STARFRUIT, MARKET << US, 5056, 1, 381300)
(STARFRUIT, MARKET << US, 5056, 1, 381300)","{""AMETHYSTS"": 11, ""STARFRUIT"": 6}",3426,5052,10000
381500,10110,-126776,"(STARFRUIT, MARKET << US, 5055, 1, 381500)
(STARFRUIT, MARKET << US, 5055, 1, 381500)","{""AMETHYSTS"": 11, ""STARFRUIT"": 4}",3433,5055,9999
381700,-30098,-156874,"(AMETHYSTS, US << MARKET, 9998, 1, 381700)
(AMETHYSTS, US << MARKET, 9998, 1, 381700)
(STARFRUIT, US << MARKET, 5051, 1, 381700)
(STARFRUIT, US << MARKET, 5051, 1, 381700)","{""AMETHYSTS"": 13, ""STARFRUIT"": 6}",3387,5050,9997
381800,25065,-131809,"(AMETHYSTS, MARKET << US, 10005, 1, 381800)
(AMETHYSTS, MARKET << US, 10005, 1, 381800)
(STARFRUIT, MARKET << US, 5055, 1, 381800)","{""AMETHYSTS"": 11, ""STARFRUIT"": 5}",3451,5052,10000
381900,-10100,-141909,"(STARFRUIT, US << MARKET, 5050, 1, 381900)
(STARFRUIT, US << MARKET, 5050, 1, 381900)","{""AMETHYSTS"": 11, ""STARFRUIT"": 7}",3462,5053,10000
382000,-5055,-146964,"(STARFRUIT, US << MARKET, 5055, 1, 382000)","{""AMETHYSTS"": 11, ""STARFRUIT"": 8}",3452,5052,10000
382200,29985,-116979,"(AMETHYSTS, MARKET << US, 9995, 1, 382200)
(AMETHYSTS, MARKET << US, 9995, 1, 382200)
(AMETHYSTS, MARKET << US, 9995, 1, 382200)","{""AMETHYSTS"": 8, ""STARFRUIT"": 8}",3445,5053,10000
382500,-19996,-136975,"(AMETHYSTS, US << MARKET, 9998, 1, 382500)
(AMETHYSTS, US << MARKET, 9998, 1, 382500)","{""AMETHYSTS"": 10, ""STARFRUIT"": 8}",3409,5053,9996
383000,-20200,-157175,"(STARFRUIT, US << MARKET, 5050, 1, 383000)
(STARFRUIT, US << MARKET, 5050, 1, 383000)
(STARFRUIT, US << MARKET, 5050, 1, 383000)
(STARFRUIT, US << MARKET, 5050, 1, 383000)","{""AMETHYSTS"": 10, ""STARFRUIT"": 12}",3461,5053,10000
383400,-15162,-172337,"(STARFRUIT, US << MARKET, 5054, 1, 383400)
(STARFRUIT, US << MARKET, 5054, 1, 383400)
(STARFRUIT, US << MARKET, 5054, 1, 383400)","{""AMETHYSTS"": 10, ""STARFRUIT"": 15}",3488,5055,10000
383600,5055,-167282,"(STARFRUIT, MARKET << US, 5055, 1, 383600)","{""AMETHYSTS"": 10, ""STARFRUIT"": 14}",3482,5056,9998
383900,-29856,-197138,"(AMETHYSTS, US << MARKET, 9998, 1, 383900)
(AMETHYSTS, US << MARKET, 9998, 1, 383900)
(AMETHYSTS, US << MARKET, 9998, 1, 383900)
(AMETHYSTS, US << MARKET, 9998, 1, 383900)
(AMETHYSTS, US << MARKET, 9998, 1, 383900)
(AMETHYSTS, US << MARKET, 9998, 1, 383900)
(AMETHYSTS, US << MARKET, 9998, 1, 383900)
(AMETHYSTS, US << MARKET, 9998, 1, 383900)
(AMETHYSTS, MARKET << US, 10004, 1, 383900)
(AMETHYSTS, MARKET << US, 10004, 1, 383900)
(AMETHYSTS, MARKET << US, 10004, 1, 383900)
(AMETHYSTS, MARKET << US, 10004, 1, 383900)
(STARFRUIT, MARKET << US, 5056, 1, 383900)
(STARFRUIT, MARKET << US, 5056, 1, 383900)","{""AMETHYSTS"": 14, ""STARFRUIT"": 12}",3500,5052,10001
384000,-20196,-217334,"(STARFRUIT, US << MARKET, 5049, 1, 384000)
(STARFRUIT, US << MARKET, 5049, 1, 384000)
(STARFRUIT, US << MARKET, 5049, 1, 384000)
(STARFRUIT, US << MARKET, 5049, 1, 384000)","{""AMETHYSTS"": 14, ""STARFRUIT"": 16}",3498,5052,10000
384200,40384,-176950,"(STARFRUIT, MARKET << US, 5048, 1, 384200)
(STARFRUIT, MARKET << US, 5048, 1, 384200)
(STARFRUIT, MARKET << US, 5048, 1, 384200)
(STARFRUIT, MARKET << US, 5048, 1, 384200)
(STARFRUIT, MARKET << US, 5048, 1, 384200)
(STARFRUIT, MARKET << US, 5048, 1, 384200)
(STARFRUIT, MARKET << US, 5048, 1, 384200)
(STARFRUIT, MARKET << US, 5048, 1, 384200)","{""AMETHYSTS"": 14, ""STARFRUIT"": 8}",3458,5051,10000
384600,-4950,-181900,"(AMETHYSTS, US << MARKET, 10005, 1, 384600)
(STARFRUIT, MARKET << US, 5055, 1, 384600)","{""AMETHYSTS"": 15, ""STARFRUIT"": 7}",3464,5052,10000
384900,9998,-171902,"(AMETHYSTS, MARKET << US, 9998, 1, 384900)","{""AMETHYSTS"": 14, ""STARFRUIT"": 7}",3455,5051,10000
385000,15043,-156859,"(AMETHYSTS, MARKET << US, 9995, 1, 385000)
(STARFRUIT, MARKET << US, 5048, 1, 385000)","{""AMETHYSTS"": 13, ""STARFRUIT"": 6}",3447,5051,10000
385300,5062,-151797,"(AMETHYSTS, US << MARKET, 9995, 1, 385300)
(AMETHYSTS, US << MARKET, 9995, 1, 385300)
(AMETHYSTS, MARKET << US, 10002, 1, 385300)
(AMETHYSTS, MARKET << US, 10002, 1, 385300)
(STARFRUIT, MARKET << US, 5048, 1, 385300)","{""AMETHYSTS"": 13, ""STARFRUIT"": 5}",3432,5051,9998
385600,5054,-146743,"(STARFRUIT, MARKET << US, 5054, 1, 385600)","{""AMETHYSTS"": 13, ""STARFRUIT"": 4}",3473,5054,10000
385800,10110,-136633,"(STARFRUIT, MARKET << US, 5055, 1, 385800)
(STARFRUIT, MARKET << US, 5055, 1, 385800)","{""AMETHYSTS"": 13, ""STARFRUIT"": 2}",3477,5055,10000
385900,20004,-116629,"(AMETHYSTS, MARKET << US, 10002, 1, 385900)
(AMETHYSTS, MARKET << US, 10002, 1, 385900)","{""AMETHYSTS"": 11, ""STARFRUIT"": 2}",3508,5052,10003
386100,-5266,-121895,"(AMETHYSTS, MARKET << US, 10002, 1, 386100)
(AMETHYSTS, MARKET << US, 10002, 1, 386100)
(STARFRUIT, US << MARKET, 5054, 1, 386100)
(STARFRUIT, US << MARKET, 5054, 1, 386100)
(STARFRUIT, US << MARKET, 5054, 1, 386100)
(STARFRUIT, US << MARKET, 5054, 1, 386100)
(STARFRUIT, US << MARKET, 5054, 1, 386100)","{""AMETHYSTS"": 9, ""STARFRUIT"": 7}",3517,5055,10003
386200,50128,-71767,"(AMETHYSTS, MARKET << US, 10004, 1, 386200)
(AMETHYSTS, MARKET << US, 10004, 1, 386200)
(AMETHYSTS, MARKET << US, 10004, 1, 386200)
(AMETHYSTS, MARKET << US, 10004, 1, 386200)
(STARFRUIT, MARKET << US, 5056, 1, 386200)
(STARFRUIT, MARKET << US, 5056, 1, 386200)","{""AMETHYSTS"": 5, ""STARFRUIT"": 5}",3513,5053,10003
386300,-10110,-81877,"(STARFRUIT, US << MARKET, 5055, 1, 386300)
(STARFRUIT, US << MARKET, 5055, 1, 386300)","{""AMETHYSTS"": 5, ""STARFRUIT"": 7}",3477,5052,9998
386400,40008,-41869,"(AMETHYSTS, MARKET << US, 10002, 1, 386400)
(AMETHYSTS, MARKET << US, 10002, 1, 386400)
(AMETHYSTS, MARKET << US, 10002, 1, 386400)
(AMETHYSTS, MARKET << US, 10002, 1, 386400)","{""AMETHYSTS"": 1, ""STARFRUIT"": 7}",3498,5052,10003
386600,19996,-21873,"(AMETHYSTS, MARKET << US, 9998, 1, 386600)
(AMETHYSTS, MARKET << US, 9998, 1, 386600)","{""AMETHYSTS"": -1, ""STARFRUIT"": 7}",3494,5052,9997
386700,29904,8031,"(AMETHYSTS, MARKET << US, 10004, 1, 386700)
(AMETHYSTS, MARKET << US, 10004, 1, 386700)
(AMETHYSTS, MARKET << US, 10004, 1, 386700)
(AMETHYSTS, MARKET << US, 10004, 1, 386700)
(STARFRUIT, US << MARKET, 5056, 1, 386700)
(STARFRUIT, US << MARKET, 5056, 1, 386700)","{""AMETHYSTS"": -5, ""STARFRUIT"": 9}",3493,5053,10003
386800,-40008,-31977,"(AMETHYSTS, US << MARKET, 10002, 1, 386800)
(AMETHYSTS, US << MARKET, 10002, 1, 386800)
(AMETHYSTS, US << MARKET, 10002, 1, 386800)
(AMETHYSTS, US << MARKET, 10002, 1, 386800)","{""AMETHYSTS"": -1, ""STARFRUIT"": 9}",3497,5053,10003
387700,5056,-26921,"(STARFRUIT, MARKET << US, 5056, 1, 387700)","{""AMETHYSTS"": -1, ""STARFRUIT"": 8}",3503,5053,10000
387900,5057,-21864,"(STARFRUIT, MARKET << US, 5057, 1, 387900)","{""AMETHYSTS"": -1, ""STARFRUIT"": 7}",3534,5057,10001
388000,-39992,-61856,"(AMETHYSTS, US << MARKET, 9998, 1, 388000)
(AMETHYSTS, US << MARKET, 9998, 1, 388000)
(AMETHYSTS, US << MARKET, 9998, 1, 388000)
(AMETHYSTS, US << MARKET, 9998, 1, 388000)","{""AMETHYSTS"": 3, ""STARFRUIT"": 7}",3506,5053,9997
388200,25285,-36571,"(STARFRUIT, MARKET << US, 5057, 1, 388200)
(STARFRUIT, MARKET << US, 5057, 1, 388200)
(STARFRUIT, MARKET << US, 5057, 1, 388200)
(STARFRUIT, MARKET << US, 5057, 1, 388200)
(STARFRUIT, MARKET << US, 5057, 1, 388200)","{""AMETHYSTS"": 3, ""STARFRUIT"": 2}",3545,5058,10000
388700,-20216,-56787,"(STARFRUIT, US << MARKET, 5054, 1, 388700)
(STARFRUIT, US << MARKET, 5054, 1, 388700)
(STARFRUIT, US << MARKET, 5054, 1, 388700)
(STARFRUIT, US << MARKET, 5054, 1, 388700)
(STARFRUIT, US << MARKET, 5054, 1, 388700)
(STARFRUIT, MARKET << US, 5054, 1, 388700)","{""AMETHYSTS"": 3, ""STARFRUIT"": 6}",3549,5056,10000
389000,9888,-46899,"(AMETHYSTS, MARKET << US, 10004, 1, 389000)
(AMETHYSTS, MARKET << US, 10004, 1, 389000)
(STARFRUIT, US << MARKET, 5060, 1, 389000)
(STARFRUIT, US << MARKET, 5060, 1, 389000)","{""AMETHYSTS"": 1, ""STARFRUIT"": 8}",3558,5057,10001
389200,-5059,-51958,"(STARFRUIT, US << MARKET, 5059, 1, 389200)","{""AMETHYSTS"": 1, ""STARFRUIT"": 9}",3580,5060,9998
389300,119952,67994,"(AMETHYSTS, MARKET << US, 9996, 1, 389300)
(AMETHYSTS, MARKET << US, 9996, 1, 389300)
(AMETHYSTS, MARKET << US, 9996, 1, 389300)
(AMETHYSTS, MARKET << US, 9996, 1, 389300)
(AMETHYSTS, MARKET << US, 9996, 1, 389300)
(AMETHYSTS, MARKET << US, 9996, 1, 389300)
(AMETHYSTS, MARKET << US, 9996, 1, 389300)
(AMETHYSTS, MARKET << US, 9996, 1, 389300)
(AMETHYSTS, MARKET << US, 9996, 1, 389300)
(AMETHYSTS, MARKET << US, 9996, 1, 389300)
(AMETHYSTS, MARKET << US, 9996, 1, 389300)
(AMETHYSTS, MARKET << US, 9996, 1, 389300)","{""AMETHYSTS"": -11, ""STARFRUIT"": 9}",3507,5057,10000
389400,40361,108355,"(AMETHYSTS, MARKET << US, 9995, 1, 389400)
(STARFRUIT, MARKET << US, 5061, 1, 389400)
(STARFRUIT, MARKET << US, 5061, 1, 389400)
(STARFRUIT, MARKET << US, 5061, 1, 389400)
(STARFRUIT, MARKET << US, 5061, 1, 389400)
(STARFRUIT, MARKET << US, 5061, 1, 389400)
(STARFRUIT, MARKET << US, 5061, 1, 389400)","{""AMETHYSTS"": -12, ""STARFRUIT"": 3}",3529,5058,10000
389700,15168,123523,"(STARFRUIT, MARKET << US, 5056, 1, 389700)
(STARFRUIT, MARKET << US, 5056, 1, 389700)
(STARFRUIT, MARKET << US, 5056, 1, 389700)","{""AMETHYSTS"": -12, ""STARFRUIT"": 0}",3523,5055,10000
389900,-10002,113521,"(AMETHYSTS, US << MARKET, 10002, 1, 389900)","{""AMETHYSTS"": -11, ""STARFRUIT"": 0}",3488,5058,10003
390200,25069,138590,"(AMETHYSTS, MARKET << US, 10004, 1, 390200)
(AMETHYSTS, MARKET << US, 10004, 1, 390200)
(STARFRUIT, MARKET << US, 5061, 1, 390200)","{""AMETHYSTS"": -13, ""STARFRUIT"": -1}",3530,5060,10000
390400,-30342,108248,"(STARFRUIT, US << MARKET, 5057, 1, 390400)
(STARFRUIT, US << MARKET, 5057, 1, 390400)
(STARFRUIT, US << MARKET, 5057, 1, 390400)
(STARFRUIT, US << MARKET, 5057, 1, 390400)
(STARFRUIT, US << MARKET, 5057, 1, 390400)
(STARFRUIT, US << MARKET, 5057, 1, 390400)","{""AMETHYSTS"": -13, ""STARFRUIT"": 5}",3541,5056,9999
390600,9998,118246,"(AMETHYSTS, MARKET << US, 9998, 1, 390600)","{""AMETHYSTS"": -14, ""STARFRUIT"": 5}",3517,5057,10001
391200,15165,133411,"(STARFRUIT, MARKET << US, 5055, 1, 391200)
(STARFRUIT, MARKET << US, 5055, 1, 391200)
(STARFRUIT, MARKET << US, 5055, 1, 391200)","{""AMETHYSTS"": -14, ""STARFRUIT"": 2}",3519,5054,10000
391500,65083,198494,"(AMETHYSTS, MARKET << US, 10005, 1, 391500)
(AMETHYSTS, MARKET << US, 10005, 1, 391500)
(AMETHYSTS, MARKET << US, 10005, 1, 391500)
(AMETHYSTS, MARKET << US, 10005, 1, 391500)
(AMETHYSTS, MARKET << US, 10005, 1, 391500)
(AMETHYSTS, MARKET << US, 10005, 1, 391500)
(STARFRUIT, MARKET << US, 5053, 1, 391500)","{""AMETHYSTS"": -20, ""STARFRUIT"": 1}",3550,5056,10000
392000,-29876,168618,"(AMETHYSTS, US << MARKET, 9996, 1, 392000)
(AMETHYSTS, US << MARKET, 9996, 1, 392000)
(AMETHYSTS, US << MARKET, 9996, 1, 392000)
(AMETHYSTS, US << MARKET, 9996, 1, 392000)
(STARFRUIT, MARKET << US, 5054, 1, 392000)
(STARFRUIT, MARKET << US, 5054, 1, 392000)","{""AMETHYSTS"": -16, ""STARFRUIT"": -1}",3561,5057,10000
392200,10106,178724,"(STARFRUIT, MARKET << US, 5053, 1, 392200)
(STARFRUIT, MARKET << US, 5053, 1, 392200)","{""AMETHYSTS"": -16, ""STARFRUIT"": -3}",3543,5055,10001
392300,25290,204014,"(STARFRUIT, MARKET << US, 5058, 1, 392300)
(STARFRUIT, MARKET << US, 5058, 1, 392300)
(STARFRUIT, MARKET << US, 5058, 1, 392300)
(STARFRUIT, MARKET << US, 5058, 1, 392300)
(STARFRUIT, MARKET << US, 5058, 1, 392300)","{""AMETHYSTS"": -16, ""STARFRUIT"": -8}",3542,5059,10000
392800,9776,213790,"(AMETHYSTS, MARKET << US, 10004, 1, 392800)
(AMETHYSTS, MARKET << US, 10004, 1, 392800)
(AMETHYSTS, MARKET << US, 10004, 1, 392800)
(STARFRUIT, US << MARKET, 5059, 1, 392800)
(STARFRUIT, US << MARKET, 5059, 1, 392800)
(STARFRUIT, US << MARKET, 5059, 1, 392800)
(STARFRUIT, US << MARKET, 5059, 1, 392800)","{""AMETHYSTS"": -19, ""STARFRUIT"": -4}",3566,5056,10000
393000,-19996,193794,"(AMETHYSTS, US << MARKET, 9998, 1, 393000)
(AMETHYSTS, US << MARKET, 9998, 1, 393000)","{""AMETHYSTS"": -17, ""STARFRUIT"": -4}",3621,5056,9997
393300,-30348,163446,"(STARFRUIT, US << MARKET, 5058, 1, 393300)
(STARFRUIT, US << MARKET, 5058, 1, 393300)
(STARFRUIT, US << MARKET, 5058, 1, 393300)
(STARFRUIT, US << MARKET, 5058, 1, 393300)
(STARFRUIT, US << MARKET, 5058, 1, 393300)
(STARFRUIT, US << MARKET, 5058, 1, 393300)","{""AMETHYSTS"": -17, ""STARFRUIT"": 2}",3581,5059,9999
393700,-25300,138146,"(STARFRUIT, US << MARKET, 5060, 1, 393700)
(STARFRUIT, US << MARKET, 5060, 1, 393700)
(STARFRUIT, US << MARKET, 5060, 1, 393700)
(STARFRUIT, US << MARKET, 5060, 1, 393700)
(STARFRUIT, US << MARKET, 5060, 1, 393700)","{""AMETHYSTS"": -17, ""STARFRUIT"": 7}",3545,5057,10000
393800,9888,148034,"(AMETHYSTS, MARKET << US, 9998, 1, 393800)
(AMETHYSTS, MARKET << US, 9996, 1, 393800)
(STARFRUIT, US << MARKET, 5053, 1, 393800)
(STARFRUIT, US << MARKET, 5053, 1, 393800)","{""AMETHYSTS"": -19, ""STARFRUIT"": 9}",3586,5055,9997
394100,-119854,28180,"(AMETHYSTS, US << MARKET, 9998, 1, 394100)
(AMETHYSTS, US << MARKET, 9998, 1, 394100)
(AMETHYSTS, US << MARKET, 9998, 1, 394100)
(AMETHYSTS, US << MARKET, 9998, 1, 394100)
(AMETHYSTS, US << MARKET, 9998, 1, 394100)
(AMETHYSTS, US << MARKET, 9998, 1, 394100)
(AMETHYSTS, US << MARKET, 9998, 1, 394100)
(AMETHYSTS, US << MARKET, 9998, 1, 394100)
(AMETHYSTS, US << MARKET, 9998, 1, 394100)
(AMETHYSTS, US << MARKET, 9998, 1, 394100)
(AMETHYSTS, US << MARKET, 9998, 1, 394100)
(AMETHYSTS, US << MARKET, 9998, 1, 394100)
(AMETHYSTS, US << MARKET, 9998, 1, 394100)
(AMETHYSTS, US << MARKET, 9998, 1, 394100)
(AMETHYSTS, MARKET << US, 9998, 1, 394100)
(STARFRUIT, MARKET << US, 5060, 1, 394100)
(STARFRUIT, MARKET << US, 5060, 1, 394100)","{""AMETHYSTS"": -6, ""STARFRUIT"": 7}",3590,5056,9997
394200,4945,33125,"(AMETHYSTS, MARKET << US, 9998, 1, 394200)
(STARFRUIT, US << MARKET, 5053, 1, 394200)","{""AMETHYSTS"": -7, ""STARFRUIT"": 8}",3594,5056,9997
394300,-4944,28181,"(AMETHYSTS, US << MARKET, 10004, 1, 394300)
(STARFRUIT, MARKET << US, 5060, 1, 394300)","{""AMETHYSTS"": -6, ""STARFRUIT"": 7}",3573,5056,10000
394600,-34927,-6746,"(AMETHYSTS, US << MARKET, 9995, 1, 394600)
(AMETHYSTS, US << MARKET, 9995, 1, 394600)
(AMETHYSTS, US << MARKET, 9995, 1, 394600)
(AMETHYSTS, US << MARKET, 9995, 1, 394600)
(STARFRUIT, MARKET << US, 5053, 1, 394600)","{""AMETHYSTS"": -2, ""STARFRUIT"": 6}",3566,5052,10000
395300,49990,43244,"(AMETHYSTS, MARKET << US, 9998, 1, 395300)
(AMETHYSTS, MARKET << US, 9998, 1, 395300)
(AMETHYSTS, MARKET << US, 9998, 1, 395300)
(AMETHYSTS, MARKET << US, 9998, 1, 395300)
(AMETHYSTS, MARKET << US, 9998, 1, 395300)","{""AMETHYSTS"": -7, ""STARFRUIT"": 6}",3596,5054,9996
395400,-20232,23012,"(STARFRUIT, US << MARKET, 5058, 1, 395400)
(STARFRUIT, US << MARKET, 5058, 1, 395400)
(STARFRUIT, US << MARKET, 5058, 1, 395400)
(STARFRUIT, US << MARKET, 5058, 1, 395400)","{""AMETHYSTS"": -7, ""STARFRUIT"": 10}",3552,5054,10000
395600,15051,38063,"(AMETHYSTS, MARKET << US, 9998, 1, 395600)
(STARFRUIT, MARKET << US, 5053, 1, 395600)","{""AMETHYSTS"": -8, ""STARFRUIT"": 9}",3559,5056,10001
395800,-20236,17827,"(STARFRUIT, US << MARKET, 5059, 1, 395800)
(STARFRUIT, US << MARKET, 5059, 1, 395800)
(STARFRUIT, US << MARKET, 5059, 1, 395800)
(STARFRUIT, US << MARKET, 5059, 1, 395800)","{""AMETHYSTS"": -8, ""STARFRUIT"": 13}",3542,5055,10000
396100,-39992,-22165,"(AMETHYSTS, US << MARKET, 9998, 1, 396100)
(AMETHYSTS, US << MARKET, 9998, 1, 396100)
(AMETHYSTS, US << MARKET, 9998, 1, 396100)
(AMETHYSTS, US << MARKET, 9998, 1, 396100)","{""AMETHYSTS"": -4, ""STARFRUIT"": 13}",3563,5056,10000
396200,145022,122857,"(AMETHYSTS, MARKET << US, 10005, 1, 396200)
(AMETHYSTS, MARKET << US, 10005, 1, 396200)
(AMETHYSTS, MARKET << US, 10005, 1, 396200)
(AMETHYSTS, MARKET << US, 10005, 1, 396200)
(AMETHYSTS, MARKET << US, 10005, 1, 396200)
(AMETHYSTS, MARKET << US, 10005, 1, 396200)
(AMETHYSTS, MARKET << US, 10005, 1, 396200)
(AMETHYSTS, MARKET << US, 10005, 1, 396200)
(AMETHYSTS, MARKET << US, 10005, 1, 396200)
(AMETHYSTS, MARKET << US, 10005, 1, 396200)
(AMETHYSTS, MARKET << US, 10005, 1, 396200)
(AMETHYSTS, MARKET << US, 10005, 1, 396200)
(AMETHYSTS, MARKET << US, 10005, 1, 396200)
(AMETHYSTS, MARKET << US, 10005, 1, 396200)
(AMETHYSTS, MARKET << US, 10005, 1, 396200)
(STARFRUIT, US << MARKET, 5053, 1, 396200)","{""AMETHYSTS"": -19, ""STARFRUIT"": 14}",3641,5056,10000
396300,10002,132859,"(AMETHYSTS, MARKET << US, 10002, 1, 396300)","{""AMETHYSTS"": -20, ""STARFRUIT"": 14}",3569,5055,10003
397000,-20126,112733,"(AMETHYSTS, US << MARKET, 10004, 1, 397000)
(STARFRUIT, US << MARKET, 5061, 1, 397000)
(STARFRUIT, US << MARKET, 5061, 1, 397000)","{""AMETHYSTS"": -19, ""STARFRUIT"": 16}",3661,5058,10000
397300,10002,122735,"(AMETHYSTS, MARKET << US, 10002, 1, 397300)","{""AMETHYSTS"": -20, ""STARFRUIT"": 16}",3651,5056,9999
397600,-10108,112627,"(STARFRUIT, US << MARKET, 5054, 1, 397600)
(STARFRUIT, US << MARKET, 5054, 1, 397600)","{""AMETHYSTS"": -20, ""STARFRUIT"": 18}",3653,5057,10000
397700,5054,117681,"(STARFRUIT, MARKET << US, 5054, 1, 397700)","{""AMETHYSTS"": -20, ""STARFRUIT"": 17}",3693,5056,9997
398000,0,117681,,"{""AMETHYSTS"": -20, ""STARFRUIT"": 17}",3650,5057,10000
398400,0,117681,,"{""AMETHYSTS"": -20, ""STARFRUIT"": 17}",3730,5057,9996
398700,5054,122735,"(STARFRUIT, MARKET << US, 5054, 1, 398700)","{""AMETHYSTS"": -20, ""STARFRUIT"": 16}",3667,5057,9999
399000,5059,127794,"(STARFRUIT, MARKET << US, 5059, 1, 399000)","{""AMETHYSTS"": -20, ""STARFRUIT"": 15}",3614,5056,10001
399100,5054,132848,"(STARFRUIT, MARKET << US, 5054, 1, 399100)","{""AMETHYSTS"": -20, ""STARFRUIT"": 14}",3632,5056,10000
399900,-39984,92864,"(AMETHYSTS, US << MARKET, 9996, 1, 399900)
(AMETHYSTS, US << MARKET, 9996, 1, 399900)
(AMETHYSTS, US << MARKET, 9996, 1, 399900)
(AMETHYSTS, US << MARKET, 9996, 1, 399900)","{""AMETHYSTS"": -16, ""STARFRUIT"": 14}",3662,5057,10000
400000,5053,97917,"(STARFRUIT, MARKET << US, 5053, 1, 400000)","{""AMETHYSTS"": -16, ""STARFRUIT"": 13}",3626,5057,10002
400300,5053,102970,"(STARFRUIT, MARKET << US, 5053, 1, 400300)","{""AMETHYSTS"": -16, ""STARFRUIT"": 12}",3630,5055,10000
400700,5053,108023,"(STARFRUIT, MARKET << US, 5053, 1, 400700)","{""AMETHYSTS"": -16, ""STARFRUIT"": 11}",3644,5055,9999
400800,10116,118139,"(STARFRUIT, MARKET << US, 5058, 1, 400800)
(STARFRUIT, MARKET << US, 5058, 1, 400800)","{""AMETHYSTS"": -16, ""STARFRUIT"": 9}",3670,5059,10000
401100,40200,158339,"(AMETHYSTS, MARKET << US, 9996, 1, 401100)
(AMETHYSTS, MARKET << US, 9996, 1, 401100)
(STARFRUIT, MARKET << US, 5052, 1, 401100)
(STARFRUIT, MARKET << US, 5052, 1, 401100)
(STARFRUIT, MARKET << US, 5052, 1, 401100)
(STARFRUIT, MARKET << US, 5052, 1, 401100)","{""AMETHYSTS"": -18, ""STARFRUIT"": 5}",3614,5055,10000
401300,10106,168445,"(STARFRUIT, MARKET << US, 5053, 1, 401300)
(STARFRUIT, MARKET << US, 5053, 1, 401300)","{""AMETHYSTS"": -18, ""STARFRUIT"": 3}",3682,5055,9996
402400,20004,188449,"(AMETHYSTS, MARKET << US, 10002, 1, 402400)
(AMETHYSTS, MARKET << US, 10002, 1, 402400)","{""AMETHYSTS"": -20, ""STARFRUIT"": 3}",3640,5057,9999
402600,-10120,178329,"(STARFRUIT, US << MARKET, 5060, 1, 402600)
(STARFRUIT, US << MARKET, 5060, 1, 402600)","{""AMETHYSTS"": -20, ""STARFRUIT"": 5}",3609,5060,10001
403400,0,178329,,"{""AMETHYSTS"": -20, ""STARFRUIT"": 5}",3664,5055,9997
403600,-30006,148323,"(AMETHYSTS, US << MARKET, 10002, 1, 403600)
(AMETHYSTS, US << MARKET, 10002, 1, 403600)
(AMETHYSTS, US << MARKET, 10002, 1, 403600)","{""AMETHYSTS"": -17, ""STARFRUIT"": 5}",3572,5060,10003
404300,-10120,138203,"(STARFRUIT, US << MARKET, 5060, 1, 404300)
(STARFRUIT, US << MARKET, 5060, 1, 404300)","{""AMETHYSTS"": -17, ""STARFRUIT"": 7}",3623,5060,10000
404400,-5054,133149,"(STARFRUIT, US << MARKET, 5054, 1, 404400)","{""AMETHYSTS"": -17, ""STARFRUIT"": 8}",3605,5057,10000
404500,-9888,123261,"(AMETHYSTS, US << MARKET, 10005, 1, 404500)
(AMETHYSTS, US << MARKET, 10005, 1, 404500)
(STARFRUIT, MARKET << US, 5061, 1, 404500)
(STARFRUIT, MARKET << US, 5061, 1, 404500)","{""AMETHYSTS"": -15, ""STARFRUIT"": 6}",3603,5057,10000
404700,19740,143001,"(AMETHYSTS, MARKET << US, 9996, 1, 404700)
(AMETHYSTS, MARKET << US, 9996, 1, 404700)
(AMETHYSTS, MARKET << US, 9996, 1, 404700)
(AMETHYSTS, MARKET << US, 9996, 1, 404700)
(STARFRUIT, US << MARKET, 5061, 1, 404700)
(STARFRUIT, US << MARKET, 5061, 1, 404700)
(STARFRUIT, US << MARKET, 5061, 1, 404700)
(STARFRUIT, US << MARKET, 5061, 1, 404700)","{""AMETHYSTS"": -19, ""STARFRUIT"": 10}",3628,5057,9997
404800,-199900,-56899,"(AMETHYSTS, US << MARKET, 9995, 1, 404800)
(AMETHYSTS, US << MARKET, 9995, 1, 404800)
(AMETHYSTS, US << MARKET, 9995, 1, 404800)
(AMETHYSTS, US << MARKET, 9995, 1, 404800)
(AMETHYSTS, US << MARKET, 9995, 1, 404800)
(AMETHYSTS, US << MARKET, 9995, 1, 404800)
(AMETHYSTS, US << MARKET, 9995, 1, 404800)
(AMETHYSTS, US << MARKET, 9995, 1, 404800)
(AMETHYSTS, US << MARKET, 9995, 1, 404800)
(AMETHYSTS, US << MARKET, 9995, 1, 404800)
(AMETHYSTS, US << MARKET, 9995, 1, 404800)
(AMETHYSTS, US << MARKET, 9995, 1, 404800)
(AMETHYSTS, US << MARKET, 9995, 1, 404800)
(AMETHYSTS, US << MARKET, 9995, 1, 404800)
(AMETHYSTS, US << MARKET, 9995, 1, 404800)
(AMETHYSTS, US << MARKET, 9995, 1, 404800)
(AMETHYSTS, US << MARKET, 9995, 1, 404800)
(AMETHYSTS, US << MARKET, 9995, 1, 404800)
(AMETHYSTS, US << MARKET, 9995, 1, 404800)
(AMETHYSTS, US << MARKET, 9995, 1, 404800)","{""AMETHYSTS"": 1, ""STARFRUIT"": 10}",3661,5056,10000
405000,25064,-31835,"(AMETHYSTS, MARKET << US, 10002, 1, 405000)
(AMETHYSTS, MARKET << US, 10002, 1, 405000)
(STARFRUIT, MARKET << US, 5060, 1, 405000)","{""AMETHYSTS"": -1, ""STARFRUIT"": 9}",3679,5057,9999
405300,19996,-11839,"(AMETHYSTS, MARKET << US, 9998, 1, 405300)
(AMETHYSTS, MARKET << US, 9998, 1, 405300)","{""AMETHYSTS"": -3, ""STARFRUIT"": 9}",3662,5056,10001
405600,-159831,-171670,"(AMETHYSTS, US << MARKET, 9996, 1, 405600)
(AMETHYSTS, US << MARKET, 9996, 1, 405600)
(AMETHYSTS, US << MARKET, 9996, 1, 405600)
(AMETHYSTS, US << MARKET, 9996, 1, 405600)
(AMETHYSTS, US << MARKET, 9996, 1, 405600)
(AMETHYSTS, US << MARKET, 9996, 1, 405600)
(AMETHYSTS, US << MARKET, 9996, 1, 405600)
(AMETHYSTS, US << MARKET, 9996, 1, 405600)
(AMETHYSTS, US << MARKET, 9996, 1, 405600)
(AMETHYSTS, US << MARKET, 9996, 1, 405600)
(AMETHYSTS, US << MARKET, 9996, 1, 405600)
(AMETHYSTS, US << MARKET, 9996, 1, 405600)
(AMETHYSTS, US << MARKET, 9996, 1, 405600)
(AMETHYSTS, US << MARKET, 9996, 1, 405600)
(AMETHYSTS, US << MARKET, 9996, 1, 405600)
(AMETHYSTS, US << MARKET, 9996, 1, 405600)
(AMETHYSTS, US << MARKET, 9996, 1, 405600)
(AMETHYSTS, US << MARKET, 9996, 1, 405600)
(AMETHYSTS, US << MARKET, 9996, 1, 405600)
(AMETHYSTS, US << MARKET, 9996, 1, 405600)
(AMETHYSTS, US << MARKET, 9996, 1, 405600)
(AMETHYSTS, US << MARKET, 9996, 1, 405600)
(AMETHYSTS, MARKET << US, 9995, 1, 405600)
(AMETHYSTS, MARKET << US, 9995, 1, 405600)
(AMETHYSTS, MARKET << US, 9995, 1, 405600)
(AMETHYSTS, MARKET << US, 9995, 1, 405600)
(AMETHYSTS, MARKET << US, 9995, 1, 405600)
(STARFRUIT, MARKET << US, 5053, 1, 405600)
(STARFRUIT, MARKET << US, 5053, 1, 405600)","{""AMETHYSTS"": 14, ""STARFRUIT"": 7}",3715,5055,10000
407600,-5049,-176719,"(AMETHYSTS, US << MARKET, 10004, 1, 407600)
(AMETHYSTS, US << MARKET, 10004, 1, 407600)
(AMETHYSTS, MARKET << US, 10004, 1, 407600)
(AMETHYSTS, MARKET << US, 10004, 1, 407600)
(STARFRUIT, US << MARKET, 5049, 1, 407600)","{""AMETHYSTS"": 14, ""STARFRUIT"": 8}",3713,5054,10000
407700,60012,-116707,"(AMETHYSTS, MARKET << US, 10002, 1, 407700)
(AMETHYSTS, MARKET << US, 10002, 1, 407700)
(AMETHYSTS, MARKET << US, 10002, 1, 407700)
(AMETHYSTS, MARKET << US, 10002, 1, 407700)
(AMETHYSTS, MARKET << US, 10002, 1, 407700)
(AMETHYSTS, MARKET << US, 10002, 1, 407700)","{""AMETHYSTS"": 8, ""STARFRUIT"": 8}",3725,5051,10003
408200,135211,18504,"(AMETHYSTS, MARKET << US, 9996, 1, 408200)
(AMETHYSTS, MARKET << US, 9996, 1, 408200)
(AMETHYSTS, MARKET << US, 9996, 1, 408200)
(AMETHYSTS, MARKET << US, 9996, 1, 408200)
(AMETHYSTS, MARKET << US, 9996, 1, 408200)
(AMETHYSTS, MARKET << US, 9996, 1, 408200)
(AMETHYSTS, MARKET << US, 9996, 1, 408200)
(AMETHYSTS, MARKET << US, 9996, 1, 408200)
(AMETHYSTS, MARKET << US, 9996, 1, 408200)
(AMETHYSTS, MARKET << US, 9996, 1, 408200)
(AMETHYSTS, MARKET << US, 9996, 1, 408200)
(STARFRUIT, MARKET << US, 5051, 1, 408200)
(STARFRUIT, MARKET << US, 5051, 1, 408200)
(STARFRUIT, MARKET << US, 5051, 1, 408200)
(STARFRUIT, MARKET << US, 5051, 1, 408200)
(STARFRUIT, MARKET << US, 5051, 1, 408200)","{""AMETHYSTS"": -3, ""STARFRUIT"": 3}",3657,5049,9998
408400,-29882,-11378,"(AMETHYSTS, US << MARKET, 9998, 1, 408400)
(AMETHYSTS, US << MARKET, 9998, 1, 408400)
(AMETHYSTS, US << MARKET, 9998, 1, 408400)
(AMETHYSTS, US << MARKET, 9998, 1, 408400)
(STARFRUIT, MARKET << US, 5055, 1, 408400)
(STARFRUIT, MARKET << US, 5055, 1, 408400)","{""AMETHYSTS"": 1, ""STARFRUIT"": 1}",3669,5051,9996
408600,9900,-1478,"(AMETHYSTS, MARKET << US, 10004, 1, 408600)
(AMETHYSTS, MARKET << US, 10004, 1, 408600)
(STARFRUIT, US << MARKET, 5054, 1, 408600)
(STARFRUIT, US << MARKET, 5054, 1, 408600)","{""AMETHYSTS"": -1, ""STARFRUIT"": 3}",3674,5051,10001
409000,20004,18526,"(AMETHYSTS, MARKET << US, 10002, 1, 409000)
(AMETHYSTS, MARKET << US, 10002, 1, 409000)","{""AMETHYSTS"": -3, ""STARFRUIT"": 3}",3667,5050,10003
409100,-15156,3370,"(STARFRUIT, US << MARKET, 5052, 1, 409100)
(STARFRUIT, US << MARKET, 5052, 1, 409100)
(STARFRUIT, US << MARKET, 5052, 1, 409100)","{""AMETHYSTS"": -3, ""STARFRUIT"": 6}",3682,5053,10002
409400,20000,23370,"(AMETHYSTS, MARKET << US, 10000, 1, 409400)
(AMETHYSTS, MARKET << US, 10000, 1, 409400)
(STARFRUIT, US << MARKET, 5050, 1, 409400)
(STARFRUIT, US << MARKET, 5050, 1, 409400)
(STARFRUIT, MARKET << US, 5050, 1, 409400)
(STARFRUIT, MARKET << US, 5050, 1, 409400)","{""AMETHYSTS"": -5, ""STARFRUIT"": 6}",3668,5048,9998
410000,5048,28418,"(STARFRUIT, MARKET << US, 5048, 1, 410000)","{""AMETHYSTS"": -5, ""STARFRUIT"": 5}",3673,5052,10001
410100,-29896,-1478,"(AMETHYSTS, US << MARKET, 9998, 1, 410100)
(AMETHYSTS, US << MARKET, 9998, 1, 410100)
(AMETHYSTS, US << MARKET, 9998, 1, 410100)
(AMETHYSTS, US << MARKET, 9998, 1, 410100)
(STARFRUIT, MARKET << US, 5048, 1, 410100)
(STARFRUIT, MARKET << US, 5048, 1, 410100)","{""AMETHYSTS"": -1, ""STARFRUIT"": 3}",3674,5051,10001
410200,-19996,-21474,"(AMETHYSTS, US << MARKET, 9998, 1, 410200)
(AMETHYSTS, US << MARKET, 9998, 1, 410200)","{""AMETHYSTS"": 1, ""STARFRUIT"": 3}",3672,5050,9996
410400,10094,-11380,"(STARFRUIT, US << MARKET, 5047, 1, 410400)
(STARFRUIT, US << MARKET, 5047, 1, 410400)
(STARFRUIT, MARKET << US, 5047, 1, 410400)
(STARFRUIT, MARKET << US, 5047, 1, 410400)
(STARFRUIT, MARKET << US, 5047, 1, 410400)
(STARFRUIT, MARKET << US, 5047, 1, 410400)","{""AMETHYSTS"": 1, ""STARFRUIT"": 1}",3671,5050,10001
410800,-184,-11564,"(AMETHYSTS, MARKET << US, 10002, 1, 410800)
(AMETHYSTS, MARKET << US, 10002, 1, 410800)
(STARFRUIT, US << MARKET, 5047, 1, 410800)
(STARFRUIT, US << MARKET, 5047, 1, 410800)
(STARFRUIT, US << MARKET, 5047, 1, 410800)
(STARFRUIT, US << MARKET, 5047, 1, 410800)","{""AMETHYSTS"": -1, ""STARFRUIT"": 5}",3678,5049,10003
411200,25240,13676,"(STARFRUIT, MARKET << US, 5048, 1, 411200)
(STARFRUIT, MARKET << US, 5048, 1, 411200)
(STARFRUIT, MARKET << US, 5048, 1, 411200)
(STARFRUIT, MARKET << US, 5048, 1, 411200)
(STARFRUIT, MARKET << US, 5048, 1, 411200)","{""AMETHYSTS"": -1, ""STARFRUIT"": 0}",3676,5051,10000
411400,-25240,-11564,"(STARFRUIT, US << MARKET, 5048, 1, 411400)
(STARFRUIT, US << MARKET, 5048, 1, 411400)
(STARFRUIT, US << MARKET, 5048, 1, 411400)
(STARFRUIT, US << MARKET, 5048, 1, 411400)
(STARFRUIT, US << MARKET, 5048, 1, 411400)
(STARFRUIT, US << MARKET, 5048, 1, 411400)
(STARFRUIT, MARKET << US, 5048, 1, 411400)","{""AMETHYSTS"": -1, ""STARFRUIT"": 5}",3691,5051,10000
411500,19996,8432,"(AMETHYSTS, MARKET << US, 9998, 1, 411500)
(AMETHYSTS, MARKET << US, 9998, 1, 411500)","{""AMETHYSTS"": -3, ""STARFRUIT"": 5}",3669,5048,10001
411700,-10108,-1676,"(STARFRUIT, US << MARKET, 5054, 1, 411700)
(STARFRUIT, US << MARKET, 5054, 1, 411700)","{""AMETHYSTS"": -3, ""STARFRUIT"": 7}",3696,5054,10002
411800,5053,3377,"(STARFRUIT, MARKET << US, 5053, 1, 411800)","{""AMETHYSTS"": -3, ""STARFRUIT"": 6}",3692,5053,10001
411900,-10106,-6729,"(STARFRUIT, US << MARKET, 5053, 1, 411900)
(STARFRUIT, US << MARKET, 5053, 1, 411900)","{""AMETHYSTS"": -3, ""STARFRUIT"": 8}",3687,5052,10000
412600,10108,3379,"(STARFRUIT, MARKET << US, 5054, 1, 412600)
(STARFRUIT, MARKET << US, 5054, 1, 412600)","{""AMETHYSTS"": -3, ""STARFRUIT"": 6}",3685,5051,10000
413100,-15138,-11759,"(STARFRUIT, US << MARKET, 5046, 1, 413100)
(STARFRUIT, US << MARKET, 5046, 1, 413100)
(STARFRUIT, US << MARKET, 5046, 1, 413100)
(STARFRUIT, US << MARKET, 5046, 1, 413100)
(STARFRUIT, MARKET << US, 5046, 1, 413100)","{""AMETHYSTS"": -3, ""STARFRUIT"": 9}",3670,5048,10001
413300,5051,-6708,"(STARFRUIT, MARKET << US, 5051, 1, 413300)","{""AMETHYSTS"": -3, ""STARFRUIT"": 8}",3668,5047,10000
413500,20004,13296,"(AMETHYSTS, MARKET << US, 10002, 1, 413500)
(AMETHYSTS, MARKET << US, 10002, 1, 413500)","{""AMETHYSTS"": -5, ""STARFRUIT"": 8}",3693,5049,9999
413800,-39984,-26688,"(AMETHYSTS, US << MARKET, 9996, 1, 413800)
(AMETHYSTS, US << MARKET, 9996, 1, 413800)
(AMETHYSTS, US << MARKET, 9996, 1, 413800)
(AMETHYSTS, US << MARKET, 9996, 1, 413800)","{""AMETHYSTS"": -1, ""STARFRUIT"": 8}",3723,5051,9997
414400,-15056,-41744,"(AMETHYSTS, US << MARKET, 10004, 1, 414400)
(STARFRUIT, US << MARKET, 5052, 1, 414400)","{""AMETHYSTS"": 0, ""STARFRUIT"": 9}",3688,5048,10000
414600,-74932,-116676,"(AMETHYSTS, US << MARKET, 9998, 1, 414600)
(AMETHYSTS, US << MARKET, 9998, 1, 414600)
(AMETHYSTS, US << MARKET, 9998, 1, 414600)
(AMETHYSTS, US << MARKET, 9998, 1, 414600)
(AMETHYSTS, US << MARKET, 9998, 1, 414600)
(AMETHYSTS, US << MARKET, 9998, 1, 414600)
(AMETHYSTS, US << MARKET, 9998, 1, 414600)
(AMETHYSTS, US << MARKET, 9998, 1, 414600)
(STARFRUIT, MARKET << US, 5052, 1, 414600)","{""AMETHYSTS"": 8, ""STARFRUIT"": 8}",3684,5048,9997
415000,60012,-56664,"(AMETHYSTS, MARKET << US, 10002, 1, 415000)
(AMETHYSTS, MARKET << US, 10002, 1, 415000)
(AMETHYSTS, MARKET << US, 10002, 1, 415000)
(AMETHYSTS, MARKET << US, 10002, 1, 415000)
(AMETHYSTS, MARKET << US, 10002, 1, 415000)
(AMETHYSTS, MARKET << US, 10002, 1, 415000)","{""AMETHYSTS"": 2, ""STARFRUIT"": 8}",3718,5047,10003
415200,5049,-51615,"(STARFRUIT, MARKET << US, 5049, 1, 415200)","{""AMETHYSTS"": 2, ""STARFRUIT"": 7}",3707,5046,10000
415300,9998,-41617,"(AMETHYSTS, MARKET << US, 9998, 1, 415300)","{""AMETHYSTS"": 1, ""STARFRUIT"": 7}",3716,5048,9997
415600,34976,-6641,"(AMETHYSTS, MARKET << US, 10005, 1, 415600)
(AMETHYSTS, MARKET << US, 10005, 1, 415600)
(AMETHYSTS, MARKET << US, 10005, 1, 415600)
(AMETHYSTS, MARKET << US, 10005, 1, 415600)
(STARFRUIT, US << MARKET, 5044, 1, 415600)","{""AMETHYSTS"": -3, ""STARFRUIT"": 8}",3735,5047,10000
415800,-99960,-106601,"(AMETHYSTS, US << MARKET, 9996, 1, 415800)
(AMETHYSTS, US << MARKET, 9996, 1, 415800)
(AMETHYSTS, US << MARKET, 9996, 1, 415800)
(AMETHYSTS, US << MARKET, 9996, 1, 415800)
(AMETHYSTS, US << MARKET, 9996, 1, 415800)
(AMETHYSTS, US << MARKET, 9996, 1, 415800)
(AMETHYSTS, US << MARKET, 9996, 1, 415800)
(AMETHYSTS, US << MARKET, 9996, 1, 415800)
(AMETHYSTS, US << MARKET, 9996, 1, 415800)
(AMETHYSTS, US << MARKET, 9996, 1, 415800)
(AMETHYSTS, US << MARKET, 9996, 1, 415800)
(AMETHYSTS, US << MARKET, 9996, 1, 415800)
(AMETHYSTS, MARKET << US, 9996, 1, 415800)
(AMETHYSTS, MARKET << US, 9996, 1, 415800)","{""AMETHYSTS"": 7, ""STARFRUIT"": 8}",3776,5048,9999
416100,-5050,-111651,"(STARFRUIT, US << MARKET, 5050, 1, 416100)","{""AMETHYSTS"": 7, ""STARFRUIT"": 9}",3785,5050,9998
416200,9998,-101653,"(AMETHYSTS, MARKET << US, 9998, 1, 416200)","{""AMETHYSTS"": 6, ""STARFRUIT"": 9}",3752,5047,9997
416600,69972,-31681,"(AMETHYSTS, MARKET << US, 9996, 1, 416600)
(AMETHYSTS, MARKET << US, 9996, 1, 416600)
(AMETHYSTS, MARKET << US, 9996, 1, 416600)
(AMETHYSTS, MARKET << US, 9996, 1, 416600)
(AMETHYSTS, MARKET << US, 9996, 1, 416600)
(AMETHYSTS, MARKET << US, 9996, 1, 416600)
(AMETHYSTS, MARKET << US, 9996, 1, 416600)","{""AMETHYSTS"": -1, ""STARFRUIT"": 9}",3761,5049,9999
416800,85021,53340,"(AMETHYSTS, MARKET << US, 9996, 1, 416800)
(AMETHYSTS, MARKET << US, 9996, 1, 416800)
(AMETHYSTS, MARKET << US, 9996, 1, 416800)
(AMETHYSTS, MARKET << US, 9996, 1, 416800)
(AMETHYSTS, MARKET << US, 9996, 1, 416800)
(AMETHYSTS, MARKET << US, 9996, 1, 416800)
(AMETHYSTS, MARKET << US, 9996, 1, 416800)
(AMETHYSTS, MARKET << US, 9996, 1, 416800)
(STARFRUIT, MARKET << US, 5053, 1, 416800)","{""AMETHYSTS"": -9, ""STARFRUIT"": 8}",3740,5050,10000
417000,-39992,13348,"(AMETHYSTS, US << MARKET, 9998, 1, 417000)
(AMETHYSTS, US << MARKET, 9998, 1, 417000)
(AMETHYSTS, US << MARKET, 9998, 1, 417000)
(AMETHYSTS, US << MARKET, 9998, 1, 417000)","{""AMETHYSTS"": -5, ""STARFRUIT"": 8}",3776,5051,9996
417100,30276,43624,"(STARFRUIT, MARKET << US, 5046, 1, 417100)
(STARFRUIT, MARKET << US, 5046, 1, 417100)
(STARFRUIT, MARKET << US, 5046, 1, 417100)
(STARFRUIT, MARKET << US, 5046, 1, 417100)
(STARFRUIT, MARKET << US, 5046, 1, 417100)
(STARFRUIT, MARKET << US, 5046, 1, 417100)","{""AMETHYSTS"": -5, ""STARFRUIT"": 2}",3717,5049,10001
417300,20004,63628,"(AMETHYSTS, MARKET << US, 10002, 1, 417300)
(AMETHYSTS, MARKET << US, 10002, 1, 417300)","{""AMETHYSTS"": -7, ""STARFRUIT"": 2}",3703,5048,10003
417500,5045,68673,"(STARFRUIT, MARKET << US, 5045, 1, 417500)","{""AMETHYSTS"": -7, ""STARFRUIT"": 1}",3700,5048,10003
417600,-25235,43438,"(STARFRUIT, US << MARKET, 5047, 1, 417600)
(STARFRUIT, US << MARKET, 5047, 1, 417600)
(STARFRUIT, US << MARKET, 5047, 1, 417600)
(STARFRUIT, US << MARKET, 5047, 1, 417600)
(STARFRUIT, US << MARKET, 5047, 1, 417600)","{""AMETHYSTS"": -7, ""STARFRUIT"": 6}",3714,5046,10000
418000,20180,63618,"(STARFRUIT, MARKET << US, 5045, 1, 418000)
(STARFRUIT, MARKET << US, 5045, 1, 418000)
(STARFRUIT, MARKET << US, 5045, 1, 418000)
(STARFRUIT, MARKET << US, 5045, 1, 418000)","{""AMETHYSTS"": -7, ""STARFRUIT"": 2}",3714,5048,10000
418200,96,63714,"(AMETHYSTS, US << MARKET, 9996, 1, 418200)
(AMETHYSTS, US << MARKET, 9996, 1, 418200)
(AMETHYSTS, MARKET << US, 9996, 1, 418200)
(STARFRUIT, MARKET << US, 5046, 1, 418200)
(STARFRUIT, MARKET << US, 5046, 1, 418200)","{""AMETHYSTS"": -6, ""STARFRUIT"": 0}",3714,5048,10000
418400,50122,113836,"(AMETHYSTS, MARKET << US, 10004, 1, 418400)
(AMETHYSTS, MARKET << US, 10004, 1, 418400)
(AMETHYSTS, MARKET << US, 10004, 1, 418400)
(AMETHYSTS, MARKET << US, 10004, 1, 418400)
(STARFRUIT, MARKET << US, 5053, 1, 418400)
(STARFRUIT, MARKET << US, 5053, 1, 418400)","{""AMETHYSTS"": -10, ""STARFRUIT"": -2}",3728,5049,10001
418800,-10104,103732,"(STARFRUIT, US << MARKET, 5052, 1, 418800)
(STARFRUIT, US << MARKET, 5052, 1, 418800)","{""AMETHYSTS"": -10, ""STARFRUIT"": 0}",3732,5052,10000
418900,-115000,-11268,"(AMETHYSTS, US << MARKET, 9998, 1, 418900)
(AMETHYSTS, US << MARKET, 9998, 1, 418900)
(AMETHYSTS, US << MARKET, 10005, 1, 418900)
(AMETHYSTS, US << MARKET, 10005, 1, 418900)
(AMETHYSTS, US << MARKET, 10005, 1, 418900)
(AMETHYSTS, US << MARKET, 10005, 1, 418900)
(AMETHYSTS, US << MARKET, 10005, 1, 418900)
(AMETHYSTS, US << MARKET, 10005, 1, 418900)
(AMETHYSTS, US << MARKET, 10005, 1, 418900)
(AMETHYSTS, US << MARKET, 10005, 1, 418900)
(AMETHYSTS, US << MARKET, 10005, 1, 418900)
(AMETHYSTS, US << MARKET, 10005, 1, 418900)
(STARFRUIT, MARKET << US, 5046, 1, 418900)","{""AMETHYSTS"": 2, ""STARFRUIT"": -1}",3685,5049,10001
419600,-14947,-26215,"(AMETHYSTS, US << MARKET, 9996, 1, 419600)
(AMETHYSTS, US << MARKET, 9996, 1, 419600)
(STARFRUIT, MARKET << US, 5045, 1, 419600)","{""AMETHYSTS"": 4, ""STARFRUIT"": -2}",3689,5048,10000
419700,-10004,-36219,"(AMETHYSTS, US << MARKET, 10004, 1, 419700)","{""AMETHYSTS"": 5, ""STARFRUIT"": -2}",3690,5048,10001
420000,-10100,-46319,"(STARFRUIT, US << MARKET, 5050, 1, 420000)
(STARFRUIT, US << MARKET, 5050, 1, 420000)","{""AMETHYSTS"": 5, ""STARFRUIT"": 0}",3686,5050,10001
420200,-34930,-81249,"(AMETHYSTS, US << MARKET, 9995, 1, 420200)
(AMETHYSTS, US << MARKET, 9995, 1, 420200)
(AMETHYSTS, US << MARKET, 9995, 1, 420200)
(AMETHYSTS, US << MARKET, 9995, 1, 420200)
(STARFRUIT, MARKET << US, 5050, 1, 420200)","{""AMETHYSTS"": 9, ""STARFRUIT"": -1}",3700,5051,10000
420300,-90036,-171285,"(AMETHYSTS, US << MARKET, 10004, 1, 420300)
(AMETHYSTS, US << MARKET, 10004, 1, 420300)
(AMETHYSTS, US << MARKET, 10004, 1, 420300)
(AMETHYSTS, US << MARKET, 10004, 1, 420300)
(AMETHYSTS, US << MARKET, 10004, 1, 420300)
(AMETHYSTS, US << MARKET, 10004, 1, 420300)
(AMETHYSTS, US << MARKET, 10004, 1, 420300)
(AMETHYSTS, US << MARKET, 10004, 1, 420300)
(AMETHYSTS, US << MARKET, 10004, 1, 420300)","{""AMETHYSTS"": 18, ""STARFRUIT"": -1}",3668,5047,10000
420400,5050,-166235,"(STARFRUIT, MARKET << US, 5050, 1, 420400)","{""AMETHYSTS"": 18, ""STARFRUIT"": -2}",3663,5051,10000
420800,9998,-156237,"(AMETHYSTS, MARKET << US, 9998, 1, 420800)","{""AMETHYSTS"": 17, ""STARFRUIT"": -2}",3695,5051,10002
421400,-19896,-176133,"(AMETHYSTS, US << MARKET, 9996, 1, 421400)
(AMETHYSTS, US << MARKET, 9996, 1, 421400)
(AMETHYSTS, US << MARKET, 9996, 1, 421400)
(STARFRUIT, MARKET << US, 5046, 1, 421400)
(STARFRUIT, MARKET << US, 5046, 1, 421400)","{""AMETHYSTS"": 20, ""STARFRUIT"": -4}",3671,5049,10000
422200,0,-176133,,"{""AMETHYSTS"": 20, ""STARFRUIT"": -4}",3735,5048,10003
422300,5045,-171088,"(STARFRUIT, MARKET << US, 5045, 1, 422300)","{""AMETHYSTS"": 20, ""STARFRUIT"": -5}",3672,5048,10000
422600,5049,-166039,"(STARFRUIT, MARKET << US, 5049, 1, 422600)","{""AMETHYSTS"": 20, ""STARFRUIT"": -6}",3667,5049,10000
422700,-10098,-176137,"(STARFRUIT, US << MARKET, 5049, 1, 422700)
(STARFRUIT, US << MARKET, 5049, 1, 422700)","{""AMETHYSTS"": 20, ""STARFRUIT"": -4}",3683,5050,10001
423300,20100,-156037,"(AMETHYSTS, MARKET << US, 9998, 1, 423300)
(STARFRUIT, MARKET << US, 5051, 1, 423300)
(STARFRUIT, MARKET << US, 5051, 1, 423300)","{""AMETHYSTS"": 19, ""STARFRUIT"": -6}",3624,5047,9997
423400,9998,-146039,"(AMETHYSTS, MARKET << US, 9998, 1, 423400)","{""AMETHYSTS"": 18, ""STARFRUIT"": -6}",3673,5048,10000
423700,-10092,-156131,"(STARFRUIT, US << MARKET, 5046, 1, 423700)
(STARFRUIT, US << MARKET, 5046, 1, 423700)","{""AMETHYSTS"": 18, ""STARFRUIT"": -4}",3689,5045,10000
424800,59970,-96161,"(AMETHYSTS, MARKET << US, 9995, 1, 424800)
(AMETHYSTS, MARKET << US, 9995, 1, 424800)
(AMETHYSTS, MARKET << US, 9995, 1, 424800)
(AMETHYSTS, MARKET << US, 9995, 1, 424800)
(AMETHYSTS, MARKET << US, 9995, 1, 424800)
(AMETHYSTS, MARKET << US, 9995, 1, 424800)","{""AMETHYSTS"": 12, ""STARFRUIT"": -4}",3643,5049,10000
425100,5051,-91110,"(STARFRUIT, MARKET << US, 5051, 1, 425100)","{""AMETHYSTS"": 12, ""STARFRUIT"": -5}",3655,5047,10000
425300,-39992,-131102,"(AMETHYSTS, US << MARKET, 9998, 1, 425300)
(AMETHYSTS, US << MARKET, 9998, 1, 425300)
(AMETHYSTS, US << MARKET, 9998, 1, 425300)
(AMETHYSTS, US << MARKET, 9998, 1, 425300)","{""AMETHYSTS"": 16, ""STARFRUIT"": -5}",3615,5047,9997
425500,5050,-126052,"(STARFRUIT, MARKET << US, 5050, 1, 425500)","{""AMETHYSTS"": 16, ""STARFRUIT"": -6}",3648,5050,10000
425700,5044,-121008,"(STARFRUIT, MARKET << US, 5044, 1, 425700)","{""AMETHYSTS"": 16, ""STARFRUIT"": -7}",3686,5046,10001
425800,-35325,-156333,"(AMETHYSTS, US << MARKET, 10000, 1, 425800)
(AMETHYSTS, US << MARKET, 10000, 1, 425800)
(AMETHYSTS, US << MARKET, 10000, 1, 425800)
(AMETHYSTS, MARKET << US, 10000, 1, 425800)
(AMETHYSTS, MARKET << US, 9998, 1, 425800)
(AMETHYSTS, MARKET << US, 9998, 1, 425800)
(STARFRUIT, US << MARKET, 5045, 1, 425800)
(STARFRUIT, US << MARKET, 5045, 1, 425800)
(STARFRUIT, US << MARKET, 5045, 1, 425800)
(STARFRUIT, US << MARKET, 5045, 1, 425800)
(STARFRUIT, US << MARKET, 5045, 1, 425800)
(STARFRUIT, US << MARKET, 5045, 1, 425800)
(STARFRUIT, US << MARKET, 5051, 1, 425800)","{""AMETHYSTS"": 16, ""STARFRUIT"": 0}",3699,5049,10002
425900,49990,-106343,"(AMETHYSTS, MARKET << US, 9998, 1, 425900)
(AMETHYSTS, MARKET << US, 9998, 1, 425900)
(AMETHYSTS, MARKET << US, 9998, 1, 425900)
(AMETHYSTS, MARKET << US, 9998, 1, 425900)
(AMETHYSTS, MARKET << US, 9998, 1, 425900)","{""AMETHYSTS"": 11, ""STARFRUIT"": 0}",3624,5047,9997
426500,5049,-101294,"(STARFRUIT, MARKET << US, 5049, 1, 426500)","{""AMETHYSTS"": 11, ""STARFRUIT"": -1}",3657,5049,10000
426600,-89982,-191276,"(AMETHYSTS, US << MARKET, 9998, 1, 426600)
(AMETHYSTS, US << MARKET, 9998, 1, 426600)
(AMETHYSTS, US << MARKET, 9998, 1, 426600)
(AMETHYSTS, US << MARKET, 9998, 1, 426600)
(AMETHYSTS, US << MARKET, 9998, 1, 426600)
(AMETHYSTS, US << MARKET, 9998, 1, 426600)
(AMETHYSTS, US << MARKET, 9998, 1, 426600)
(AMETHYSTS, US << MARKET, 9998, 1, 426600)
(AMETHYSTS, US << MARKET, 9998, 1, 426600)","{""AMETHYSTS"": 20, ""STARFRUIT"": -1}",3698,5046,10001
426800,-10096,-201372,"(STARFRUIT, US << MARKET, 5048, 1, 426800)
(STARFRUIT, US << MARKET, 5048, 1, 426800)","{""AMETHYSTS"": 20, ""STARFRUIT"": 1}",3677,5049,10000
427100,-10098,-211470,"(STARFRUIT, US << MARKET, 5049, 1, 427100)
(STARFRUIT, US << MARKET, 5049, 1, 427100)","{""AMETHYSTS"": 20, ""STARFRUIT"": 3}",3697,5049,10001
427500,160032,-51438,"(AMETHYSTS, MARKET << US, 10002, 1, 427500)
(AMETHYSTS, MARKET << US, 10002, 1, 427500)
(AMETHYSTS, MARKET << US, 10002, 1, 427500)
(AMETHYSTS, MARKET << US, 10002, 1, 427500)
(AMETHYSTS, MARKET << US, 10002, 1, 427500)
(AMETHYSTS, MARKET << US, 10002, 1, 427500)
(AMETHYSTS, MARKET << US, 10002, 1, 427500)
(AMETHYSTS, MARKET << US, 10002, 1, 427500)
(AMETHYSTS, MARKET << US, 10002, 1, 427500)
(AMETHYSTS, MARKET << US, 10002, 1, 427500)
(AMETHYSTS, MARKET << US, 10002, 1, 427500)
(AMETHYSTS, MARKET << US, 10002, 1, 427500)
(AMETHYSTS, MARKET << US, 10002, 1, 427500)
(AMETHYSTS, MARKET << US, 10002, 1, 427500)
(AMETHYSTS, MARKET << US, 10002, 1, 427500)
(AMETHYSTS, MARKET << US, 10002, 1, 427500)","{""AMETHYSTS"": 4, ""STARFRUIT"": 3}",3699,5047,9999
427800,-10088,-61526,"(STARFRUIT, US << MARKET, 5044, 1, 427800)
(STARFRUIT, US << MARKET, 5044, 1, 427800)","{""AMETHYSTS"": 4, ""STARFRUIT"": 5}",3704,5046,10000
428000,-20176,-81702,"(STARFRUIT, US << MARKET, 5044, 1, 428000)
(STARFRUIT, US << MARKET, 5044, 1, 428000)
(STARFRUIT, US << MARKET, 5044, 1, 428000)
(STARFRUIT, US << MARKET, 5044, 1, 428000)","{""AMETHYSTS"": 4, ""STARFRUIT"": 9}",3725,5047,10001
428200,-10002,-91704,"(AMETHYSTS, US << MARKET, 10002, 1, 428200)","{""AMETHYSTS"": 5, ""STARFRUIT"": 9}",3714,5047,9999
428300,25041,-66663,"(AMETHYSTS, MARKET << US, 9998, 1, 428300)
(AMETHYSTS, MARKET << US, 9998, 1, 428300)
(STARFRUIT, MARKET << US, 5045, 1, 428300)","{""AMETHYSTS"": 3, ""STARFRUIT"": 8}",3712,5048,9997
428900,-5045,-71708,"(STARFRUIT, US << MARKET, 5045, 1, 428900)","{""AMETHYSTS"": 3, ""STARFRUIT"": 9}",3724,5048,10000
429000,20008,-51700,"(AMETHYSTS, MARKET << US, 10004, 1, 429000)
(AMETHYSTS, MARKET << US, 10004, 1, 429000)","{""AMETHYSTS"": 1, ""STARFRUIT"": 9}",3732,5048,10000
429100,94,-51606,"(AMETHYSTS, US << MARKET, 9996, 1, 429100)
(AMETHYSTS, US << MARKET, 9996, 1, 429100)
(AMETHYSTS, MARKET << US, 9996, 1, 429100)
(STARFRUIT, MARKET << US, 5045, 1, 429100)
(STARFRUIT, MARKET << US, 5045, 1, 429100)","{""AMETHYSTS"": 2, ""STARFRUIT"": 7}",3723,5047,10000
429600,-14942,-66548,"(AMETHYSTS, US << MARKET, 9996, 1, 429600)
(AMETHYSTS, US << MARKET, 9996, 1, 429600)
(STARFRUIT, MARKET << US, 5050, 1, 429600)","{""AMETHYSTS"": 4, ""STARFRUIT"": 6}",3758,5051,10000
429800,5046,-61502,"(STARFRUIT, MARKET << US, 5046, 1, 429800)","{""AMETHYSTS"": 4, ""STARFRUIT"": 5}",3738,5048,10000
429900,-30084,-91586,"(AMETHYSTS, US << MARKET, 9996, 1, 429900)
(AMETHYSTS, US << MARKET, 9996, 1, 429900)
(STARFRUIT, US << MARKET, 5046, 1, 429900)
(STARFRUIT, US << MARKET, 5046, 1, 429900)","{""AMETHYSTS"": 6, ""STARFRUIT"": 7}",3757,5049,10000
430000,-20188,-111774,"(STARFRUIT, US << MARKET, 5047, 1, 430000)
(STARFRUIT, US << MARKET, 5047, 1, 430000)
(STARFRUIT, US << MARKET, 5047, 1, 430000)
(STARFRUIT, US << MARKET, 5047, 1, 430000)","{""AMETHYSTS"": 6, ""STARFRUIT"": 11}",3776,5050,10000
430200,-19996,-131770,"(AMETHYSTS, US << MARKET, 9998, 1, 430200)
(AMETHYSTS, US << MARKET, 9998, 1, 430200)","{""AMETHYSTS"": 8, ""STARFRUIT"": 11}",3745,5049,9997
430400,-40008,-171778,"(AMETHYSTS, US << MARKET, 10002, 1, 430400)
(AMETHYSTS, US << MARKET, 10002, 1, 430400)
(AMETHYSTS, US << MARKET, 10002, 1, 430400)
(AMETHYSTS, US << MARKET, 10002, 1, 430400)","{""AMETHYSTS"": 12, ""STARFRUIT"": 11}",3725,5049,9997
431100,-5047,-176825,"(STARFRUIT, US << MARKET, 5047, 1, 431100)","{""AMETHYSTS"": 12, ""STARFRUIT"": 12}",3775,5050,10000
431400,-5051,-181876,"(STARFRUIT, US << MARKET, 5051, 1, 431400)","{""AMETHYSTS"": 12, ""STARFRUIT"": 13}",3800,5052,10000
431500,35357,-146519,"(STARFRUIT, MARKET << US, 5051, 1, 431500)
(STARFRUIT, MARKET << US, 5051, 1, 431500)
(STARFRUIT, MARKET << US, 5051, 1, 431500)
(STARFRUIT, MARKET << US, 5051, 1, 431500)
(STARFRUIT, MARKET << US, 5051, 1, 431500)
(STARFRUIT, MARKET << US, 5051, 1, 431500)
(STARFRUIT, MARKET << US, 5051, 1, 431500)","{""AMETHYSTS"": 12, ""STARFRUIT"": 6}",3757,5052,9997
431900,20004,-126515,"(AMETHYSTS, MARKET << US, 10002, 1, 431900)
(AMETHYSTS, MARKET << US, 10002, 1, 431900)","{""AMETHYSTS"": 10, ""STARFRUIT"": 6}",3815,5050,10003
433000,5055,-121460,"(STARFRUIT, MARKET << US, 5055, 1, 433000)","{""AMETHYSTS"": 10, ""STARFRUIT"": 5}",3815,5055,10000
433100,-4947,-126407,"(AMETHYSTS, US << MARKET, 10002, 1, 433100)
(STARFRUIT, MARKET << US, 5055, 1, 433100)","{""AMETHYSTS"": 11, ""STARFRUIT"": 4}",3846,5055,10003
433500,4842,-121565,"(AMETHYSTS, MARKET << US, 9996, 1, 433500)
(AMETHYSTS, MARKET << US, 9996, 1, 433500)
(STARFRUIT, US << MARKET, 5050, 1, 433500)
(STARFRUIT, US << MARKET, 5050, 1, 433500)
(STARFRUIT, US << MARKET, 5050, 1, 433500)","{""AMETHYSTS"": 9, ""STARFRUIT"": 7}",3806,5053,10000
433800,-10002,-131567,"(AMETHYSTS, US << MARKET, 10002, 1, 433800)","{""AMETHYSTS"": 10, ""STARFRUIT"": 7}",3834,5053,10003
434500,30110,-101457,"(AMETHYSTS, MARKET << US, 10004, 1, 434500)
(AMETHYSTS, MARKET << US, 10004, 1, 434500)
(STARFRUIT, MARKET << US, 5053, 1, 434500)
(STARFRUIT, MARKET << US, 5049, 1, 434500)","{""AMETHYSTS"": 8, ""STARFRUIT"": 5}",3798,5051,10000
434600,-79984,-181441,"(AMETHYSTS, US << MARKET, 9998, 1, 434600)
(AMETHYSTS, US << MARKET, 9998, 1, 434600)
(AMETHYSTS, US << MARKET, 9998, 1, 434600)
(AMETHYSTS, US << MARKET, 9998, 1, 434600)
(AMETHYSTS, US << MARKET, 9998, 1, 434600)
(AMETHYSTS, US << MARKET, 9998, 1, 434600)
(AMETHYSTS, US << MARKET, 9998, 1, 434600)
(AMETHYSTS, US << MARKET, 9998, 1, 434600)
(AMETHYSTS, US << MARKET, 9998, 1, 434600)
(AMETHYSTS, US << MARKET, 9998, 1, 434600)
(AMETHYSTS, US << MARKET, 9998, 1, 434600)
(AMETHYSTS, MARKET << US, 9998, 1, 434600)
(AMETHYSTS, MARKET << US, 9998, 1, 434600)
(AMETHYSTS, MARKET << US, 9998, 1, 434600)","{""AMETHYSTS"": 16, ""STARFRUIT"": 5}",3766,5051,9997
434900,-102,-181543,"(AMETHYSTS, MARKET << US, 9996, 1, 434900)
(STARFRUIT, US << MARKET, 5049, 1, 434900)
(STARFRUIT, US << MARKET, 5049, 1, 434900)","{""AMETHYSTS"": 15, ""STARFRUIT"": 7}",3821,5052,10000
435000,-19996,-201539,"(AMETHYSTS, US << MARKET, 9998, 1, 435000)
(AMETHYSTS, US << MARKET, 9998, 1, 435000)","{""AMETHYSTS"": 17, ""STARFRUIT"": 7}",3842,5052,10001
435600,5049,-196490,"(STARFRUIT, MARKET << US, 5049, 1, 435600)","{""AMETHYSTS"": 17, ""STARFRUIT"": 6}",3788,5052,9998
435700,-19996,-216486,"(AMETHYSTS, US << MARKET, 10000, 1, 435700)
(AMETHYSTS, US << MARKET, 10000, 1, 435700)
(STARFRUIT, US << MARKET, 5049, 1, 435700)
(STARFRUIT, US << MARKET, 5049, 1, 435700)
(STARFRUIT, MARKET << US, 5051, 1, 435700)
(STARFRUIT, MARKET << US, 5051, 1, 435700)","{""AMETHYSTS"": 19, ""STARFRUIT"": 6}",3851,5053,10001
436400,-10106,-226592,"(STARFRUIT, US << MARKET, 5053, 1, 436400)
(STARFRUIT, US << MARKET, 5053, 1, 436400)","{""AMETHYSTS"": 19, ""STARFRUIT"": 8}",3808,5050,10000
436500,20004,-206588,"(AMETHYSTS, MARKET << US, 10002, 1, 436500)
(AMETHYSTS, MARKET << US, 10002, 1, 436500)","{""AMETHYSTS"": 17, ""STARFRUIT"": 8}",3879,5052,10003
436900,25052,-181536,"(AMETHYSTS, MARKET << US, 10002, 1, 436900)
(AMETHYSTS, MARKET << US, 10002, 1, 436900)
(STARFRUIT, MARKET << US, 5048, 1, 436900)","{""AMETHYSTS"": 15, ""STARFRUIT"": 7}",3859,5050,10003
437000,-20224,-201760,"(STARFRUIT, US << MARKET, 5056, 1, 437000)
(STARFRUIT, US << MARKET, 5056, 1, 437000)
(STARFRUIT, US << MARKET, 5056, 1, 437000)
(STARFRUIT, US << MARKET, 5056, 1, 437000)","{""AMETHYSTS"": 15, ""STARFRUIT"": 11}",3827,5052,10001
437300,4942,-196818,"(AMETHYSTS, MARKET << US, 9996, 1, 437300)
(STARFRUIT, US << MARKET, 5054, 1, 437300)","{""AMETHYSTS"": 14, ""STARFRUIT"": 12}",3788,5054,9997
437500,-20192,-217010,"(STARFRUIT, US << MARKET, 5048, 1, 437500)
(STARFRUIT, US << MARKET, 5048, 1, 437500)
(STARFRUIT, US << MARKET, 5048, 1, 437500)
(STARFRUIT, US << MARKET, 5048, 1, 437500)","{""AMETHYSTS"": 14, ""STARFRUIT"": 16}",3806,5051,10000
437800,25255,-191755,"(STARFRUIT, MARKET << US, 5051, 1, 437800)
(STARFRUIT, MARKET << US, 5051, 1, 437800)
(STARFRUIT, MARKET << US, 5051, 1, 437800)
(STARFRUIT, MARKET << US, 5051, 1, 437800)
(STARFRUIT, MARKET << US, 5051, 1, 437800)","{""AMETHYSTS"": 14, ""STARFRUIT"": 11}",3742,5049,9997
438000,5049,-186706,"(STARFRUIT, MARKET << US, 5049, 1, 438000)","{""AMETHYSTS"": 14, ""STARFRUIT"": 10}",3760,5048,9999
438600,-40196,-226902,"(AMETHYSTS, US << MARKET, 9998, 1, 438600)
(AMETHYSTS, US << MARKET, 9998, 1, 438600)
(STARFRUIT, US << MARKET, 5050, 1, 438600)
(STARFRUIT, US << MARKET, 5050, 1, 438600)
(STARFRUIT, US << MARKET, 5050, 1, 438600)
(STARFRUIT, US << MARKET, 5050, 1, 438600)","{""AMETHYSTS"": 16, ""STARFRUIT"": 14}",3776,5053,9996
438700,-4952,-231854,"(AMETHYSTS, US << MARKET, 10002, 1, 438700)
(STARFRUIT, MARKET << US, 5050, 1, 438700)","{""AMETHYSTS"": 17, ""STARFRUIT"": 13}",3886,5053,10003
438800,-25046,-256900,"(AMETHYSTS, US << MARKET, 9998, 1, 438800)
(AMETHYSTS, US << MARKET, 9998, 1, 438800)
(STARFRUIT, US << MARKET, 5050, 1, 438800)","{""AMETHYSTS"": 19, ""STARFRUIT"": 14}",3771,5052,9997
439000,-5050,-261950,"(STARFRUIT, US << MARKET, 5050, 1, 439000)","{""AMETHYSTS"": 19, ""STARFRUIT"": 15}",3845,5053,10000
439100,-5051,-267001,"(STARFRUIT, US << MARKET, 5051, 1, 439100)","{""AMETHYSTS"": 19, ""STARFRUIT"": 16}",3863,5054,10000
439300,-20116,-287117,"(AMETHYSTS, US << MARKET, 10004, 1, 439300)
(STARFRUIT, US << MARKET, 5056, 1, 439300)
(STARFRUIT, US << MARKET, 5056, 1, 439300)","{""AMETHYSTS"": 20, ""STARFRUIT"": 18}",3855,5054,10000
439500,19996,-267121,"(AMETHYSTS, MARKET << US, 9998, 1, 439500)
(AMETHYSTS, MARKET << US, 9998, 1, 439500)","{""AMETHYSTS"": 18, ""STARFRUIT"": 18}",3779,5054,9996
439600,20004,-247117,"(AMETHYSTS, MARKET << US, 10002, 1, 439600)
(AMETHYSTS, MARKET << US, 10002, 1, 439600)
(STARFRUIT, US << MARKET, 5056, 1, 439600)
(STARFRUIT, US << MARKET, 5056, 1, 439600)
(STARFRUIT, MARKET << US, 5056, 1, 439600)
(STARFRUIT, MARKET << US, 5056, 1, 439600)","{""AMETHYSTS"": 16, ""STARFRUIT"": 18}",3805,5053,9998
439700,20004,-227113,"(AMETHYSTS, MARKET << US, 10002, 1, 439700)
(AMETHYSTS, MARKET << US, 10002, 1, 439700)","{""AMETHYSTS"": 14, ""STARFRUIT"": 18}",3901,5054,10003
439800,-5051,-232164,"(STARFRUIT, US << MARKET, 5051, 1, 439800)","{""AMETHYSTS"": 14, ""STARFRUIT"": 19}",3862,5054,10000
440000,-15060,-247224,"(AMETHYSTS, US << MARKET, 10002, 1, 440000)
(STARFRUIT, US << MARKET, 5058, 1, 440000)","{""AMETHYSTS"": 15, ""STARFRUIT"": 20}",3901,5057,9999
440100,-40008,-287232,"(AMETHYSTS, US << MARKET, 10002, 1, 440100)
(AMETHYSTS, US << MARKET, 10002, 1, 440100)
(AMETHYSTS, US << MARKET, 10002, 1, 440100)
(AMETHYSTS, US << MARKET, 10002, 1, 440100)","{""AMETHYSTS"": 19, ""STARFRUIT"": 20}",3925,5055,10003
441200,5050,-282182,"(STARFRUIT, MARKET << US, 5050, 1, 441200)","{""AMETHYSTS"": 19, ""STARFRUIT"": 19}",3749,5049,10000
441300,40008,-242174,"(AMETHYSTS, MARKET << US, 10002, 1, 441300)
(AMETHYSTS, MARKET << US, 10002, 1, 441300)
(AMETHYSTS, MARKET << US, 10002, 1, 441300)
(AMETHYSTS, MARKET << US, 10002, 1, 441300)","{""AMETHYSTS"": 15, ""STARFRUIT"": 19}",3878,5053,10003
441400,5055,-237119,"(STARFRUIT, MARKET << US, 5055, 1, 441400)","{""AMETHYSTS"": 15, ""STARFRUIT"": 18}",3817,5052,10000
441700,4942,-232177,"(AMETHYSTS, MARKET << US, 9998, 1, 441700)
(STARFRUIT, US << MARKET, 5055, 1, 441700)
(STARFRUIT, US << MARKET, 5055, 1, 441700)
(STARFRUIT, MARKET << US, 5054, 1, 441700)","{""AMETHYSTS"": 14, ""STARFRUIT"": 19}",3793,5054,9996
442200,20004,-212173,"(AMETHYSTS, MARKET << US, 10002, 1, 442200)
(AMETHYSTS, MARKET << US, 10002, 1, 442200)","{""AMETHYSTS"": 12, ""STARFRUIT"": 19}",3832,5051,10003
442400,45062,-167111,"(AMETHYSTS, MARKET << US, 10002, 1, 442400)
(AMETHYSTS, MARKET << US, 10002, 1, 442400)
(AMETHYSTS, MARKET << US, 10002, 1, 442400)
(AMETHYSTS, MARKET << US, 10002, 1, 442400)
(STARFRUIT, MARKET << US, 5054, 1, 442400)","{""AMETHYSTS"": 8, ""STARFRUIT"": 18}",3853,5054,9999
442600,45441,-121670,"(STARFRUIT, MARKET << US, 5049, 1, 442600)
(STARFRUIT, MARKET << US, 5049, 1, 442600)
(STARFRUIT, MARKET << US, 5049, 1, 442600)
(STARFRUIT, MARKET << US, 5049, 1, 442600)
(STARFRUIT, MARKET << US, 5049, 1, 442600)
(STARFRUIT, MARKET << US, 5049, 1, 442600)
(STARFRUIT, MARKET << US, 5049, 1, 442600)
(STARFRUIT, MARKET << US, 5049, 1, 442600)
(STARFRUIT, MARKET << US, 5049, 1, 442600)","{""AMETHYSTS"": 8, ""STARFRUIT"": 9}",3798,5052,10000
443100,50286,-71384,"(AMETHYSTS, MARKET << US, 10002, 1, 443100)
(AMETHYSTS, MARKET << US, 10002, 1, 443100)
(STARFRUIT, MARKET << US, 5047, 1, 443100)
(STARFRUIT, MARKET << US, 5047, 1, 443100)
(STARFRUIT, MARKET << US, 5047, 1, 443100)
(STARFRUIT, MARKET << US, 5047, 1, 443100)
(STARFRUIT, MARKET << US, 5047, 1, 443100)
(STARFRUIT, MARKET << US, 5047, 1, 443100)","{""AMETHYSTS"": 6, ""STARFRUIT"": 3}",3760,5050,9999
443300,-10096,-81480,"(STARFRUIT, US << MARKET, 5048, 1, 443300)
(STARFRUIT, US << MARKET, 5048, 1, 443300)","{""AMETHYSTS"": 6, ""STARFRUIT"": 5}",3755,5047,10000
444000,10102,-71378,"(STARFRUIT, MARKET << US, 5051, 1, 444000)
(STARFRUIT, MARKET << US, 5051, 1, 444000)","{""AMETHYSTS"": 6, ""STARFRUIT"": 3}",3775,5051,10000
444500,20216,-51162,"(STARFRUIT, MARKET << US, 5054, 1, 444500)
(STARFRUIT, MARKET << US, 5054, 1, 444500)
(STARFRUIT, MARKET << US, 5054, 1, 444500)
(STARFRUIT, MARKET << US, 5054, 1, 444500)","{""AMETHYSTS"": 6, ""STARFRUIT"": -1}",3793,5051,10001
444600,-30318,-81480,"(STARFRUIT, US << MARKET, 5053, 1, 444600)
(STARFRUIT, US << MARKET, 5053, 1, 444600)
(STARFRUIT, US << MARKET, 5053, 1, 444600)
(STARFRUIT, US << MARKET, 5053, 1, 444600)
(STARFRUIT, US << MARKET, 5053, 1, 444600)
(STARFRUIT, US << MARKET, 5053, 1, 444600)","{""AMETHYSTS"": 6, ""STARFRUIT"": 5}",3771,5049,10001
444700,69972,-11508,"(AMETHYSTS, MARKET << US, 9996, 1, 444700)
(AMETHYSTS, MARKET << US, 9996, 1, 444700)
(AMETHYSTS, MARKET << US, 9996, 1, 444700)
(AMETHYSTS, MARKET << US, 9996, 1, 444700)
(AMETHYSTS, MARKET << US, 9996, 1, 444700)
(AMETHYSTS, MARKET << US, 9996, 1, 444700)
(AMETHYSTS, MARKET << US, 9996, 1, 444700)","{""AMETHYSTS"": -1, ""STARFRUIT"": 5}",3745,5050,9997
444800,-10094,-21602,"(STARFRUIT, US << MARKET, 5047, 1, 444800)
(STARFRUIT, US << MARKET, 5047, 1, 444800)","{""AMETHYSTS"": -1, ""STARFRUIT"": 7}",3754,5051,10001
445100,-20220,-41822,"(STARFRUIT, US << MARKET, 5055, 1, 445100)
(STARFRUIT, US << MARKET, 5055, 1, 445100)
(STARFRUIT, US << MARKET, 5055, 1, 445100)
(STARFRUIT, US << MARKET, 5055, 1, 445100)","{""AMETHYSTS"": -1, ""STARFRUIT"": 11}",3771,5054,10001
445200,15048,-26774,"(AMETHYSTS, MARKET << US, 9995, 1, 445200)
(STARFRUIT, MARKET << US, 5053, 1, 445200)","{""AMETHYSTS"": -2, ""STARFRUIT"": 10}",3756,5053,10000
445400,40320,13546,"(AMETHYSTS, MARKET << US, 9996, 1, 445400)
(STARFRUIT, MARKET << US, 5054, 1, 445400)
(STARFRUIT, MARKET << US, 5054, 1, 445400)
(STARFRUIT, MARKET << US, 5054, 1, 445400)
(STARFRUIT, MARKET << US, 5054, 1, 445400)
(STARFRUIT, MARKET << US, 5054, 1, 445400)
(STARFRUIT, MARKET << US, 5054, 1, 445400)","{""AMETHYSTS"": -3, ""STARFRUIT"": 4}",3762,5054,10000
445700,-35146,-21600,"(AMETHYSTS, US << MARKET, 9998, 1, 445700)
(AMETHYSTS, US << MARKET, 9998, 1, 445700)
(STARFRUIT, US << MARKET, 5050, 1, 445700)
(STARFRUIT, US << MARKET, 5050, 1, 445700)
(STARFRUIT, US << MARKET, 5050, 1, 445700)","{""AMETHYSTS"": -1, ""STARFRUIT"": 7}",3746,5049,9997
446100,-5050,-26650,"(STARFRUIT, US << MARKET, 5050, 1, 446100)","{""AMETHYSTS"": -1, ""STARFRUIT"": 8}",3742,5049,10000
446300,39992,13342,"(AMETHYSTS, MARKET << US, 9998, 1, 446300)
(AMETHYSTS, MARKET << US, 9998, 1, 446300)
(AMETHYSTS, MARKET << US, 9998, 1, 446300)
(AMETHYSTS, MARKET << US, 9998, 1, 446300)","{""AMETHYSTS"": -5, ""STARFRUIT"": 8}",3778,5052,9996
446400,-19996,-6654,"(AMETHYSTS, US << MARKET, 9998, 1, 446400)
(AMETHYSTS, US << MARKET, 9998, 1, 446400)","{""AMETHYSTS"": -3, ""STARFRUIT"": 8}",3759,5052,10001
446600,-15151,-21805,"(STARFRUIT, US << MARKET, 5051, 1, 446600)
(STARFRUIT, US << MARKET, 5051, 1, 446600)
(STARFRUIT, US << MARKET, 5051, 1, 446600)
(STARFRUIT, US << MARKET, 5051, 1, 446600)
(STARFRUIT, MARKET << US, 5053, 1, 446600)","{""AMETHYSTS"": -3, ""STARFRUIT"": 11}",3740,5049,9998
446800,-30006,-51811,"(AMETHYSTS, US << MARKET, 10002, 1, 446800)
(AMETHYSTS, US << MARKET, 10002, 1, 446800)
(AMETHYSTS, US << MARKET, 10002, 1, 446800)","{""AMETHYSTS"": 0, ""STARFRUIT"": 11}",3728,5049,10003
447000,5053,-46758,"(STARFRUIT, MARKET << US, 5053, 1, 447000)","{""AMETHYSTS"": 0, ""STARFRUIT"": 10}",3752,5051,10000
447100,5053,-41705,"(STARFRUIT, MARKET << US, 5053, 1, 447100)","{""AMETHYSTS"": 0, ""STARFRUIT"": 9}",3772,5053,10000
447200,-20208,-61913,"(STARFRUIT, US << MARKET, 5052, 1, 447200)
(STARFRUIT, US << MARKET, 5052, 1, 447200)
(STARFRUIT, US << MARKET, 5052, 1, 447200)
(STARFRUIT, US << MARKET, 5052, 1, 447200)","{""AMETHYSTS"": 0, ""STARFRUIT"": 13}",3776,5053,10002
447800,25045,-36868,"(AMETHYSTS, US << MARKET, 9998, 1, 447800)
(AMETHYSTS, US << MARKET, 9998, 1, 447800)
(AMETHYSTS, US << MARKET, 9998, 1, 447800)
(AMETHYSTS, US << MARKET, 9998, 1, 447800)
(AMETHYSTS, MARKET << US, 9998, 1, 447800)
(AMETHYSTS, MARKET << US, 9998, 1, 447800)
(AMETHYSTS, MARKET << US, 9998, 1, 447800)
(AMETHYSTS, MARKET << US, 9998, 1, 447800)
(AMETHYSTS, MARKET << US, 9998, 1, 447800)
(AMETHYSTS, MARKET << US, 9998, 1, 447800)
(STARFRUIT, MARKET << US, 5049, 1, 447800)","{""AMETHYSTS"": -2, ""STARFRUIT"": 12}",3706,5048,10001
447900,14950,-21918,"(AMETHYSTS, MARKET << US, 10002, 1, 447900)
(AMETHYSTS, MARKET << US, 10002, 1, 447900)
(STARFRUIT, US << MARKET, 5054, 1, 447900)","{""AMETHYSTS"": -4, ""STARFRUIT"": 13}",3772,5054,10003
448200,-15059,-36977,"(AMETHYSTS, US << MARKET, 10004, 1, 448200)
(STARFRUIT, US << MARKET, 5055, 1, 448200)","{""AMETHYSTS"": -3, ""STARFRUIT"": 14}",3737,5051,10000
448400,-19996,-56973,"(AMETHYSTS, US << MARKET, 9998, 1, 448400)
(AMETHYSTS, US << MARKET, 9998, 1, 448400)","{""AMETHYSTS"": -1, ""STARFRUIT"": 14}",3768,5053,10001
448600,20004,-36969,"(AMETHYSTS, MARKET << US, 10002, 1, 448600)
(AMETHYSTS, MARKET << US, 10002, 1, 448600)","{""AMETHYSTS"": -3, ""STARFRUIT"": 14}",3764,5053,10003
448800,4948,-32021,"(AMETHYSTS, MARKET << US, 9998, 1, 448800)
(STARFRUIT, US << MARKET, 5050, 1, 448800)","{""AMETHYSTS"": -4, ""STARFRUIT"": 15}",3730,5049,9996
449500,100065,68044,"(AMETHYSTS, US << MARKET, 10002, 1, 449500)
(AMETHYSTS, US << MARKET, 10002, 1, 449500)
(AMETHYSTS, US << MARKET, 10002, 1, 449500)
(AMETHYSTS, US << MARKET, 10002, 1, 449500)
(AMETHYSTS, US << MARKET, 10002, 1, 449500)
(AMETHYSTS, MARKET << US, 10005, 1, 449500)
(AMETHYSTS, MARKET << US, 10005, 1, 449500)
(AMETHYSTS, MARKET << US, 10005, 1, 449500)
(AMETHYSTS, MARKET << US, 10005, 1, 449500)
(AMETHYSTS, MARKET << US, 10005, 1, 449500)
(AMETHYSTS, MARKET << US, 10005, 1, 449500)
(AMETHYSTS, MARKET << US, 10005, 1, 449500)
(AMETHYSTS, MARKET << US, 10005, 1, 449500)
(AMETHYSTS, MARKET << US, 10005, 1, 449500)
(AMETHYSTS, MARKET << US, 10005, 1, 449500)
(AMETHYSTS, MARKET << US, 10005, 1, 449500)
(AMETHYSTS, MARKET << US, 10005, 1, 449500)
(AMETHYSTS, MARKET << US, 10005, 1, 449500)
(AMETHYSTS, MARKET << US, 10005, 1, 449500)
(AMETHYSTS, MARKET << US, 10005, 1, 449500)","{""AMETHYSTS"": -14, ""STARFRUIT"": 15}",3827,5055,10003
449700,49990,118034,"(AMETHYSTS, MARKET << US, 9998, 1, 449700)
(AMETHYSTS, MARKET << US, 9998, 1, 449700)
(AMETHYSTS, MARKET << US, 9998, 1, 449700)
(AMETHYSTS, MARKET << US, 9998, 1, 449700)
(AMETHYSTS, MARKET << US, 9998, 1, 449700)","{""AMETHYSTS"": -19, ""STARFRUIT"": 15}",3870,5057,10001
449900,15047,133081,"(AMETHYSTS, MARKET << US, 9995, 1, 449900)
(STARFRUIT, MARKET << US, 5052, 1, 449900)","{""AMETHYSTS"": -20, ""STARFRUIT"": 14}",3877,5054,9998
450100,5057,138138,"(STARFRUIT, MARKET << US, 5057, 1, 450100)","{""AMETHYSTS"": -20, ""STARFRUIT"": 13}",3840,5054,10000
450700,-30010,108128,"(AMETHYSTS, US << MARKET, 10002, 1, 450700)
(AMETHYSTS, US << MARKET, 10004, 1, 450700)
(AMETHYSTS, US << MARKET, 10004, 1, 450700)","{""AMETHYSTS"": -17, ""STARFRUIT"": 13}",3805,5056,10003
450900,30100,138228,"(AMETHYSTS, MARKET << US, 9998, 1, 450900)
(AMETHYSTS, MARKET << US, 9998, 1, 450900)
(STARFRUIT, MARKET << US, 5052, 1, 450900)
(STARFRUIT, MARKET << US, 5052, 1, 450900)","{""AMETHYSTS"": -19, ""STARFRUIT"": 11}",3803,5054,10001
451400,-20208,118020,"(STARFRUIT, US << MARKET, 5052, 1, 451400)
(STARFRUIT, US << MARKET, 5052, 1, 451400)
(STARFRUIT, US << MARKET, 5052, 1, 451400)
(STARFRUIT, US << MARKET, 5052, 1, 451400)","{""AMETHYSTS"": -19, ""STARFRUIT"": 15}",3785,5051,10000
451500,-50098,67922,"(AMETHYSTS, US << MARKET, 9998, 1, 451500)
(AMETHYSTS, US << MARKET, 9998, 1, 451500)
(AMETHYSTS, US << MARKET, 9998, 1, 451500)
(AMETHYSTS, US << MARKET, 9998, 1, 451500)
(STARFRUIT, US << MARKET, 5053, 1, 451500)
(STARFRUIT, US << MARKET, 5053, 1, 451500)","{""AMETHYSTS"": -15, ""STARFRUIT"": 17}",3842,5055,10001
451600,10114,78036,"(STARFRUIT, MARKET << US, 5057, 1, 451600)
(STARFRUIT, MARKET << US, 5057, 1, 451600)","{""AMETHYSTS"": -15, ""STARFRUIT"": 15}",3861,5054,9999
452000,50010,128046,"(AMETHYSTS, MARKET << US, 10002, 1, 452000)
(AMETHYSTS, MARKET << US, 10002, 1, 452000)
(AMETHYSTS, MARKET << US, 10002, 1, 452000)
(AMETHYSTS, MARKET << US, 10002, 1, 452000)
(AMETHYSTS, MARKET << US, 10002, 1, 452000)","{""AMETHYSTS"": -20, ""STARFRUIT"": 15}",3826,5056,10003
452100,-20212,107834,"(STARFRUIT, US << MARKET, 5053, 1, 452100)
(STARFRUIT, US << MARKET, 5053, 1, 452100)
(STARFRUIT, US << MARKET, 5053, 1, 452100)
(STARFRUIT, US << MARKET, 5053, 1, 452100)","{""AMETHYSTS"": -20, ""STARFRUIT"": 19}",3898,5056,10000
452300,25275,133109,"(STARFRUIT, MARKET << US, 5055, 1, 452300)
(STARFRUIT, MARKET << US, 5055, 1, 452300)
(STARFRUIT, MARKET << US, 5055, 1, 452300)
(STARFRUIT, MARKET << US, 5055, 1, 452300)
(STARFRUIT, MARKET << US, 5055, 1, 452300)","{""AMETHYSTS"": -20, ""STARFRUIT"": 14}",3905,5054,9998
452500,20228,153337,"(STARFRUIT, MARKET << US, 5057, 1, 452500)
(STARFRUIT, MARKET << US, 5057, 1, 452500)
(STARFRUIT, MARKET << US, 5057, 1, 452500)
(STARFRUIT, MARKET << US, 5057, 1, 452500)","{""AMETHYSTS"": -20, ""STARFRUIT"": 10}",3947,5055,9997
452900,30330,183667,"(STARFRUIT, MARKET << US, 5055, 1, 452900)
(STARFRUIT, MARKET << US, 5055, 1, 452900)
(STARFRUIT, MARKET << US, 5055, 1, 452900)
(STARFRUIT, MARKET << US, 5055, 1, 452900)
(STARFRUIT, MARKET << US, 5055, 1, 452900)
(STARFRUIT, MARKET << US, 5055, 1, 452900)","{""AMETHYSTS"": -20, ""STARFRUIT"": 4}",3939,5058,9998
453300,-9886,173781,"(AMETHYSTS, US << MARKET, 9998, 1, 453300)
(AMETHYSTS, US << MARKET, 9998, 1, 453300)
(STARFRUIT, MARKET << US, 5055, 1, 453300)
(STARFRUIT, MARKET << US, 5055, 1, 453300)","{""AMETHYSTS"": -18, ""STARFRUIT"": 2}",3879,5058,10001
453400,-4834,168947,"(AMETHYSTS, US << MARKET, 10005, 1, 453400)
(AMETHYSTS, US << MARKET, 10005, 1, 453400)
(STARFRUIT, US << MARKET, 5060, 1, 453400)
(STARFRUIT, MARKET << US, 5059, 1, 453400)
(STARFRUIT, MARKET << US, 5059, 1, 453400)
(STARFRUIT, MARKET << US, 5059, 1, 453400)
(STARFRUIT, MARKET << US, 5059, 1, 453400)","{""AMETHYSTS"": -16, ""STARFRUIT"": -1}",3891,5056,10000
453700,10122,179069,"(STARFRUIT, MARKET << US, 5061, 1, 453700)
(STARFRUIT, MARKET << US, 5061, 1, 453700)","{""AMETHYSTS"": -16, ""STARFRUIT"": -3}",3930,5057,9998
453800,10112,189181,"(STARFRUIT, MARKET << US, 5056, 1, 453800)
(STARFRUIT, MARKET << US, 5056, 1, 453800)","{""AMETHYSTS"": -16, ""STARFRUIT"": -5}",3838,5059,10003
453900,-10112,179069,"(STARFRUIT, US << MARKET, 5056, 1, 453900)
(STARFRUIT, US << MARKET, 5056, 1, 453900)","{""AMETHYSTS"": -16, ""STARFRUIT"": -3}",3936,5055,9998
454100,-35441,143628,"(STARFRUIT, US << MARKET, 5063, 1, 454100)
(STARFRUIT, US << MARKET, 5063, 1, 454100)
(STARFRUIT, US << MARKET, 5063, 1, 454100)
(STARFRUIT, US << MARKET, 5063, 1, 454100)
(STARFRUIT, US << MARKET, 5063, 1, 454100)
(STARFRUIT, US << MARKET, 5063, 1, 454100)
(STARFRUIT, US << MARKET, 5063, 1, 454100)","{""AMETHYSTS"": -16, ""STARFRUIT"": 4}",3864,5059,10000
454500,-10002,133626,"(AMETHYSTS, US << MARKET, 10002, 1, 454500)","{""AMETHYSTS"": -15, ""STARFRUIT"": 4}",3813,5058,10003
454800,-30110,103516,"(AMETHYSTS, US << MARKET, 9998, 1, 454800)
(AMETHYSTS, US << MARKET, 9998, 1, 454800)
(STARFRUIT, US << MARKET, 5057, 1, 454800)
(STARFRUIT, US << MARKET, 5057, 1, 454800)","{""AMETHYSTS"": -13, ""STARFRUIT"": 6}",3863,5060,10001
455000,-20232,83284,"(STARFRUIT, US << MARKET, 5058, 1, 455000)
(STARFRUIT, US << MARKET, 5058, 1, 455000)
(STARFRUIT, US << MARKET, 5058, 1, 455000)
(STARFRUIT, US << MARKET, 5058, 1, 455000)","{""AMETHYSTS"": -13, ""STARFRUIT"": 10}",3880,5057,9998
455200,15053,98337,"(AMETHYSTS, MARKET << US, 9996, 1, 455200)
(STARFRUIT, MARKET << US, 5057, 1, 455200)","{""AMETHYSTS"": -14, ""STARFRUIT"": 9}",3868,5059,10000
455400,20240,118577,"(STARFRUIT, MARKET << US, 5060, 1, 455400)
(STARFRUIT, MARKET << US, 5060, 1, 455400)
(STARFRUIT, MARKET << US, 5060, 1, 455400)
(STARFRUIT, MARKET << US, 5060, 1, 455400)","{""AMETHYSTS"": -14, ""STARFRUIT"": 5}",3882,5061,10000
455500,-10122,108455,"(STARFRUIT, US << MARKET, 5061, 1, 455500)
(STARFRUIT, US << MARKET, 5061, 1, 455500)","{""AMETHYSTS"": -14, ""STARFRUIT"": 7}",3882,5061,10000
455600,-10002,98453,"(AMETHYSTS, US << MARKET, 10002, 1, 455600)","{""AMETHYSTS"": -13, ""STARFRUIT"": 7}",3820,5058,10003
455700,-19996,78457,"(AMETHYSTS, US << MARKET, 9998, 1, 455700)
(AMETHYSTS, US << MARKET, 9998, 1, 455700)","{""AMETHYSTS"": -11, ""STARFRUIT"": 7}",3910,5060,9997
455800,9998,88455,"(AMETHYSTS, MARKET << US, 9998, 1, 455800)","{""AMETHYSTS"": -12, ""STARFRUIT"": 7}",3897,5058,9997
456500,25285,113740,"(STARFRUIT, MARKET << US, 5057, 1, 456500)
(STARFRUIT, MARKET << US, 5057, 1, 456500)
(STARFRUIT, MARKET << US, 5057, 1, 456500)
(STARFRUIT, MARKET << US, 5057, 1, 456500)
(STARFRUIT, MARKET << US, 5057, 1, 456500)","{""AMETHYSTS"": -12, ""STARFRUIT"": 2}",3858,5059,10000
456700,19996,133736,"(AMETHYSTS, MARKET << US, 9998, 1, 456700)
(AMETHYSTS, MARKET << US, 9998, 1, 456700)","{""AMETHYSTS"": -14, ""STARFRUIT"": 2}",3896,5059,9997
457100,-19996,113740,"(AMETHYSTS, US << MARKET, 9998, 1, 457100)
(AMETHYSTS, US << MARKET, 9998, 1, 457100)","{""AMETHYSTS"": -12, ""STARFRUIT"": 2}",3908,5060,9996
457900,-10118,103622,"(STARFRUIT, US << MARKET, 5059, 1, 457900)
(STARFRUIT, US << MARKET, 5059, 1, 457900)","{""AMETHYSTS"": -12, ""STARFRUIT"": 4}",3870,5062,10000
458800,-20256,83366,"(STARFRUIT, US << MARKET, 5064, 1, 458800)
(STARFRUIT, US << MARKET, 5064, 1, 458800)
(STARFRUIT, US << MARKET, 5064, 1, 458800)
(STARFRUIT, US << MARKET, 5064, 1, 458800)","{""AMETHYSTS"": -12, ""STARFRUIT"": 8}",3874,5065,10001
459200,-30136,53230,"(AMETHYSTS, US << MARKET, 10002, 1, 459200)
(AMETHYSTS, US << MARKET, 10002, 1, 459200)
(STARFRUIT, US << MARKET, 5066, 1, 459200)
(STARFRUIT, US << MARKET, 5066, 1, 459200)","{""AMETHYSTS"": -10, ""STARFRUIT"": 10}",3860,5062,9999
459600,20004,73234,"(AMETHYSTS, MARKET << US, 10002, 1, 459600)
(AMETHYSTS, MARKET << US, 10002, 1, 459600)","{""AMETHYSTS"": -12, ""STARFRUIT"": 10}",3808,5061,10003
460000,-4939,68295,"(AMETHYSTS, US << MARKET, 10004, 1, 460000)
(STARFRUIT, MARKET << US, 5065, 1, 460000)","{""AMETHYSTS"": -11, ""STARFRUIT"": 9}",3840,5063,10002
460100,5064,73359,"(STARFRUIT, MARKET << US, 5064, 1, 460100)","{""AMETHYSTS"": -11, ""STARFRUIT"": 8}",3871,5064,10000
460500,-5064,68295,"(STARFRUIT, US << MARKET, 5064, 1, 460500)","{""AMETHYSTS"": -11, ""STARFRUIT"": 9}",3853,5062,10000
460700,-20236,48059,"(STARFRUIT, US << MARKET, 5059, 1, 460700)
(STARFRUIT, US << MARKET, 5059, 1, 460700)
(STARFRUIT, US << MARKET, 5059, 1, 460700)
(STARFRUIT, US << MARKET, 5059, 1, 460700)","{""AMETHYSTS"": -11, ""STARFRUIT"": 13}",3852,5061,10000
461300,4932,52991,"(AMETHYSTS, MARKET << US, 9998, 1, 461300)
(STARFRUIT, US << MARKET, 5066, 1, 461300)","{""AMETHYSTS"": -12, ""STARFRUIT"": 14}",3907,5062,9996
461500,54946,107937,"(AMETHYSTS, MARKET << US, 10002, 1, 461500)
(AMETHYSTS, MARKET << US, 10002, 1, 461500)
(AMETHYSTS, MARKET << US, 10002, 1, 461500)
(AMETHYSTS, MARKET << US, 10002, 1, 461500)
(AMETHYSTS, MARKET << US, 10002, 1, 461500)
(AMETHYSTS, MARKET << US, 10002, 1, 461500)
(STARFRUIT, US << MARKET, 5066, 1, 461500)","{""AMETHYSTS"": -18, ""STARFRUIT"": 15}",3828,5063,10003
462000,9998,117935,"(AMETHYSTS, MARKET << US, 9998, 1, 462000)","{""AMETHYSTS"": -19, ""STARFRUIT"": 15}",3872,5065,10002
462300,9996,127931,"(AMETHYSTS, MARKET << US, 9996, 1, 462300)","{""AMETHYSTS"": -20, ""STARFRUIT"": 15}",3891,5064,10000
462700,-10002,117929,"(AMETHYSTS, US << MARKET, 10002, 1, 462700)","{""AMETHYSTS"": -19, ""STARFRUIT"": 15}",3832,5064,10003
462900,-59988,57941,"(AMETHYSTS, US << MARKET, 9998, 1, 462900)
(AMETHYSTS, US << MARKET, 9998, 1, 462900)
(AMETHYSTS, US << MARKET, 9998, 1, 462900)
(AMETHYSTS, US << MARKET, 9998, 1, 462900)
(AMETHYSTS, US << MARKET, 9998, 1, 462900)
(AMETHYSTS, US << MARKET, 9998, 1, 462900)","{""AMETHYSTS"": -13, ""STARFRUIT"": 15}",3955,5065,9997
463000,45073,103014,"(AMETHYSTS, US << MARKET, 10002, 1, 463000)
(AMETHYSTS, US << MARKET, 10004, 1, 463000)
(AMETHYSTS, MARKET << US, 10002, 1, 463000)
(AMETHYSTS, MARKET << US, 10002, 1, 463000)
(AMETHYSTS, MARKET << US, 10002, 1, 463000)
(AMETHYSTS, MARKET << US, 10002, 1, 463000)
(AMETHYSTS, MARKET << US, 10002, 1, 463000)
(AMETHYSTS, MARKET << US, 10002, 1, 463000)
(STARFRUIT, MARKET << US, 5067, 1, 463000)","{""AMETHYSTS"": -17, ""STARFRUIT"": 14}",3859,5064,10003
463100,-79984,23030,"(AMETHYSTS, US << MARKET, 9998, 1, 463100)
(AMETHYSTS, US << MARKET, 9998, 1, 463100)
(AMETHYSTS, US << MARKET, 9998, 1, 463100)
(AMETHYSTS, US << MARKET, 9998, 1, 463100)
(AMETHYSTS, US << MARKET, 9998, 1, 463100)
(AMETHYSTS, US << MARKET, 9998, 1, 463100)
(AMETHYSTS, US << MARKET, 9998, 1, 463100)
(AMETHYSTS, US << MARKET, 9998, 1, 463100)","{""AMETHYSTS"": -9, ""STARFRUIT"": 14}",3948,5063,9996
463300,-5061,17969,"(STARFRUIT, US << MARKET, 5061, 1, 463300)","{""AMETHYSTS"": -9, ""STARFRUIT"": 15}",3929,5064,10000
463800,-10002,7967,"(AMETHYSTS, US << MARKET, 10002, 1, 463800)","{""AMETHYSTS"": -8, ""STARFRUIT"": 15}",3888,5063,10003
464000,49990,57957,"(AMETHYSTS, MARKET << US, 9998, 1, 464000)
(AMETHYSTS, MARKET << US, 9998, 1, 464000)
(AMETHYSTS, MARKET << US, 9998, 1, 464000)
(AMETHYSTS, MARKET << US, 9998, 1, 464000)
(AMETHYSTS, MARKET << US, 9998, 1, 464000)","{""AMETHYSTS"": -13, ""STARFRUIT"": 15}",3941,5063,9997
464300,-5061,52896,"(STARFRUIT, US << MARKET, 5061, 1, 464300)","{""AMETHYSTS"": -13, ""STARFRUIT"": 16}",3888,5062,10000
464500,70390,123286,"(AMETHYSTS, US << MARKET, 10004, 1, 464500)
(AMETHYSTS, MARKET << US, 10004, 1, 464500)
(AMETHYSTS, MARKET << US, 10004, 1, 464500)
(AMETHYSTS, MARKET << US, 9998, 1, 464500)
(AMETHYSTS, MARKET << US, 9998, 1, 464500)
(AMETHYSTS, MARKET << US, 9998, 1, 464500)
(STARFRUIT, US << MARKET, 5064, 1, 464500)
(STARFRUIT, US << MARKET, 5064, 1, 464500)
(STARFRUIT, MARKET << US, 5065, 1, 464500)
(STARFRUIT, MARKET << US, 5065, 1, 464500)
(STARFRUIT, MARKET << US, 5065, 1, 464500)
(STARFRUIT, MARKET << US, 5065, 1, 464500)
(STARFRUIT, MARKET << US, 5065, 1, 464500)
(STARFRUIT, MARKET << US, 5065, 1, 464500)
(STARFRUIT, MARKET << US, 5065, 1, 464500)
(STARFRUIT, MARKET << US, 5065, 1, 464500)","{""AMETHYSTS"": -17, ""STARFRUIT"": 10}",3929,5066,10001
464700,-10002,113284,"(AMETHYSTS, US << MARKET, 10002, 1, 464700)","{""AMETHYSTS"": -16, ""STARFRUIT"": 10}",3856,5062,10003
465000,29994,143278,"(AMETHYSTS, MARKET << US, 9998, 1, 465000)
(AMETHYSTS, MARKET << US, 9998, 1, 465000)
(AMETHYSTS, MARKET << US, 9998, 1, 465000)","{""AMETHYSTS"": -19, ""STARFRUIT"": 10}",3955,5062,9997
465100,30396,173674,"(STARFRUIT, MARKET << US, 5066, 1, 465100)
(STARFRUIT, MARKET << US, 5066, 1, 465100)
(STARFRUIT, MARKET << US, 5066, 1, 465100)
(STARFRUIT, MARKET << US, 5066, 1, 465100)
(STARFRUIT, MARKET << US, 5066, 1, 465100)
(STARFRUIT, MARKET << US, 5066, 1, 465100)","{""AMETHYSTS"": -19, ""STARFRUIT"": 4}",3903,5062,10001
465200,-19996,153678,"(AMETHYSTS, US << MARKET, 9998, 1, 465200)
(AMETHYSTS, US << MARKET, 9998, 1, 465200)","{""AMETHYSTS"": -17, ""STARFRUIT"": 4}",3977,5062,9997
465600,-45042,108636,"(AMETHYSTS, US << MARKET, 9996, 1, 465600)
(AMETHYSTS, US << MARKET, 9996, 1, 465600)
(AMETHYSTS, US << MARKET, 9996, 1, 465600)
(AMETHYSTS, US << MARKET, 9996, 1, 465600)
(STARFRUIT, US << MARKET, 5058, 1, 465600)
(STARFRUIT, US << MARKET, 5058, 1, 465600)
(STARFRUIT, MARKET << US, 5058, 1, 465600)","{""AMETHYSTS"": -13, ""STARFRUIT"": 5}",3941,5061,10000
465700,0,108636,"(STARFRUIT, US << MARKET, 5063, 1, 465700)
(STARFRUIT, US << MARKET, 5063, 1, 465700)
(STARFRUIT, US << MARKET, 5063, 1, 465700)
(STARFRUIT, US << MARKET, 5063, 1, 465700)
(STARFRUIT, MARKET << US, 5063, 1, 465700)
(STARFRUIT, MARKET << US, 5063, 1, 465700)
(STARFRUIT, MARKET << US, 5063, 1, 465700)
(STARFRUIT, MARKET << US, 5063, 1, 465700)","{""AMETHYSTS"": -13, ""STARFRUIT"": 5}",3956,5064,10000
465800,-19996,88640,"(AMETHYSTS, US << MARKET, 9998, 1, 465800)
(AMETHYSTS, US << MARKET, 9998, 1, 465800)","{""AMETHYSTS"": -11, ""STARFRUIT"": 5}",3939,5062,10001
466000,-19996,68644,"(AMETHYSTS, US << MARKET, 9998, 1, 466000)
(AMETHYSTS, US << MARKET, 9998, 1, 466000)","{""AMETHYSTS"": -9, ""STARFRUIT"": 5}",3941,5063,10002
466200,-55154,13490,"(AMETHYSTS, US << MARKET, 9995, 1, 466200)
(AMETHYSTS, US << MARKET, 9995, 1, 466200)
(AMETHYSTS, US << MARKET, 9995, 1, 466200)
(AMETHYSTS, US << MARKET, 9995, 1, 466200)
(STARFRUIT, US << MARKET, 5058, 1, 466200)
(STARFRUIT, US << MARKET, 5058, 1, 466200)
(STARFRUIT, US << MARKET, 5058, 1, 466200)","{""AMETHYSTS"": -5, ""STARFRUIT"": 8}",3978,5061,10000
466300,40016,53506,"(AMETHYSTS, MARKET << US, 10004, 1, 466300)
(AMETHYSTS, MARKET << US, 10004, 1, 466300)
(AMETHYSTS, MARKET << US, 10004, 1, 466300)
(AMETHYSTS, MARKET << US, 10004, 1, 466300)","{""AMETHYSTS"": -9, ""STARFRUIT"": 8}",4002,5062,10000
466400,20004,73510,"(AMETHYSTS, MARKET << US, 10002, 1, 466400)
(AMETHYSTS, MARKET << US, 10002, 1, 466400)","{""AMETHYSTS"": -11, ""STARFRUIT"": 8}",3973,5062,10003
466600,4932,78442,"(AMETHYSTS, MARKET << US, 9996, 1, 466600)
(STARFRUIT, US << MARKET, 5064, 1, 466600)","{""AMETHYSTS"": -12, ""STARFRUIT"": 9}",4027,5065,10000
466800,-10002,68440,"(AMETHYSTS, US << MARKET, 10002, 1, 466800)","{""AMETHYSTS"": -11, ""STARFRUIT"": 9}",3956,5061,10003
466900,25055,93495,"(AMETHYSTS, MARKET << US, 9998, 1, 466900)
(AMETHYSTS, MARKET << US, 9998, 1, 466900)
(STARFRUIT, MARKET << US, 5059, 1, 466900)","{""AMETHYSTS"": -13, ""STARFRUIT"": 8}",4011,5058,9996
467000,5060,98555,"(STARFRUIT, MARKET << US, 5060, 1, 467000)","{""AMETHYSTS"": -13, ""STARFRUIT"": 7}",3968,5059,10000
467200,20004,118559,"(AMETHYSTS, MARKET << US, 10002, 1, 467200)
(AMETHYSTS, MARKET << US, 10002, 1, 467200)","{""AMETHYSTS"": -15, ""STARFRUIT"": 7}",3948,5062,10003
467800,15186,133745,"(STARFRUIT, MARKET << US, 5062, 1, 467800)
(STARFRUIT, MARKET << US, 5062, 1, 467800)
(STARFRUIT, MARKET << US, 5062, 1, 467800)","{""AMETHYSTS"": -15, ""STARFRUIT"": 4}",3982,5063,10001
467900,-10114,123631,"(STARFRUIT, US << MARKET, 5057, 1, 467900)
(STARFRUIT, US << MARKET, 5057, 1, 467900)","{""AMETHYSTS"": -15, ""STARFRUIT"": 6}",3991,5060,10000
468600,25315,148946,"(STARFRUIT, MARKET << US, 5063, 1, 468600)
(STARFRUIT, MARKET << US, 5063, 1, 468600)
(STARFRUIT, MARKET << US, 5063, 1, 468600)
(STARFRUIT, MARKET << US, 5063, 1, 468600)
(STARFRUIT, MARKET << US, 5063, 1, 468600)","{""AMETHYSTS"": -15, ""STARFRUIT"": 1}",4005,5059,10000
468800,0,148946,"(AMETHYSTS, US << MARKET, 10004, 1, 468800)
(AMETHYSTS, US << MARKET, 10004, 1, 468800)
(AMETHYSTS, MARKET << US, 10004, 1, 468800)
(AMETHYSTS, MARKET << US, 10004, 1, 468800)","{""AMETHYSTS"": -15, ""STARFRUIT"": 1}",3992,5061,10001
469100,-10124,138822,"(STARFRUIT, US << MARKET, 5062, 1, 469100)
(STARFRUIT, US << MARKET, 5062, 1, 469100)","{""AMETHYSTS"": -15, ""STARFRUIT"": 3}",4011,5063,10000
469900,10232,149054,"(AMETHYSTS, US << MARKET, 10002, 1, 469900)
(STARFRUIT, MARKET << US, 5059, 1, 469900)
(STARFRUIT, MARKET << US, 5059, 1, 469900)
(STARFRUIT, MARKET << US, 5059, 1, 469900)
(STARFRUIT, MARKET << US, 5057, 1, 469900)","{""AMETHYSTS"": -14, ""STARFRUIT"": -1}",3954,5058,10003
470000,4827,153881,"(AMETHYSTS, MARKET << US, 10004, 1, 470000)
(AMETHYSTS, MARKET << US, 10004, 1, 470000)
(STARFRUIT, US << MARKET, 5061, 1, 470000)
(STARFRUIT, US << MARKET, 5061, 1, 470000)
(STARFRUIT, US << MARKET, 5061, 1, 470000)
(STARFRUIT, US << MARKET, 5061, 1, 470000)
(STARFRUIT, MARKET << US, 5063, 1, 470000)","{""AMETHYSTS"": -16, ""STARFRUIT"": 2}",3989,5062,10001
470600,-10110,143771,"(STARFRUIT, US << MARKET, 5055, 1, 470600)
(STARFRUIT, US << MARKET, 5055, 1, 470600)","{""AMETHYSTS"": -16, ""STARFRUIT"": 4}",4003,5058,10000
470900,-10118,133653,"(STARFRUIT, US << MARKET, 5059, 1, 470900)
(STARFRUIT, US << MARKET, 5059, 1, 470900)","{""AMETHYSTS"": -16, ""STARFRUIT"": 6}",4007,5059,10000
471200,-20244,113409,"(STARFRUIT, US << MARKET, 5061, 1, 471200)
(STARFRUIT, US << MARKET, 5061, 1, 471200)
(STARFRUIT, US << MARKET, 5061, 1, 471200)
(STARFRUIT, US << MARKET, 5061, 1, 471200)","{""AMETHYSTS"": -16, ""STARFRUIT"": 10}",3979,5057,10000
471500,-30126,83283,"(AMETHYSTS, US << MARKET, 10004, 1, 471500)
(AMETHYSTS, US << MARKET, 10004, 1, 471500)
(STARFRUIT, US << MARKET, 5059, 1, 471500)
(STARFRUIT, US << MARKET, 5059, 1, 471500)","{""AMETHYSTS"": -14, ""STARFRUIT"": 12}",3955,5056,10000
471600,5059,88342,"(STARFRUIT, MARKET << US, 5059, 1, 471600)","{""AMETHYSTS"": -14, ""STARFRUIT"": 11}",3963,5059,10002
472300,-25050,63292,"(AMETHYSTS, US << MARKET, 9998, 1, 472300)
(AMETHYSTS, US << MARKET, 9998, 1, 472300)
(STARFRUIT, US << MARKET, 5054, 1, 472300)","{""AMETHYSTS"": -12, ""STARFRUIT"": 12}",3928,5054,10001
472400,-19996,43296,"(AMETHYSTS, US << MARKET, 9998, 1, 472400)
(AMETHYSTS, US << MARKET, 9998, 1, 472400)","{""AMETHYSTS"": -10, ""STARFRUIT"": 12}",4008,5056,9996
472500,-20224,23072,"(STARFRUIT, US << MARKET, 5056, 1, 472500)
(STARFRUIT, US << MARKET, 5056, 1, 472500)
(STARFRUIT, US << MARKET, 5056, 1, 472500)
(STARFRUIT, US << MARKET, 5056, 1, 472500)","{""AMETHYSTS"": -10, ""STARFRUIT"": 16}",3952,5055,10000
473000,-5056,18016,"(STARFRUIT, US << MARKET, 5056, 1, 473000)","{""AMETHYSTS"": -10, ""STARFRUIT"": 17}",4002,5058,10000
473100,-35176,-17160,"(AMETHYSTS, US << MARKET, 10004, 1, 473100)
(AMETHYSTS, US << MARKET, 10004, 1, 473100)
(STARFRUIT, US << MARKET, 5056, 1, 473100)
(STARFRUIT, US << MARKET, 5056, 1, 473100)
(STARFRUIT, US << MARKET, 5056, 1, 473100)","{""AMETHYSTS"": -8, ""STARFRUIT"": 20}",4012,5059,10001
473200,0,-17160,,"{""AMETHYSTS"": -8, ""STARFRUIT"": 20}",3960,5056,10000
473300,-9878,-27038,"(AMETHYSTS, US << MARKET, 10002, 1, 473300)
(AMETHYSTS, US << MARKET, 10002, 1, 473300)
(STARFRUIT, MARKET << US, 5063, 1, 473300)
(STARFRUIT, MARKET << US, 5063, 1, 473300)","{""AMETHYSTS"": -6, ""STARFRUIT"": 18}",4048,5060,9999
473500,19996,-7042,"(AMETHYSTS, MARKET << US, 9998, 1, 473500)
(AMETHYSTS, MARKET << US, 9998, 1, 473500)","{""AMETHYSTS"": -8, ""STARFRUIT"": 18}",4080,5061,9997
473600,60244,53202,"(AMETHYSTS, MARKET << US, 10002, 1, 473600)
(AMETHYSTS, MARKET << US, 10002, 1, 473600)
(AMETHYSTS, MARKET << US, 10002, 1, 473600)
(AMETHYSTS, MARKET << US, 10002, 1, 473600)
(STARFRUIT, MARKET << US, 5059, 1, 473600)
(STARFRUIT, MARKET << US, 5059, 1, 473600)
(STARFRUIT, MARKET << US, 5059, 1, 473600)
(STARFRUIT, MARKET << US, 5059, 1, 473600)","{""AMETHYSTS"": -12, ""STARFRUIT"": 14}",4038,5058,9998
473800,20008,73210,"(AMETHYSTS, US << MARKET, 10004, 1, 473800)
(AMETHYSTS, US << MARKET, 10004, 1, 473800)
(AMETHYSTS, MARKET << US, 10004, 1, 473800)
(AMETHYSTS, MARKET << US, 10004, 1, 473800)
(AMETHYSTS, MARKET << US, 10004, 1, 473800)
(AMETHYSTS, MARKET << US, 10004, 1, 473800)","{""AMETHYSTS"": -14, ""STARFRUIT"": 14}",4050,5061,10001
473900,5058,78268,"(STARFRUIT, MARKET << US, 5058, 1, 473900)","{""AMETHYSTS"": -14, ""STARFRUIT"": 13}",4047,5061,10001
474600,-10002,68266,"(AMETHYSTS, US << MARKET, 10002, 1, 474600)","{""AMETHYSTS"": -13, ""STARFRUIT"": 13}",4098,5062,9998
475000,5058,73324,"(STARFRUIT, MARKET << US, 5058, 1, 475000)","{""AMETHYSTS"": -13, ""STARFRUIT"": 12}",4044,5060,10000
475500,-10002,63322,"(AMETHYSTS, US << MARKET, 10002, 1, 475500)","{""AMETHYSTS"": -12, ""STARFRUIT"": 12}",4018,5061,10003
475700,-20232,43090,"(STARFRUIT, US << MARKET, 5058, 1, 475700)
(STARFRUIT, US << MARKET, 5058, 1, 475700)
(STARFRUIT, US << MARKET, 5058, 1, 475700)
(STARFRUIT, US << MARKET, 5058, 1, 475700)","{""AMETHYSTS"": -12, ""STARFRUIT"": 16}",4018,5058,10000
476600,-20008,23082,"(AMETHYSTS, US << MARKET, 10004, 1, 476600)
(AMETHYSTS, US << MARKET, 10004, 1, 476600)
(AMETHYSTS, US << MARKET, 10004, 1, 476600)
(AMETHYSTS, US << MARKET, 10004, 1, 476600)
(AMETHYSTS, US << MARKET, 10004, 1, 476600)
(AMETHYSTS, US << MARKET, 10004, 1, 476600)
(AMETHYSTS, MARKET << US, 10004, 1, 476600)
(AMETHYSTS, MARKET << US, 10004, 1, 476600)
(AMETHYSTS, MARKET << US, 10004, 1, 476600)
(AMETHYSTS, MARKET << US, 10004, 1, 476600)","{""AMETHYSTS"": -10, ""STARFRUIT"": 16}",4058,5061,10000
476700,-5063,18019,"(STARFRUIT, US << MARKET, 5063, 1, 476700)","{""AMETHYSTS"": -10, ""STARFRUIT"": 17}",4022,5059,10000
477000,5062,23081,"(STARFRUIT, MARKET << US, 5062, 1, 477000)","{""AMETHYSTS"": -10, ""STARFRUIT"": 16}",4089,5063,10000
477100,-5057,18024,"(STARFRUIT, US << MARKET, 5057, 1, 477100)","{""AMETHYSTS"": -10, ""STARFRUIT"": 17}",4024,5060,10002
477400,-25176,-7152,"(AMETHYSTS, US << MARKET, 10005, 1, 477400)
(STARFRUIT, US << MARKET, 5057, 1, 477400)
(STARFRUIT, US << MARKET, 5057, 1, 477400)
(STARFRUIT, US << MARKET, 5057, 1, 477400)","{""AMETHYSTS"": -9, ""STARFRUIT"": 20}",4039,5060,10001
477600,5057,-2095,"(STARFRUIT, MARKET << US, 5057, 1, 477600)","{""AMETHYSTS"": -9, ""STARFRUIT"": 19}",4053,5059,9997
477700,-5063,-7158,"(STARFRUIT, US << MARKET, 5063, 1, 477700)","{""AMETHYSTS"": -9, ""STARFRUIT"": 20}",4042,5060,10000
477800,-20004,-27162,"(AMETHYSTS, US << MARKET, 10002, 1, 477800)
(AMETHYSTS, US << MARKET, 10002, 1, 477800)","{""AMETHYSTS"": -7, ""STARFRUIT"": 20}",4032,5059,9998
477900,0,-27162,,"{""AMETHYSTS"": -7, ""STARFRUIT"": 20}",4058,5061,10000
478000,9998,-17164,"(AMETHYSTS, MARKET << US, 9998, 1, 478000)","{""AMETHYSTS"": -8, ""STARFRUIT"": 20}",4028,5060,10001
478100,110055,92891,"(AMETHYSTS, MARKET << US, 10005, 1, 478100)
(AMETHYSTS, MARKET << US, 10005, 1, 478100)
(AMETHYSTS, MARKET << US, 10005, 1, 478100)
(AMETHYSTS, MARKET << US, 10005, 1, 478100)
(AMETHYSTS, MARKET << US, 10005, 1, 478100)
(AMETHYSTS, MARKET << US, 10005, 1, 478100)
(AMETHYSTS, MARKET << US, 10005, 1, 478100)
(AMETHYSTS, MARKET << US, 10005, 1, 478100)
(AMETHYSTS, MARKET << US, 10005, 1, 478100)
(AMETHYSTS, MARKET << US, 10005, 1, 478100)
(AMETHYSTS, MARKET << US, 10005, 1, 478100)","{""AMETHYSTS"": -19, ""STARFRUIT"": 20}",4072,5060,10001
478200,-19996,72895,"(AMETHYSTS, US << MARKET, 9998, 1, 478200)
(AMETHYSTS, US << MARKET, 9998, 1, 478200)","{""AMETHYSTS"": -17, ""STARFRUIT"": 20}",4126,5059,9997
478800,15182,88077,"(STARFRUIT, MARKET << US, 5062, 1, 478800)
(STARFRUIT, MARKET << US, 5060, 1, 478800)
(STARFRUIT, MARKET << US, 5060, 1, 478800)","{""AMETHYSTS"": -17, ""STARFRUIT"": 17}",4097,5058,9998
479500,-29870,58207,"(AMETHYSTS, US << MARKET, 9995, 1, 479500)
(AMETHYSTS, US << MARKET, 9995, 1, 479500)
(AMETHYSTS, US << MARKET, 9995, 1, 479500)
(AMETHYSTS, US << MARKET, 9995, 1, 479500)
(STARFRUIT, MARKET << US, 5055, 1, 479500)
(STARFRUIT, MARKET << US, 5055, 1, 479500)","{""AMETHYSTS"": -13, ""STARFRUIT"": 15}",4088,5057,9998
479700,-44814,13393,"(AMETHYSTS, US << MARKET, 9998, 1, 479700)
(AMETHYSTS, US << MARKET, 9998, 1, 479700)
(AMETHYSTS, US << MARKET, 9998, 1, 479700)
(AMETHYSTS, US << MARKET, 9998, 1, 479700)
(AMETHYSTS, US << MARKET, 9998, 1, 479700)
(AMETHYSTS, US << MARKET, 9998, 1, 479700)
(STARFRUIT, MARKET << US, 5058, 1, 479700)
(STARFRUIT, MARKET << US, 5058, 1, 479700)
(STARFRUIT, MARKET << US, 5058, 1, 479700)","{""AMETHYSTS"": -7, ""STARFRUIT"": 12}",4084,5057,9999
480000,14948,28341,"(AMETHYSTS, MARKET << US, 10005, 1, 480000)
(AMETHYSTS, MARKET << US, 10005, 1, 480000)
(STARFRUIT, US << MARKET, 5062, 1, 480000)","{""AMETHYSTS"": -9, ""STARFRUIT"": 13}",4095,5058,10000
480200,-119940,-91599,"(AMETHYSTS, US << MARKET, 9995, 1, 480200)
(AMETHYSTS, US << MARKET, 9995, 1, 480200)
(AMETHYSTS, US << MARKET, 9995, 1, 480200)
(AMETHYSTS, US << MARKET, 9995, 1, 480200)
(AMETHYSTS, US << MARKET, 9995, 1, 480200)
(AMETHYSTS, US << MARKET, 9995, 1, 480200)
(AMETHYSTS, US << MARKET, 9995, 1, 480200)
(AMETHYSTS, US << MARKET, 9995, 1, 480200)
(AMETHYSTS, US << MARKET, 9995, 1, 480200)
(AMETHYSTS, US << MARKET, 9995, 1, 480200)
(AMETHYSTS, US << MARKET, 9995, 1, 480200)
(AMETHYSTS, US << MARKET, 9995, 1, 480200)","{""AMETHYSTS"": 3, ""STARFRUIT"": 13}",4162,5059,9998
480700,-5054,-96653,"(STARFRUIT, US << MARKET, 5054, 1, 480700)","{""AMETHYSTS"": 3, ""STARFRUIT"": 14}",4162,5058,10001
480800,5055,-91598,"(STARFRUIT, MARKET << US, 5055, 1, 480800)","{""AMETHYSTS"": 3, ""STARFRUIT"": 13}",4165,5058,10003
481300,-5058,-96656,"(STARFRUIT, US << MARKET, 5058, 1, 481300)","{""AMETHYSTS"": 3, ""STARFRUIT"": 14}",4094,5054,9998
481600,-10002,-106658,"(AMETHYSTS, US << MARKET, 10002, 1, 481600)","{""AMETHYSTS"": 4, ""STARFRUIT"": 14}",4152,5057,10003
481900,-30130,-136788,"(AMETHYSTS, US << MARKET, 10005, 1, 481900)
(AMETHYSTS, US << MARKET, 10005, 1, 481900)
(STARFRUIT, US << MARKET, 5060, 1, 481900)
(STARFRUIT, US << MARKET, 5060, 1, 481900)","{""AMETHYSTS"": 6, ""STARFRUIT"": 16}",4114,5056,10001
482000,-5053,-141841,"(STARFRUIT, US << MARKET, 5053, 1, 482000)","{""AMETHYSTS"": 6, ""STARFRUIT"": 17}",4129,5056,10003
482700,-15062,-156903,"(AMETHYSTS, US << MARKET, 10004, 1, 482700)
(STARFRUIT, US << MARKET, 5058, 1, 482700)","{""AMETHYSTS"": 7, ""STARFRUIT"": 18}",4087,5055,10000
483000,34953,-121950,"(AMETHYSTS, US << MARKET, 10002, 1, 483000)
(AMETHYSTS, US << MARKET, 10002, 1, 483000)
(AMETHYSTS, MARKET << US, 10002, 1, 483000)
(AMETHYSTS, MARKET << US, 10002, 1, 483000)
(AMETHYSTS, MARKET << US, 10002, 1, 483000)
(AMETHYSTS, MARKET << US, 10002, 1, 483000)
(AMETHYSTS, MARKET << US, 10002, 1, 483000)
(AMETHYSTS, MARKET << US, 10002, 1, 483000)
(STARFRUIT, US << MARKET, 5056, 1, 483000)
(STARFRUIT, US << MARKET, 5056, 1, 483000)
(STARFRUIT, MARKET << US, 5057, 1, 483000)","{""AMETHYSTS"": 3, ""STARFRUIT"": 19}",4066,5053,10003
483300,125076,3126,"(AMETHYSTS, MARKET << US, 10002, 1, 483300)
(AMETHYSTS, MARKET << US, 10002, 1, 483300)
(AMETHYSTS, MARKET << US, 10002, 1, 483300)
(AMETHYSTS, MARKET << US, 10002, 1, 483300)
(AMETHYSTS, MARKET << US, 10002, 1, 483300)
(AMETHYSTS, MARKET << US, 10002, 1, 483300)
(AMETHYSTS, MARKET << US, 10002, 1, 483300)
(AMETHYSTS, MARKET << US, 10002, 1, 483300)
(AMETHYSTS, MARKET << US, 10002, 1, 483300)
(AMETHYSTS, MARKET << US, 10002, 1, 483300)
(AMETHYSTS, MARKET << US, 10002, 1, 483300)
(AMETHYSTS, MARKET << US, 10002, 1, 483300)
(STARFRUIT, MARKET << US, 5052, 1, 483300)","{""AMETHYSTS"": -9, ""STARFRUIT"": 18}",4017,5051,10003
483400,15054,18180,"(AMETHYSTS, MARKET << US, 10000, 1, 483400)
(STARFRUIT, MARKET << US, 5054, 1, 483400)","{""AMETHYSTS"": -10, ""STARFRUIT"": 17}",4112,5056,10002
483900,-15062,3118,"(AMETHYSTS, US << MARKET, 10004, 1, 483900)
(STARFRUIT, US << MARKET, 5058, 1, 483900)","{""AMETHYSTS"": -9, ""STARFRUIT"": 18}",4108,5055,10000
484000,5052,8170,"(STARFRUIT, MARKET << US, 5052, 1, 484000)","{""AMETHYSTS"": -9, ""STARFRUIT"": 17}",4037,5051,10000
484200,9998,18168,"(AMETHYSTS, MARKET << US, 9998, 1, 484200)","{""AMETHYSTS"": -10, ""STARFRUIT"": 17}",4126,5054,9996
484300,9998,28166,"(AMETHYSTS, MARKET << US, 9998, 1, 484300)","{""AMETHYSTS"": -11, ""STARFRUIT"": 17}",4107,5056,10001
484500,15048,43214,"(AMETHYSTS, MARKET << US, 9998, 1, 484500)
(STARFRUIT, MARKET << US, 5050, 1, 484500)","{""AMETHYSTS"": -12, ""STARFRUIT"": 16}",4114,5054,9997
484700,-10002,33212,"(AMETHYSTS, US << MARKET, 10002, 1, 484700)","{""AMETHYSTS"": -11, ""STARFRUIT"": 16}",4066,5052,9998
485200,50130,83342,"(AMETHYSTS, MARKET << US, 10004, 1, 485200)
(AMETHYSTS, MARKET << US, 10004, 1, 485200)
(AMETHYSTS, MARKET << US, 10004, 1, 485200)
(AMETHYSTS, MARKET << US, 10004, 1, 485200)
(STARFRUIT, MARKET << US, 5057, 1, 485200)
(STARFRUIT, MARKET << US, 5057, 1, 485200)","{""AMETHYSTS"": -15, ""STARFRUIT"": 14}",4098,5054,10000
485300,4831,88173,"(AMETHYSTS, US << MARKET, 9998, 1, 485300)
(AMETHYSTS, US << MARKET, 9998, 1, 485300)
(AMETHYSTS, MARKET << US, 9998, 1, 485300)
(AMETHYSTS, MARKET << US, 9998, 1, 485300)
(AMETHYSTS, MARKET << US, 9998, 1, 485300)
(AMETHYSTS, MARKET << US, 9998, 1, 485300)
(STARFRUIT, US << MARKET, 5055, 1, 485300)
(STARFRUIT, US << MARKET, 5055, 1, 485300)
(STARFRUIT, US << MARKET, 5055, 1, 485300)
(STARFRUIT, US << MARKET, 5055, 1, 485300)
(STARFRUIT, MARKET << US, 5055, 1, 485300)","{""AMETHYSTS"": -17, ""STARFRUIT"": 17}",4176,5056,9997
485600,30006,118179,"(AMETHYSTS, MARKET << US, 10002, 1, 485600)
(AMETHYSTS, MARKET << US, 10002, 1, 485600)
(AMETHYSTS, MARKET << US, 10002, 1, 485600)","{""AMETHYSTS"": -20, ""STARFRUIT"": 17}",4054,5055,10003
485700,5052,123231,"(STARFRUIT, MARKET << US, 5052, 1, 485700)","{""AMETHYSTS"": -20, ""STARFRUIT"": 16}",4047,5051,10000
486500,-19996,103235,"(AMETHYSTS, US << MARKET, 9998, 1, 486500)
(AMETHYSTS, US << MARKET, 9998, 1, 486500)","{""AMETHYSTS"": -18, ""STARFRUIT"": 16}",4113,5056,10001
486600,30130,133365,"(AMETHYSTS, MARKET << US, 10005, 1, 486600)
(AMETHYSTS, MARKET << US, 10005, 1, 486600)
(STARFRUIT, MARKET << US, 5060, 1, 486600)
(STARFRUIT, MARKET << US, 5060, 1, 486600)","{""AMETHYSTS"": -20, ""STARFRUIT"": 14}",4191,5059,10000
487200,-35064,98301,"(AMETHYSTS, US << MARKET, 10002, 1, 487200)
(AMETHYSTS, US << MARKET, 10002, 1, 487200)
(AMETHYSTS, US << MARKET, 10002, 1, 487200)
(STARFRUIT, US << MARKET, 5058, 1, 487200)","{""AMETHYSTS"": -17, ""STARFRUIT"": 15}",4120,5058,10003
487400,-25041,73260,"(AMETHYSTS, US << MARKET, 9995, 1, 487400)
(AMETHYSTS, US << MARKET, 9995, 1, 487400)
(STARFRUIT, US << MARKET, 5051, 1, 487400)","{""AMETHYSTS"": -15, ""STARFRUIT"": 16}",4108,5053,10000
487600,50020,123280,"(AMETHYSTS, MARKET << US, 10004, 1, 487600)
(AMETHYSTS, MARKET << US, 10004, 1, 487600)
(AMETHYSTS, MARKET << US, 10004, 1, 487600)
(AMETHYSTS, MARKET << US, 10004, 1, 487600)
(AMETHYSTS, MARKET << US, 10004, 1, 487600)","{""AMETHYSTS"": -20, ""STARFRUIT"": 16}",4144,5054,10000
488200,0,123280,,"{""AMETHYSTS"": -20, ""STARFRUIT"": 16}",4148,5053,9999
488500,-10004,113276,"(AMETHYSTS, US << MARKET, 10005, 1, 488500)
(STARFRUIT, US << MARKET, 5054, 1, 488500)
(STARFRUIT, MARKET << US, 5055, 1, 488500)","{""AMETHYSTS"": -19, ""STARFRUIT"": 16}",4092,5051,10000
489300,9995,123271,"(AMETHYSTS, MARKET << US, 9995, 1, 489300)","{""AMETHYSTS"": -20, ""STARFRUIT"": 16}",4135,5054,10000
489400,-5056,118215,"(STARFRUIT, US << MARKET, 5056, 1, 489400)","{""AMETHYSTS"": -20, ""STARFRUIT"": 17}",4224,5057,9998
489500,-14940,103275,"(AMETHYSTS, US << MARKET, 9996, 1, 489500)
(AMETHYSTS, US << MARKET, 9996, 1, 489500)
(STARFRUIT, MARKET << US, 5052, 1, 489500)","{""AMETHYSTS"": -18, ""STARFRUIT"": 16}",4155,5055,10000
489600,4944,108219,"(AMETHYSTS, MARKET << US, 9995, 1, 489600)
(STARFRUIT, US << MARKET, 5051, 1, 489600)","{""AMETHYSTS"": -19, ""STARFRUIT"": 17}",4137,5054,10000
491100,9998,118217,"(AMETHYSTS, MARKET << US, 9998, 1, 491100)","{""AMETHYSTS"": -20, ""STARFRUIT"": 17}",4229,5056,9997
491600,-40008,78209,"(AMETHYSTS, US << MARKET, 10002, 1, 491600)
(AMETHYSTS, US << MARKET, 10002, 1, 491600)
(AMETHYSTS, US << MARKET, 10002, 1, 491600)
(AMETHYSTS, US << MARKET, 10002, 1, 491600)","{""AMETHYSTS"": -16, ""STARFRUIT"": 17}",4177,5056,9999
491800,-10002,68207,"(AMETHYSTS, US << MARKET, 10002, 1, 491800)","{""AMETHYSTS"": -15, ""STARFRUIT"": 17}",4114,5056,10003
492200,50025,118232,"(AMETHYSTS, MARKET << US, 10005, 1, 492200)
(AMETHYSTS, MARKET << US, 10005, 1, 492200)
(AMETHYSTS, MARKET << US, 10005, 1, 492200)
(AMETHYSTS, MARKET << US, 10005, 1, 492200)
(AMETHYSTS, MARKET << US, 10005, 1, 492200)","{""AMETHYSTS"": -20, ""STARFRUIT"": 17}",4184,5056,10000
492400,5054,123286,"(STARFRUIT, MARKET << US, 5054, 1, 492400)","{""AMETHYSTS"": -20, ""STARFRUIT"": 16}",4182,5056,10000
492700,5061,128347,"(STARFRUIT, MARKET << US, 5061, 1, 492700)","{""AMETHYSTS"": -20, ""STARFRUIT"": 15}",4262,5061,10000
492800,20256,148603,"(STARFRUIT, US << MARKET, 5060, 1, 492800)
(STARFRUIT, US << MARKET, 5060, 1, 492800)
(STARFRUIT, US << MARKET, 5060, 1, 492800)
(STARFRUIT, US << MARKET, 5060, 1, 492800)
(STARFRUIT, MARKET << US, 5062, 1, 492800)
(STARFRUIT, MARKET << US, 5062, 1, 492800)
(STARFRUIT, MARKET << US, 5062, 1, 492800)
(STARFRUIT, MARKET << US, 5062, 1, 492800)
(STARFRUIT, MARKET << US, 5062, 1, 492800)
(STARFRUIT, MARKET << US, 5062, 1, 492800)
(STARFRUIT, MARKET << US, 5062, 1, 492800)
(STARFRUIT, MARKET << US, 5062, 1, 492800)","{""AMETHYSTS"": -20, ""STARFRUIT"": 11}",4274,5061,10000
493000,0,148603,,"{""AMETHYSTS"": -20, ""STARFRUIT"": 11}",4252,5059,10000
493200,-19996,128607,"(AMETHYSTS, US << MARKET, 9998, 1, 493200)
(AMETHYSTS, US << MARKET, 9998, 1, 493200)","{""AMETHYSTS"": -18, ""STARFRUIT"": 11}",4310,5059,9997
493300,-5062,123545,"(STARFRUIT, US << MARKET, 5062, 1, 493300)","{""AMETHYSTS"": -18, ""STARFRUIT"": 12}",4271,5062,10001
493500,9996,133541,"(AMETHYSTS, MARKET << US, 9996, 1, 493500)","{""AMETHYSTS"": -19, ""STARFRUIT"": 12}",4292,5061,9999
493600,5058,138599,"(STARFRUIT, MARKET << US, 5058, 1, 493600)","{""AMETHYSTS"": -19, ""STARFRUIT"": 11}",4259,5060,10000
493900,10002,148601,"(AMETHYSTS, MARKET << US, 10002, 1, 493900)","{""AMETHYSTS"": -20, ""STARFRUIT"": 11}",4303,5062,9999
494100,-10002,138599,"(AMETHYSTS, US << MARKET, 10002, 1, 494100)","{""AMETHYSTS"": -19, ""STARFRUIT"": 11}",4202,5060,10003
494500,-30006,108593,"(AMETHYSTS, US << MARKET, 10002, 1, 494500)
(AMETHYSTS, US << MARKET, 10002, 1, 494500)
(AMETHYSTS, US << MARKET, 10002, 1, 494500)","{""AMETHYSTS"": -16, ""STARFRUIT"": 11}",4205,5060,10003
494800,14942,123535,"(AMETHYSTS, MARKET << US, 10002, 1, 494800)
(AMETHYSTS, MARKET << US, 10002, 1, 494800)
(STARFRUIT, US << MARKET, 5062, 1, 494800)","{""AMETHYSTS"": -18, ""STARFRUIT"": 12}",4225,5062,10003
495000,-5057,118478,"(STARFRUIT, US << MARKET, 5057, 1, 495000)","{""AMETHYSTS"": -18, ""STARFRUIT"": 13}",4227,5059,10001
495200,35399,153877,"(STARFRUIT, MARKET << US, 5057, 1, 495200)
(STARFRUIT, MARKET << US, 5057, 1, 495200)
(STARFRUIT, MARKET << US, 5057, 1, 495200)
(STARFRUIT, MARKET << US, 5057, 1, 495200)
(STARFRUIT, MARKET << US, 5057, 1, 495200)
(STARFRUIT, MARKET << US, 5057, 1, 495200)
(STARFRUIT, MARKET << US, 5057, 1, 495200)","{""AMETHYSTS"": -18, ""STARFRUIT"": 6}",4219,5060,10001
496000,5059,158936,"(STARFRUIT, MARKET << US, 5059, 1, 496000)","{""AMETHYSTS"": -18, ""STARFRUIT"": 5}",4246,5062,10000
496300,-10120,148816,"(STARFRUIT, US << MARKET, 5060, 1, 496300)
(STARFRUIT, US << MARKET, 5060, 1, 496300)","{""AMETHYSTS"": -18, ""STARFRUIT"": 7}",4228,5064,10002
496600,9998,158814,"(AMETHYSTS, MARKET << US, 9998, 1, 496600)","{""AMETHYSTS"": -19, ""STARFRUIT"": 7}",4312,5063,9997
497100,-79984,78830,"(AMETHYSTS, US << MARKET, 9998, 1, 497100)
(AMETHYSTS, US << MARKET, 9998, 1, 497100)
(AMETHYSTS, US << MARKET, 9998, 1, 497100)
(AMETHYSTS, US << MARKET, 9998, 1, 497100)
(AMETHYSTS, US << MARKET, 9998, 1, 497100)
(AMETHYSTS, US << MARKET, 9998, 1, 497100)
(AMETHYSTS, US << MARKET, 9998, 1, 497100)
(AMETHYSTS, US << MARKET, 9998, 1, 497100)","{""AMETHYSTS"": -11, ""STARFRUIT"": 7}",4304,5063,9997
497300,9998,88828,"(AMETHYSTS, MARKET << US, 9998, 1, 497300)","{""AMETHYSTS"": -12, ""STARFRUIT"": 7}",4298,5062,9997
497400,2,88830,"(AMETHYSTS, US << MARKET, 10002, 1, 497400)
(AMETHYSTS, US << MARKET, 10004, 1, 497400)
(AMETHYSTS, MARKET << US, 10004, 1, 497400)
(AMETHYSTS, MARKET << US, 10004, 1, 497400)
(STARFRUIT, US << MARKET, 5066, 1, 497400)
(STARFRUIT, MARKET << US, 5066, 1, 497400)","{""AMETHYSTS"": -12, ""STARFRUIT"": 7}",4235,5063,10003
497700,9998,98828,"(AMETHYSTS, MARKET << US, 9998, 1, 497700)","{""AMETHYSTS"": -13, ""STARFRUIT"": 7}",4230,5063,10003
497900,50020,148848,"(AMETHYSTS, US << MARKET, 10004, 1, 497900)
(AMETHYSTS, US << MARKET, 10004, 1, 497900)
(AMETHYSTS, MARKET << US, 10004, 1, 497900)
(AMETHYSTS, MARKET << US, 10004, 1, 497900)
(AMETHYSTS, MARKET << US, 10004, 1, 497900)
(AMETHYSTS, MARKET << US, 10004, 1, 497900)
(AMETHYSTS, MARKET << US, 10004, 1, 497900)
(AMETHYSTS, MARKET << US, 10004, 1, 497900)
(AMETHYSTS, MARKET << US, 10004, 1, 497900)","{""AMETHYSTS"": -18, ""STARFRUIT"": 7}",4289,5063,10000
498000,5065,153913,"(STARFRUIT, MARKET << US, 5065, 1, 498000)","{""AMETHYSTS"": -18, ""STARFRUIT"": 6}",4285,5062,10000
498200,-20244,133669,"(STARFRUIT, US << MARKET, 5061, 1, 498200)
(STARFRUIT, US << MARKET, 5061, 1, 498200)
(STARFRUIT, US << MARKET, 5061, 1, 498200)
(STARFRUIT, US << MARKET, 5061, 1, 498200)","{""AMETHYSTS"": -18, ""STARFRUIT"": 10}",4269,5060,10000
498300,9998,143667,"(AMETHYSTS, MARKET << US, 9998, 1, 498300)","{""AMETHYSTS"": -19, ""STARFRUIT"": 10}",4383,5064,9996
498400,10002,153669,"(AMETHYSTS, MARKET << US, 10002, 1, 498400)","{""AMETHYSTS"": -20, ""STARFRUIT"": 10}",4239,5063,10003
498500,-5065,148604,"(STARFRUIT, US << MARKET, 5065, 1, 498500)","{""AMETHYSTS"": -20, ""STARFRUIT"": 11}",4319,5065,10000
499000,-5060,143544,"(STARFRUIT, US << MARKET, 5060, 1, 499000)","{""AMETHYSTS"": -20, ""STARFRUIT"": 12}",4308,5062,9999
499400,-10124,133420,"(STARFRUIT, US << MARKET, 5062, 1, 499400)
(STARFRUIT, US << MARKET, 5062, 1, 499400)","{""AMETHYSTS"": -20, ""STARFRUIT"": 14}",4274,5061,10000
499700,0,133420,,"{""AMETHYSTS"": -20, ""STARFRUIT"": 14}",4274,5061,10000
499900,-15061,118359,"(AMETHYSTS, US << MARKET, 10002, 1, 499900)
(STARFRUIT, US << MARKET, 5059, 1, 499900)","{""AMETHYSTS"": -19, ""STARFRUIT"": 15}",4232,5062,10003
500000,5060,123419,"(STARFRUIT, MARKET << US, 5060, 1, 500000)","{""AMETHYSTS"": -19, ""STARFRUIT"": 14}",4245,5059,10000
501200,-116,123303,"(AMETHYSTS, MARKET << US, 10002, 1, 501200)
(STARFRUIT, US << MARKET, 5059, 1, 501200)
(STARFRUIT, US << MARKET, 5059, 1, 501200)","{""AMETHYSTS"": -20, ""STARFRUIT"": 16}",4235,5062,10003
501800,-59975,63328,"(AMETHYSTS, US << MARKET, 9996, 1, 501800)
(AMETHYSTS, US << MARKET, 9996, 1, 501800)
(AMETHYSTS, US << MARKET, 9996, 1, 501800)
(AMETHYSTS, US << MARKET, 9996, 1, 501800)
(AMETHYSTS, US << MARKET, 9996, 1, 501800)
(AMETHYSTS, US << MARKET, 9996, 1, 501800)
(STARFRUIT, US << MARKET, 5065, 1, 501800)
(STARFRUIT, MARKET << US, 5066, 1, 501800)","{""AMETHYSTS"": -14, ""STARFRUIT"": 16}",4336,5063,10000
501900,40008,103336,"(AMETHYSTS, MARKET << US, 10002, 1, 501900)
(AMETHYSTS, MARKET << US, 10002, 1, 501900)
(AMETHYSTS, MARKET << US, 10002, 1, 501900)
(AMETHYSTS, MARKET << US, 10002, 1, 501900)","{""AMETHYSTS"": -18, ""STARFRUIT"": 16}",4258,5061,10003
502100,-10002,93334,"(AMETHYSTS, US << MARKET, 10002, 1, 502100)","{""AMETHYSTS"": -17, ""STARFRUIT"": 16}",4259,5061,10003
502300,35457,128791,"(STARFRUIT, US << MARKET, 5063, 1, 502300)
(STARFRUIT, MARKET << US, 5065, 1, 502300)
(STARFRUIT, MARKET << US, 5065, 1, 502300)
(STARFRUIT, MARKET << US, 5065, 1, 502300)
(STARFRUIT, MARKET << US, 5065, 1, 502300)
(STARFRUIT, MARKET << US, 5065, 1, 502300)
(STARFRUIT, MARKET << US, 5065, 1, 502300)
(STARFRUIT, MARKET << US, 5065, 1, 502300)
(STARFRUIT, MARKET << US, 5065, 1, 502300)","{""AMETHYSTS"": -17, ""STARFRUIT"": 9}",4350,5064,10001
502500,45192,173983,"(AMETHYSTS, MARKET << US, 10002, 1, 502500)
(AMETHYSTS, MARKET << US, 10002, 1, 502500)
(AMETHYSTS, MARKET << US, 10002, 1, 502500)
(STARFRUIT, MARKET << US, 5064, 1, 502500)
(STARFRUIT, MARKET << US, 5064, 1, 502500)
(STARFRUIT, MARKET << US, 5058, 1, 502500)","{""AMETHYSTS"": -20, ""STARFRUIT"": 6}",4369,5061,9999
502600,-39984,133999,"(AMETHYSTS, US << MARKET, 9996, 1, 502600)
(AMETHYSTS, US << MARKET, 9996, 1, 502600)
(AMETHYSTS, US << MARKET, 9996, 1, 502600)
(AMETHYSTS, US << MARKET, 9996, 1, 502600)","{""AMETHYSTS"": -16, ""STARFRUIT"": 6}",4359,5060,10000
503400,30012,164011,"(AMETHYSTS, MARKET << US, 10004, 1, 503400)
(AMETHYSTS, MARKET << US, 10004, 1, 503400)
(AMETHYSTS, MARKET << US, 10004, 1, 503400)","{""AMETHYSTS"": -19, ""STARFRUIT"": 6}",4377,5061,10000
504300,-10116,153895,"(STARFRUIT, US << MARKET, 5058, 1, 504300)
(STARFRUIT, US << MARKET, 5058, 1, 504300)","{""AMETHYSTS"": -19, ""STARFRUIT"": 8}",4383,5061,10000
504500,-4939,148956,"(AMETHYSTS, US << MARKET, 10002, 1, 504500)
(STARFRUIT, MARKET << US, 5063, 1, 504500)","{""AMETHYSTS"": -18, ""STARFRUIT"": 7}",4398,5058,9998
504700,-10002,138954,"(AMETHYSTS, US << MARKET, 10002, 1, 504700)","{""AMETHYSTS"": -17, ""STARFRUIT"": 7}",4316,5059,10003
505200,-10002,128952,"(AMETHYSTS, US << MARKET, 10002, 1, 505200)","{""AMETHYSTS"": -16, ""STARFRUIT"": 7}",4395,5061,9999
505300,-5059,123893,"(STARFRUIT, US << MARKET, 5059, 1, 505300)","{""AMETHYSTS"": -16, ""STARFRUIT"": 8}",4397,5061,9999
505500,35076,158969,"(AMETHYSTS, US << MARKET, 10004, 1, 505500)
(AMETHYSTS, MARKET << US, 10004, 1, 505500)
(AMETHYSTS, MARKET << US, 10004, 1, 505500)
(AMETHYSTS, MARKET << US, 10004, 1, 505500)
(AMETHYSTS, MARKET << US, 10004, 1, 505500)
(STARFRUIT, MARKET << US, 5064, 1, 505500)","{""AMETHYSTS"": -19, ""STARFRUIT"": 7}",4398,5064,10001
505600,5059,164028,"(STARFRUIT, MARKET << US, 5059, 1, 505600)","{""AMETHYSTS"": -19, ""STARFRUIT"": 6}",4394,5061,10000
506000,9998,174026,"(AMETHYSTS, MARKET << US, 9998, 1, 506000)","{""AMETHYSTS"": -20, ""STARFRUIT"": 6}",4458,5062,9997
506100,-30006,144020,"(AMETHYSTS, US << MARKET, 10002, 1, 506100)
(AMETHYSTS, US << MARKET, 10002, 1, 506100)
(AMETHYSTS, US << MARKET, 10002, 1, 506100)","{""AMETHYSTS"": -17, ""STARFRUIT"": 6}",4415,5063,9999
506300,19990,164010,"(AMETHYSTS, MARKET << US, 9995, 1, 506300)
(AMETHYSTS, MARKET << US, 9995, 1, 506300)","{""AMETHYSTS"": -19, ""STARFRUIT"": 6}",4388,5063,10000
506500,9995,174005,"(AMETHYSTS, MARKET << US, 9995, 1, 506500)","{""AMETHYSTS"": -20, ""STARFRUIT"": 6}",4377,5062,10000
506600,25310,199315,"(STARFRUIT, MARKET << US, 5062, 1, 506600)
(STARFRUIT, MARKET << US, 5062, 1, 506600)
(STARFRUIT, MARKET << US, 5062, 1, 506600)
(STARFRUIT, MARKET << US, 5062, 1, 506600)
(STARFRUIT, MARKET << US, 5062, 1, 506600)","{""AMETHYSTS"": -20, ""STARFRUIT"": 1}",4415,5060,9998
507600,-14935,184380,"(AMETHYSTS, US << MARKET, 9998, 1, 507600)
(AMETHYSTS, US << MARKET, 9998, 1, 507600)
(STARFRUIT, MARKET << US, 5061, 1, 507600)","{""AMETHYSTS"": -18, ""STARFRUIT"": 0}",4434,5062,9997
507700,-10002,174378,"(AMETHYSTS, US << MARKET, 10002, 1, 507700)","{""AMETHYSTS"": -17, ""STARFRUIT"": 0}",4412,5063,9998
508200,5065,179443,"(STARFRUIT, MARKET << US, 5065, 1, 508200)","{""AMETHYSTS"": -17, ""STARFRUIT"": -1}",4327,5065,10003
508400,-30272,149171,"(AMETHYSTS, US << MARKET, 10004, 1, 508400)
(STARFRUIT, US << MARKET, 5067, 1, 508400)
(STARFRUIT, US << MARKET, 5067, 1, 508400)
(STARFRUIT, US << MARKET, 5067, 1, 508400)
(STARFRUIT, US << MARKET, 5067, 1, 508400)","{""AMETHYSTS"": -16, ""STARFRUIT"": 3}",4360,5063,10000
508600,20264,169435,"(STARFRUIT, MARKET << US, 5066, 1, 508600)
(STARFRUIT, MARKET << US, 5066, 1, 508600)
(STARFRUIT, MARKET << US, 5066, 1, 508600)
(STARFRUIT, MARKET << US, 5066, 1, 508600)","{""AMETHYSTS"": -16, ""STARFRUIT"": -1}",4371,5064,10000
508800,9998,179433,"(AMETHYSTS, MARKET << US, 9998, 1, 508800)","{""AMETHYSTS"": -17, ""STARFRUIT"": -1}",4421,5063,9997
508900,-10134,169299,"(STARFRUIT, US << MARKET, 5067, 1, 508900)
(STARFRUIT, US << MARKET, 5067, 1, 508900)","{""AMETHYSTS"": -17, ""STARFRUIT"": 1}",4383,5067,9999
509300,-25325,143974,"(STARFRUIT, US << MARKET, 5065, 1, 509300)
(STARFRUIT, US << MARKET, 5065, 1, 509300)
(STARFRUIT, US << MARKET, 5065, 1, 509300)
(STARFRUIT, US << MARKET, 5065, 1, 509300)
(STARFRUIT, US << MARKET, 5065, 1, 509300)","{""AMETHYSTS"": -17, ""STARFRUIT"": 6}",4369,5063,9999
509500,-15188,128786,"(STARFRUIT, US << MARKET, 5064, 1, 509500)
(STARFRUIT, US << MARKET, 5064, 1, 509500)
(STARFRUIT, US << MARKET, 5064, 1, 509500)
(STARFRUIT, US << MARKET, 5064, 1, 509500)
(STARFRUIT, MARKET << US, 5068, 1, 509500)","{""AMETHYSTS"": -17, ""STARFRUIT"": 9}",4387,5063,9998
509700,14935,143721,"(AMETHYSTS, US << MARKET, 10002, 1, 509700)
(AMETHYSTS, MARKET << US, 10002, 1, 509700)
(AMETHYSTS, MARKET << US, 10002, 1, 509700)
(AMETHYSTS, MARKET << US, 10002, 1, 509700)
(STARFRUIT, US << MARKET, 5069, 1, 509700)","{""AMETHYSTS"": -19, ""STARFRUIT"": 10}",4354,5069,10003
509800,20124,163845,"(AMETHYSTS, MARKET << US, 9996, 1, 509800)
(STARFRUIT, MARKET << US, 5064, 1, 509800)
(STARFRUIT, MARKET << US, 5064, 1, 509800)","{""AMETHYSTS"": -20, ""STARFRUIT"": 8}",4433,5066,9997
509900,-10140,153705,"(STARFRUIT, US << MARKET, 5070, 1, 509900)
(STARFRUIT, US << MARKET, 5070, 1, 509900)","{""AMETHYSTS"": -20, ""STARFRUIT"": 10}",4365,5066,10000
510100,-60248,93457,"(AMETHYSTS, US << MARKET, 9998, 1, 510100)
(AMETHYSTS, US << MARKET, 9998, 1, 510100)
(AMETHYSTS, US << MARKET, 9998, 1, 510100)
(AMETHYSTS, US << MARKET, 9998, 1, 510100)
(STARFRUIT, US << MARKET, 5064, 1, 510100)
(STARFRUIT, US << MARKET, 5064, 1, 510100)
(STARFRUIT, US << MARKET, 5064, 1, 510100)
(STARFRUIT, US << MARKET, 5064, 1, 510100)","{""AMETHYSTS"": -16, ""STARFRUIT"": 14}",4379,5067,10001
510200,-19996,73461,"(AMETHYSTS, US << MARKET, 9998, 1, 510200)
(AMETHYSTS, US << MARKET, 9998, 1, 510200)","{""AMETHYSTS"": -14, ""STARFRUIT"": 14}",4455,5067,9996
510900,10134,83595,"(STARFRUIT, MARKET << US, 5067, 1, 510900)
(STARFRUIT, MARKET << US, 5067, 1, 510900)","{""AMETHYSTS"": -14, ""STARFRUIT"": 12}",4401,5066,9999
511100,20004,103599,"(AMETHYSTS, MARKET << US, 10002, 1, 511100)
(AMETHYSTS, MARKET << US, 10002, 1, 511100)","{""AMETHYSTS"": -16, ""STARFRUIT"": 12}",4419,5067,9999
511300,-39984,63615,"(AMETHYSTS, US << MARKET, 9996, 1, 511300)
(AMETHYSTS, US << MARKET, 9996, 1, 511300)
(AMETHYSTS, US << MARKET, 9996, 1, 511300)
(AMETHYSTS, US << MARKET, 9996, 1, 511300)","{""AMETHYSTS"": -12, ""STARFRUIT"": 12}",4467,5068,9997
511400,4931,68546,"(AMETHYSTS, MARKET << US, 9996, 1, 511400)
(STARFRUIT, US << MARKET, 5065, 1, 511400)","{""AMETHYSTS"": -13, ""STARFRUIT"": 13}",4417,5067,10000
511500,20276,88822,"(STARFRUIT, MARKET << US, 5069, 1, 511500)
(STARFRUIT, MARKET << US, 5069, 1, 511500)
(STARFRUIT, MARKET << US, 5069, 1, 511500)
(STARFRUIT, MARKET << US, 5069, 1, 511500)","{""AMETHYSTS"": -13, ""STARFRUIT"": 9}",4452,5070,10000
511700,9998,98820,"(AMETHYSTS, MARKET << US, 9998, 1, 511700)","{""AMETHYSTS"": -14, ""STARFRUIT"": 9}",4474,5068,9997
511800,50164,148984,"(AMETHYSTS, MARKET << US, 10005, 1, 511800)
(AMETHYSTS, MARKET << US, 10005, 1, 511800)
(AMETHYSTS, MARKET << US, 10005, 1, 511800)
(AMETHYSTS, MARKET << US, 10005, 1, 511800)
(STARFRUIT, MARKET << US, 5072, 1, 511800)
(STARFRUIT, MARKET << US, 5072, 1, 511800)","{""AMETHYSTS"": -18, ""STARFRUIT"": 7}",4442,5068,10001
512200,15063,164047,"(AMETHYSTS, MARKET << US, 9998, 1, 512200)
(STARFRUIT, MARKET << US, 5065, 1, 512200)","{""AMETHYSTS"": -19, ""STARFRUIT"": 6}",4430,5067,10001
512700,10002,174049,"(AMETHYSTS, MARKET << US, 10002, 1, 512700)","{""AMETHYSTS"": -20, ""STARFRUIT"": 6}",4457,5068,10000
512900,0,174049,,"{""AMETHYSTS"": -20, ""STARFRUIT"": 6}",4391,5067,10003
513400,25355,199404,"(STARFRUIT, MARKET << US, 5071, 1, 513400)
(STARFRUIT, MARKET << US, 5071, 1, 513400)
(STARFRUIT, MARKET << US, 5071, 1, 513400)
(STARFRUIT, MARKET << US, 5071, 1, 513400)
(STARFRUIT, MARKET << US, 5071, 1, 513400)","{""AMETHYSTS"": -20, ""STARFRUIT"": 1}",4474,5070,10000
514100,0,199404,,"{""AMETHYSTS"": -20, ""STARFRUIT"": 1}",4451,5067,10001
514600,-100020,99384,"(AMETHYSTS, US << MARKET, 10002, 1, 514600)
(AMETHYSTS, US << MARKET, 10002, 1, 514600)
(AMETHYSTS, US << MARKET, 10002, 1, 514600)
(AMETHYSTS, US << MARKET, 10002, 1, 514600)
(AMETHYSTS, US << MARKET, 10002, 1, 514600)
(AMETHYSTS, US << MARKET, 10002, 1, 514600)
(AMETHYSTS, US << MARKET, 10002, 1, 514600)
(AMETHYSTS, US << MARKET, 10002, 1, 514600)
(AMETHYSTS, US << MARKET, 10002, 1, 514600)
(AMETHYSTS, US << MARKET, 10002, 1, 514600)","{""AMETHYSTS"": -10, ""STARFRUIT"": 1}",4420,5066,10003
515200,-30118,69266,"(AMETHYSTS, US << MARKET, 9995, 1, 515200)
(AMETHYSTS, US << MARKET, 9995, 1, 515200)
(STARFRUIT, US << MARKET, 5064, 1, 515200)
(STARFRUIT, US << MARKET, 5064, 1, 515200)","{""AMETHYSTS"": -8, ""STARFRUIT"": 3}",4483,5067,9998
515500,-25310,43956,"(STARFRUIT, US << MARKET, 5062, 1, 515500)
(STARFRUIT, US << MARKET, 5062, 1, 515500)
(STARFRUIT, US << MARKET, 5062, 1, 515500)
(STARFRUIT, US << MARKET, 5062, 1, 515500)
(STARFRUIT, US << MARKET, 5062, 1, 515500)","{""AMETHYSTS"": -8, ""STARFRUIT"": 8}",4476,5065,10000
515700,-19996,23960,"(AMETHYSTS, US << MARKET, 9998, 1, 515700)
(AMETHYSTS, US << MARKET, 9998, 1, 515700)","{""AMETHYSTS"": -6, ""STARFRUIT"": 8}",4504,5065,9996
515800,-45051,-21091,"(AMETHYSTS, US << MARKET, 9996, 1, 515800)
(AMETHYSTS, US << MARKET, 9996, 1, 515800)
(AMETHYSTS, US << MARKET, 9996, 1, 515800)
(AMETHYSTS, US << MARKET, 9996, 1, 515800)
(STARFRUIT, US << MARKET, 5067, 1, 515800)","{""AMETHYSTS"": -2, ""STARFRUIT"": 9}",4521,5068,10000
515900,-139972,-161063,"(AMETHYSTS, US << MARKET, 9998, 1, 515900)
(AMETHYSTS, US << MARKET, 9998, 1, 515900)
(AMETHYSTS, US << MARKET, 9998, 1, 515900)
(AMETHYSTS, US << MARKET, 9998, 1, 515900)
(AMETHYSTS, US << MARKET, 9998, 1, 515900)
(AMETHYSTS, US << MARKET, 9998, 1, 515900)
(AMETHYSTS, US << MARKET, 9998, 1, 515900)
(AMETHYSTS, US << MARKET, 9998, 1, 515900)
(AMETHYSTS, US << MARKET, 9998, 1, 515900)
(AMETHYSTS, US << MARKET, 9998, 1, 515900)
(AMETHYSTS, US << MARKET, 9998, 1, 515900)
(AMETHYSTS, US << MARKET, 9998, 1, 515900)
(AMETHYSTS, US << MARKET, 9998, 1, 515900)
(AMETHYSTS, US << MARKET, 9998, 1, 515900)","{""AMETHYSTS"": 12, ""STARFRUIT"": 9}",4465,5064,9996
516100,-54921,-215984,"(AMETHYSTS, US << MARKET, 9998, 1, 516100)
(AMETHYSTS, US << MARKET, 9998, 1, 516100)
(AMETHYSTS, US << MARKET, 9998, 1, 516100)
(AMETHYSTS, US << MARKET, 9998, 1, 516100)
(AMETHYSTS, US << MARKET, 9998, 1, 516100)
(AMETHYSTS, US << MARKET, 9998, 1, 516100)
(STARFRUIT, MARKET << US, 5067, 1, 516100)","{""AMETHYSTS"": 18, ""STARFRUIT"": 8}",4492,5064,9998
516200,20364,-195620,"(AMETHYSTS, US << MARKET, 10002, 1, 516200)
(STARFRUIT, MARKET << US, 5061, 1, 516200)
(STARFRUIT, MARKET << US, 5061, 1, 516200)
(STARFRUIT, MARKET << US, 5061, 1, 516200)
(STARFRUIT, MARKET << US, 5061, 1, 516200)
(STARFRUIT, MARKET << US, 5061, 1, 516200)
(STARFRUIT, MARKET << US, 5061, 1, 516200)","{""AMETHYSTS"": 19, ""STARFRUIT"": 2}",4472,5065,9998
516300,-129,-195749,"(AMETHYSTS, MARKET << US, 9995, 1, 516300)
(STARFRUIT, US << MARKET, 5062, 1, 516300)
(STARFRUIT, US << MARKET, 5062, 1, 516300)","{""AMETHYSTS"": 18, ""STARFRUIT"": 4}",4475,5065,9998
516400,44818,-150931,"(AMETHYSTS, MARKET << US, 10004, 1, 516400)
(AMETHYSTS, MARKET << US, 10004, 1, 516400)
(AMETHYSTS, MARKET << US, 10004, 1, 516400)
(AMETHYSTS, MARKET << US, 10004, 1, 516400)
(AMETHYSTS, MARKET << US, 10004, 1, 516400)
(AMETHYSTS, MARKET << US, 10002, 1, 516400)
(STARFRUIT, US << MARKET, 5068, 1, 516400)
(STARFRUIT, US << MARKET, 5068, 1, 516400)
(STARFRUIT, US << MARKET, 5068, 1, 516400)","{""AMETHYSTS"": 12, ""STARFRUIT"": 7}",4560,5065,10003
517300,-29862,-180793,"(AMETHYSTS, US << MARKET, 9996, 1, 517300)
(AMETHYSTS, US << MARKET, 9996, 1, 517300)
(AMETHYSTS, US << MARKET, 9996, 1, 517300)
(AMETHYSTS, US << MARKET, 9996, 1, 517300)
(STARFRUIT, MARKET << US, 5061, 1, 517300)
(STARFRUIT, MARKET << US, 5061, 1, 517300)","{""AMETHYSTS"": 16, ""STARFRUIT"": 5}",4527,5064,10000
517900,-19996,-200789,"(AMETHYSTS, US << MARKET, 9998, 1, 517900)
(AMETHYSTS, US << MARKET, 9998, 1, 517900)","{""AMETHYSTS"": 18, ""STARFRUIT"": 5}",4544,5063,10001
518500,-20252,-221041,"(STARFRUIT, US << MARKET, 5063, 1, 518500)
(STARFRUIT, US << MARKET, 5063, 1, 518500)
(STARFRUIT, US << MARKET, 5063, 1, 518500)
(STARFRUIT, US << MARKET, 5063, 1, 518500)","{""AMETHYSTS"": 18, ""STARFRUIT"": 9}",4571,5064,10002
518700,-10002,-231043,"(AMETHYSTS, US << MARKET, 10002, 1, 518700)","{""AMETHYSTS"": 19, ""STARFRUIT"": 9}",4590,5064,10003
518800,-15070,-246113,"(AMETHYSTS, US << MARKET, 10002, 1, 518800)
(STARFRUIT, US << MARKET, 5068, 1, 518800)","{""AMETHYSTS"": 20, ""STARFRUIT"": 10}",4627,5068,10003
519400,-5069,-251182,"(STARFRUIT, US << MARKET, 5069, 1, 519400)","{""AMETHYSTS"": 20, ""STARFRUIT"": 11}",4593,5065,10003
519500,30378,-220804,"(STARFRUIT, US << MARKET, 5063, 1, 519500)
(STARFRUIT, MARKET << US, 5063, 1, 519500)
(STARFRUIT, MARKET << US, 5063, 1, 519500)
(STARFRUIT, MARKET << US, 5063, 1, 519500)
(STARFRUIT, MARKET << US, 5063, 1, 519500)
(STARFRUIT, MARKET << US, 5063, 1, 519500)
(STARFRUIT, MARKET << US, 5063, 1, 519500)
(STARFRUIT, MARKET << US, 5063, 1, 519500)","{""AMETHYSTS"": 20, ""STARFRUIT"": 5}",4526,5066,10000
519700,-15207,-236011,"(STARFRUIT, US << MARKET, 5069, 1, 519700)
(STARFRUIT, US << MARKET, 5069, 1, 519700)
(STARFRUIT, US << MARKET, 5069, 1, 519700)","{""AMETHYSTS"": 20, ""STARFRUIT"": 8}",4537,5066,10001
520400,5063,-230948,"(STARFRUIT, MARKET << US, 5063, 1, 520400)","{""AMETHYSTS"": 20, ""STARFRUIT"": 7}",4486,5062,10000
520600,-20268,-251216,"(STARFRUIT, US << MARKET, 5067, 1, 520600)
(STARFRUIT, US << MARKET, 5067, 1, 520600)
(STARFRUIT, US << MARKET, 5067, 1, 520600)
(STARFRUIT, US << MARKET, 5067, 1, 520600)","{""AMETHYSTS"": 20, ""STARFRUIT"": 11}",4488,5064,10000
521000,35448,-215768,"(STARFRUIT, MARKET << US, 5064, 1, 521000)
(STARFRUIT, MARKET << US, 5064, 1, 521000)
(STARFRUIT, MARKET << US, 5064, 1, 521000)
(STARFRUIT, MARKET << US, 5064, 1, 521000)
(STARFRUIT, MARKET << US, 5064, 1, 521000)
(STARFRUIT, MARKET << US, 5064, 1, 521000)
(STARFRUIT, MARKET << US, 5064, 1, 521000)","{""AMETHYSTS"": 20, ""STARFRUIT"": 4}",4464,5063,9999
521300,5063,-210705,"(STARFRUIT, MARKET << US, 5063, 1, 521300)","{""AMETHYSTS"": 20, ""STARFRUIT"": 3}",4553,5066,10003
521600,220088,9383,"(AMETHYSTS, MARKET << US, 10004, 1, 521600)
(AMETHYSTS, MARKET << US, 10004, 1, 521600)
(AMETHYSTS, MARKET << US, 10004, 1, 521600)
(AMETHYSTS, MARKET << US, 10004, 1, 521600)
(AMETHYSTS, MARKET << US, 10004, 1, 521600)
(AMETHYSTS, MARKET << US, 10004, 1, 521600)
(AMETHYSTS, MARKET << US, 10004, 1, 521600)
(AMETHYSTS, MARKET << US, 10004, 1, 521600)
(AMETHYSTS, MARKET << US, 10004, 1, 521600)
(AMETHYSTS, MARKET << US, 10004, 1, 521600)
(AMETHYSTS, MARKET << US, 10004, 1, 521600)
(AMETHYSTS, MARKET << US, 10004, 1, 521600)
(AMETHYSTS, MARKET << US, 10004, 1, 521600)
(AMETHYSTS, MARKET << US, 10004, 1, 521600)
(AMETHYSTS, MARKET << US, 10004, 1, 521600)
(AMETHYSTS, MARKET << US, 10004, 1, 521600)
(AMETHYSTS, MARKET << US, 10004, 1, 521600)
(AMETHYSTS, MARKET << US, 10004, 1, 521600)
(AMETHYSTS, MARKET << US, 10004, 1, 521600)
(AMETHYSTS, MARKET << US, 10004, 1, 521600)
(AMETHYSTS, MARKET << US, 10004, 1, 521600)
(AMETHYSTS, MARKET << US, 10004, 1, 521600)","{""AMETHYSTS"": -2, ""STARFRUIT"": 3}",4578,5065,10000
521700,29878,39261,"(AMETHYSTS, MARKET << US, 10004, 1, 521700)
(AMETHYSTS, MARKET << US, 10004, 1, 521700)
(AMETHYSTS, MARKET << US, 10004, 1, 521700)
(AMETHYSTS, MARKET << US, 10002, 1, 521700)
(STARFRUIT, US << MARKET, 5068, 1, 521700)
(STARFRUIT, US << MARKET, 5068, 1, 521700)","{""AMETHYSTS"": -6, ""STARFRUIT"": 5}",4578,5067,10003
521800,-15216,24045,"(STARFRUIT, US << MARKET, 5070, 1, 521800)
(STARFRUIT, US << MARKET, 5070, 1, 521800)
(STARFRUIT, US << MARKET, 5070, 1, 521800)
(STARFRUIT, US << MARKET, 5070, 1, 521800)
(STARFRUIT, MARKET << US, 5064, 1, 521800)","{""AMETHYSTS"": -6, ""STARFRUIT"": 8}",4573,5066,10000
522400,0,24045,"(STARFRUIT, US << MARKET, 5067, 1, 522400)
(STARFRUIT, US << MARKET, 5067, 1, 522400)
(STARFRUIT, US << MARKET, 5067, 1, 522400)
(STARFRUIT, US << MARKET, 5067, 1, 522400)
(STARFRUIT, MARKET << US, 5067, 1, 522400)
(STARFRUIT, MARKET << US, 5067, 1, 522400)
(STARFRUIT, MARKET << US, 5067, 1, 522400)
(STARFRUIT, MARKET << US, 5067, 1, 522400)","{""AMETHYSTS"": -6, ""STARFRUIT"": 8}",4559,5065,10001
522500,9870,33915,"(AMETHYSTS, MARKET << US, 10002, 1, 522500)
(AMETHYSTS, MARKET << US, 10002, 1, 522500)
(STARFRUIT, US << MARKET, 5067, 1, 522500)
(STARFRUIT, US << MARKET, 5067, 1, 522500)","{""AMETHYSTS"": -8, ""STARFRUIT"": 10}",4573,5065,9999
522800,25310,59225,"(STARFRUIT, US << MARKET, 5062, 1, 522800)
(STARFRUIT, MARKET << US, 5062, 1, 522800)
(STARFRUIT, MARKET << US, 5062, 1, 522800)
(STARFRUIT, MARKET << US, 5062, 1, 522800)
(STARFRUIT, MARKET << US, 5062, 1, 522800)
(STARFRUIT, MARKET << US, 5062, 1, 522800)
(STARFRUIT, MARKET << US, 5062, 1, 522800)","{""AMETHYSTS"": -8, ""STARFRUIT"": 5}",4542,5065,10001
523300,-59988,-763,"(AMETHYSTS, US << MARKET, 9998, 1, 523300)
(AMETHYSTS, US << MARKET, 9998, 1, 523300)
(AMETHYSTS, US << MARKET, 9998, 1, 523300)
(AMETHYSTS, US << MARKET, 9998, 1, 523300)
(AMETHYSTS, US << MARKET, 9998, 1, 523300)
(AMETHYSTS, US << MARKET, 9998, 1, 523300)","{""AMETHYSTS"": -2, ""STARFRUIT"": 5}",4560,5065,10001
523500,-10134,-10897,"(STARFRUIT, US << MARKET, 5067, 1, 523500)
(STARFRUIT, US << MARKET, 5067, 1, 523500)","{""AMETHYSTS"": -2, ""STARFRUIT"": 7}",4544,5063,10000
523600,-65054,-75951,"(AMETHYSTS, US << MARKET, 9998, 1, 523600)
(AMETHYSTS, US << MARKET, 9998, 1, 523600)
(AMETHYSTS, US << MARKET, 9998, 1, 523600)
(AMETHYSTS, US << MARKET, 9998, 1, 523600)
(AMETHYSTS, US << MARKET, 9998, 1, 523600)
(AMETHYSTS, US << MARKET, 9998, 1, 523600)
(STARFRUIT, US << MARKET, 5066, 1, 523600)","{""AMETHYSTS"": 4, ""STARFRUIT"": 8}",4569,5067,9996
524200,-19996,-95947,"(AMETHYSTS, US << MARKET, 9998, 1, 524200)
(AMETHYSTS, US << MARKET, 9998, 1, 524200)","{""AMETHYSTS"": 6, ""STARFRUIT"": 8}",4579,5065,10001
524500,5062,-90885,"(STARFRUIT, MARKET << US, 5062, 1, 524500)","{""AMETHYSTS"": 6, ""STARFRUIT"": 7}",4570,5065,10000
525000,-4939,-95824,"(AMETHYSTS, US << MARKET, 10004, 1, 525000)
(STARFRUIT, MARKET << US, 5065, 1, 525000)","{""AMETHYSTS"": 7, ""STARFRUIT"": 6}",4548,5062,10000
525300,-4937,-100761,"(AMETHYSTS, US << MARKET, 10002, 1, 525300)
(STARFRUIT, MARKET << US, 5065, 1, 525300)","{""AMETHYSTS"": 8, ""STARFRUIT"": 5}",4593,5066,10003
525400,-10002,-110763,"(AMETHYSTS, US << MARKET, 10002, 1, 525400)","{""AMETHYSTS"": 9, ""STARFRUIT"": 5}",4529,5062,9998
525600,-15189,-125952,"(STARFRUIT, US << MARKET, 5063, 1, 525600)
(STARFRUIT, US << MARKET, 5063, 1, 525600)
(STARFRUIT, US << MARKET, 5063, 1, 525600)","{""AMETHYSTS"": 9, ""STARFRUIT"": 8}",4528,5060,10000
525700,40355,-85597,"(AMETHYSTS, MARKET << US, 9996, 1, 525700)
(STARFRUIT, MARKET << US, 5060, 1, 525700)
(STARFRUIT, MARKET << US, 5060, 1, 525700)
(STARFRUIT, MARKET << US, 5060, 1, 525700)
(STARFRUIT, MARKET << US, 5060, 1, 525700)
(STARFRUIT, MARKET << US, 5060, 1, 525700)
(STARFRUIT, MARKET << US, 5059, 1, 525700)","{""AMETHYSTS"": 8, ""STARFRUIT"": 2}",4521,5059,10000
526200,-10114,-95711,"(STARFRUIT, US << MARKET, 5057, 1, 526200)
(STARFRUIT, US << MARKET, 5057, 1, 526200)","{""AMETHYSTS"": 8, ""STARFRUIT"": 4}",4529,5060,10000
526600,5063,-90648,"(STARFRUIT, MARKET << US, 5063, 1, 526600)","{""AMETHYSTS"": 8, ""STARFRUIT"": 3}",4532,5060,10000
527100,19992,-70656,"(AMETHYSTS, MARKET << US, 9996, 1, 527100)
(AMETHYSTS, MARKET << US, 9996, 1, 527100)","{""AMETHYSTS"": 6, ""STARFRUIT"": 3}",4521,5059,10000
527300,-10122,-80778,"(STARFRUIT, US << MARKET, 5061, 1, 527300)
(STARFRUIT, US << MARKET, 5061, 1, 527300)","{""AMETHYSTS"": 6, ""STARFRUIT"": 5}",4521,5061,9999
527500,25310,-55468,"(STARFRUIT, MARKET << US, 5062, 1, 527500)
(STARFRUIT, MARKET << US, 5062, 1, 527500)
(STARFRUIT, MARKET << US, 5062, 1, 527500)
(STARFRUIT, MARKET << US, 5062, 1, 527500)
(STARFRUIT, MARKET << US, 5062, 1, 527500)","{""AMETHYSTS"": 6, ""STARFRUIT"": 0}",4532,5063,10000
527700,-9882,-65350,"(AMETHYSTS, US << MARKET, 10004, 1, 527700)
(AMETHYSTS, US << MARKET, 10004, 1, 527700)
(STARFRUIT, MARKET << US, 5063, 1, 527700)
(STARFRUIT, MARKET << US, 5063, 1, 527700)","{""AMETHYSTS"": 8, ""STARFRUIT"": -2}",4532,5059,10000
527900,9998,-55352,"(AMETHYSTS, MARKET << US, 9998, 1, 527900)","{""AMETHYSTS"": 7, ""STARFRUIT"": -2}",4502,5059,9996
528200,-30342,-85694,"(STARFRUIT, US << MARKET, 5057, 1, 528200)
(STARFRUIT, US << MARKET, 5057, 1, 528200)
(STARFRUIT, US << MARKET, 5057, 1, 528200)
(STARFRUIT, US << MARKET, 5057, 1, 528200)
(STARFRUIT, US << MARKET, 5057, 1, 528200)
(STARFRUIT, US << MARKET, 5057, 1, 528200)","{""AMETHYSTS"": 7, ""STARFRUIT"": 4}",4553,5060,10001
528500,-20224,-105918,"(STARFRUIT, US << MARKET, 5056, 1, 528500)
(STARFRUIT, US << MARKET, 5056, 1, 528500)
(STARFRUIT, US << MARKET, 5056, 1, 528500)
(STARFRUIT, US << MARKET, 5056, 1, 528500)","{""AMETHYSTS"": 7, ""STARFRUIT"": 8}",4537,5056,10001
528600,9998,-95920,"(AMETHYSTS, MARKET << US, 9998, 1, 528600)","{""AMETHYSTS"": 6, ""STARFRUIT"": 8}",4542,5060,9997
528700,-14951,-110871,"(AMETHYSTS, US << MARKET, 10004, 1, 528700)
(AMETHYSTS, US << MARKET, 10004, 1, 528700)
(STARFRUIT, MARKET << US, 5057, 1, 528700)","{""AMETHYSTS"": 8, ""STARFRUIT"": 7}",4573,5060,10003
529200,-25053,-135924,"(AMETHYSTS, US << MARKET, 9998, 1, 529200)
(AMETHYSTS, US << MARKET, 9998, 1, 529200)
(STARFRUIT, US << MARKET, 5057, 1, 529200)","{""AMETHYSTS"": 10, ""STARFRUIT"": 8}",4574,5061,10001
529300,0,-135924,"(STARFRUIT, US << MARKET, 5058, 1, 529300)
(STARFRUIT, MARKET << US, 5058, 1, 529300)","{""AMETHYSTS"": 10, ""STARFRUIT"": 8}",4532,5057,10000
529600,-4941,-140865,"(AMETHYSTS, US << MARKET, 10004, 1, 529600)
(STARFRUIT, MARKET << US, 5063, 1, 529600)","{""AMETHYSTS"": 11, ""STARFRUIT"": 7}",4555,5060,10000
529800,65282,-75583,"(AMETHYSTS, MARKET << US, 9998, 1, 529800)
(AMETHYSTS, MARKET << US, 9998, 1, 529800)
(AMETHYSTS, MARKET << US, 9998, 1, 529800)
(AMETHYSTS, MARKET << US, 9998, 1, 529800)
(STARFRUIT, MARKET << US, 5058, 1, 529800)
(STARFRUIT, MARKET << US, 5058, 1, 529800)
(STARFRUIT, MARKET << US, 5058, 1, 529800)
(STARFRUIT, MARKET << US, 5058, 1, 529800)
(STARFRUIT, MARKET << US, 5058, 1, 529800)","{""AMETHYSTS"": 7, ""STARFRUIT"": 2}",4510,5057,9997
530000,109956,34373,"(AMETHYSTS, MARKET << US, 9996, 1, 530000)
(AMETHYSTS, MARKET << US, 9996, 1, 530000)
(AMETHYSTS, MARKET << US, 9996, 1, 530000)
(AMETHYSTS, MARKET << US, 9996, 1, 530000)
(AMETHYSTS, MARKET << US, 9996, 1, 530000)
(AMETHYSTS, MARKET << US, 9996, 1, 530000)
(AMETHYSTS, MARKET << US, 9996, 1, 530000)
(AMETHYSTS, MARKET << US, 9996, 1, 530000)
(AMETHYSTS, MARKET << US, 9996, 1, 530000)
(AMETHYSTS, MARKET << US, 9996, 1, 530000)
(AMETHYSTS, MARKET << US, 9996, 1, 530000)","{""AMETHYSTS"": -4, ""STARFRUIT"": 2}",4491,5059,10000
530100,-20120,14253,"(AMETHYSTS, US << MARKET, 9998, 1, 530100)
(AMETHYSTS, US << MARKET, 9998, 1, 530100)
(AMETHYSTS, US << MARKET, 9998, 1, 530100)
(AMETHYSTS, US << MARKET, 9998, 1, 530100)
(AMETHYSTS, MARKET << US, 9998, 1, 530100)
(AMETHYSTS, MARKET << US, 9998, 1, 530100)
(AMETHYSTS, MARKET << US, 9998, 1, 530100)
(STARFRUIT, US << MARKET, 5061, 1, 530100)
(STARFRUIT, US << MARKET, 5061, 1, 530100)","{""AMETHYSTS"": -3, ""STARFRUIT"": 4}",4513,5062,9996
530400,-50010,-35757,"(AMETHYSTS, US << MARKET, 10002, 1, 530400)
(AMETHYSTS, US << MARKET, 10002, 1, 530400)
(AMETHYSTS, US << MARKET, 10002, 1, 530400)
(AMETHYSTS, US << MARKET, 10002, 1, 530400)
(AMETHYSTS, US << MARKET, 10002, 1, 530400)","{""AMETHYSTS"": 2, ""STARFRUIT"": 4}",4485,5059,10003
530500,-60012,-95769,"(AMETHYSTS, US << MARKET, 10002, 1, 530500)
(AMETHYSTS, US << MARKET, 10002, 1, 530500)
(AMETHYSTS, US << MARKET, 10002, 1, 530500)
(AMETHYSTS, US << MARKET, 10002, 1, 530500)
(AMETHYSTS, US << MARKET, 10002, 1, 530500)
(AMETHYSTS, US << MARKET, 10002, 1, 530500)","{""AMETHYSTS"": 8, ""STARFRUIT"": 4}",4495,5060,10003
530800,-9874,-105643,"(AMETHYSTS, US << MARKET, 9998, 1, 530800)
(AMETHYSTS, US << MARKET, 9998, 1, 530800)
(STARFRUIT, MARKET << US, 5061, 1, 530800)
(STARFRUIT, MARKET << US, 5061, 1, 530800)","{""AMETHYSTS"": 10, ""STARFRUIT"": 2}",4451,5062,9997
531800,-89955,-195598,"(AMETHYSTS, US << MARKET, 9995, 1, 531800)
(AMETHYSTS, US << MARKET, 9995, 1, 531800)
(AMETHYSTS, US << MARKET, 9995, 1, 531800)
(AMETHYSTS, US << MARKET, 9995, 1, 531800)
(AMETHYSTS, US << MARKET, 9995, 1, 531800)
(AMETHYSTS, US << MARKET, 9995, 1, 531800)
(AMETHYSTS, US << MARKET, 9995, 1, 531800)
(AMETHYSTS, US << MARKET, 9995, 1, 531800)
(AMETHYSTS, US << MARKET, 9995, 1, 531800)","{""AMETHYSTS"": 19, ""STARFRUIT"": 2}",4524,5061,10000
531900,-10116,-205714,"(STARFRUIT, US << MARKET, 5058, 1, 531900)
(STARFRUIT, US << MARKET, 5058, 1, 531900)","{""AMETHYSTS"": 19, ""STARFRUIT"": 4}",4473,5061,9997
532100,20264,-185450,"(STARFRUIT, MARKET << US, 5066, 1, 532100)
(STARFRUIT, MARKET << US, 5066, 1, 532100)
(STARFRUIT, MARKET << US, 5066, 1, 532100)
(STARFRUIT, MARKET << US, 5066, 1, 532100)","{""AMETHYSTS"": 19, ""STARFRUIT"": 0}",4512,5062,9998
532200,5065,-180385,"(STARFRUIT, MARKET << US, 5065, 1, 532200)","{""AMETHYSTS"": 19, ""STARFRUIT"": -1}",4553,5062,10000
532900,15180,-165205,"(STARFRUIT, MARKET << US, 5060, 1, 532900)
(STARFRUIT, MARKET << US, 5060, 1, 532900)
(STARFRUIT, MARKET << US, 5060, 1, 532900)","{""AMETHYSTS"": 19, ""STARFRUIT"": -4}",4524,5063,9999
533600,-35441,-200646,"(STARFRUIT, US << MARKET, 5063, 1, 533600)
(STARFRUIT, US << MARKET, 5063, 1, 533600)
(STARFRUIT, US << MARKET, 5063, 1, 533600)
(STARFRUIT, US << MARKET, 5063, 1, 533600)
(STARFRUIT, US << MARKET, 5063, 1, 533600)
(STARFRUIT, US << MARKET, 5063, 1, 533600)
(STARFRUIT, US << MARKET, 5063, 1, 533600)","{""AMETHYSTS"": 19, ""STARFRUIT"": 3}",4543,5063,10000
533900,-9996,-210642,"(AMETHYSTS, US << MARKET, 9996, 1, 533900)","{""AMETHYSTS"": 20, ""STARFRUIT"": 3}",4547,5063,10000
534100,0,-210642,,"{""AMETHYSTS"": 20, ""STARFRUIT"": 3}",4604,5062,10003
534300,30139,-180503,"(AMETHYSTS, MARKET << US, 10004, 1, 534300)
(AMETHYSTS, MARKET << US, 10004, 1, 534300)
(STARFRUIT, MARKET << US, 5066, 1, 534300)
(STARFRUIT, MARKET << US, 5065, 1, 534300)","{""AMETHYSTS"": 18, ""STARFRUIT"": 1}",4562,5065,10000
534400,125089,-55414,"(AMETHYSTS, MARKET << US, 10002, 1, 534400)
(AMETHYSTS, MARKET << US, 10002, 1, 534400)
(AMETHYSTS, MARKET << US, 10002, 1, 534400)
(AMETHYSTS, MARKET << US, 10002, 1, 534400)
(AMETHYSTS, MARKET << US, 10002, 1, 534400)
(AMETHYSTS, MARKET << US, 10002, 1, 534400)
(AMETHYSTS, MARKET << US, 10002, 1, 534400)
(AMETHYSTS, MARKET << US, 10002, 1, 534400)
(AMETHYSTS, MARKET << US, 10002, 1, 534400)
(AMETHYSTS, MARKET << US, 10002, 1, 534400)
(AMETHYSTS, MARKET << US, 10002, 1, 534400)
(AMETHYSTS, MARKET << US, 10002, 1, 534400)
(STARFRUIT, MARKET << US, 5065, 1, 534400)","{""AMETHYSTS"": 6, ""STARFRUIT"": 0}",4604,5065,10003
534500,25054,-30360,"(AMETHYSTS, MARKET << US, 9995, 1, 534500)
(AMETHYSTS, MARKET << US, 9995, 1, 534500)
(STARFRUIT, MARKET << US, 5064, 1, 534500)","{""AMETHYSTS"": 4, ""STARFRUIT"": -1}",4575,5065,10000
534700,10116,-20244,"(STARFRUIT, MARKET << US, 5058, 1, 534700)
(STARFRUIT, MARKET << US, 5058, 1, 534700)","{""AMETHYSTS"": 4, ""STARFRUIT"": -3}",4565,5061,9998
534900,-40266,-60510,"(AMETHYSTS, US << MARKET, 10005, 1, 534900)
(AMETHYSTS, US << MARKET, 10005, 1, 534900)
(STARFRUIT, US << MARKET, 5064, 1, 534900)
(STARFRUIT, US << MARKET, 5064, 1, 534900)
(STARFRUIT, US << MARKET, 5064, 1, 534900)
(STARFRUIT, US << MARKET, 5064, 1, 534900)","{""AMETHYSTS"": 6, ""STARFRUIT"": 1}",4550,5060,10000
535500,-19996,-80506,"(AMETHYSTS, US << MARKET, 9998, 1, 535500)
(AMETHYSTS, US << MARKET, 9998, 1, 535500)","{""AMETHYSTS"": 8, ""STARFRUIT"": 1}",4528,5058,9997
535600,-25192,-105698,"(AMETHYSTS, US << MARKET, 10005, 1, 535600)
(STARFRUIT, US << MARKET, 5062, 1, 535600)
(STARFRUIT, US << MARKET, 5062, 1, 535600)
(STARFRUIT, US << MARKET, 5063, 1, 535600)","{""AMETHYSTS"": 9, ""STARFRUIT"": 4}",4559,5062,10001
535900,-20228,-125926,"(STARFRUIT, US << MARKET, 5057, 1, 535900)
(STARFRUIT, US << MARKET, 5057, 1, 535900)
(STARFRUIT, US << MARKET, 5057, 1, 535900)
(STARFRUIT, US << MARKET, 5057, 1, 535900)","{""AMETHYSTS"": 9, ""STARFRUIT"": 8}",4522,5056,10000
536000,29892,-96034,"(AMETHYSTS, MARKET << US, 10004, 1, 536000)
(AMETHYSTS, MARKET << US, 10004, 1, 536000)
(AMETHYSTS, MARKET << US, 10004, 1, 536000)
(AMETHYSTS, MARKET << US, 10004, 1, 536000)
(STARFRUIT, US << MARKET, 5062, 1, 536000)
(STARFRUIT, US << MARKET, 5062, 1, 536000)","{""AMETHYSTS"": 5, ""STARFRUIT"": 10}",4546,5058,10000
536100,-5055,-101089,"(STARFRUIT, US << MARKET, 5055, 1, 536100)","{""AMETHYSTS"": 5, ""STARFRUIT"": 11}",4560,5059,10000
536500,-20240,-121329,"(STARFRUIT, US << MARKET, 5060, 1, 536500)
(STARFRUIT, US << MARKET, 5060, 1, 536500)
(STARFRUIT, US << MARKET, 5060, 1, 536500)
(STARFRUIT, US << MARKET, 5060, 1, 536500)","{""AMETHYSTS"": 5, ""STARFRUIT"": 15}",4586,5061,10000
536600,10002,-111327,"(AMETHYSTS, US << MARKET, 10002, 1, 536600)
(AMETHYSTS, US << MARKET, 10002, 1, 536600)
(AMETHYSTS, US << MARKET, 10002, 1, 536600)
(AMETHYSTS, MARKET << US, 10002, 1, 536600)
(AMETHYSTS, MARKET << US, 10002, 1, 536600)
(AMETHYSTS, MARKET << US, 10002, 1, 536600)
(AMETHYSTS, MARKET << US, 10002, 1, 536600)","{""AMETHYSTS"": 4, ""STARFRUIT"": 15}",4570,5059,10003
536900,9996,-101331,"(AMETHYSTS, US << MARKET, 9996, 1, 536900)
(AMETHYSTS, US << MARKET, 9996, 1, 536900)
(AMETHYSTS, US << MARKET, 9996, 1, 536900)
(AMETHYSTS, US << MARKET, 9996, 1, 536900)
(AMETHYSTS, MARKET << US, 9996, 1, 536900)
(AMETHYSTS, MARKET << US, 9996, 1, 536900)
(AMETHYSTS, MARKET << US, 9996, 1, 536900)
(AMETHYSTS, MARKET << US, 9996, 1, 536900)
(AMETHYSTS, MARKET << US, 9996, 1, 536900)","{""AMETHYSTS"": 3, ""STARFRUIT"": 15}",4539,5058,10000
537100,-10002,-111333,"(AMETHYSTS, US << MARKET, 10002, 1, 537100)","{""AMETHYSTS"": 4, ""STARFRUIT"": 15}",4519,5056,10003
537200,5054,-106279,"(STARFRUIT, MARKET << US, 5054, 1, 537200)","{""AMETHYSTS"": 4, ""STARFRUIT"": 14}",4475,5055,9996
537600,94966,-11313,"(AMETHYSTS, MARKET << US, 10002, 1, 537600)
(AMETHYSTS, MARKET << US, 10002, 1, 537600)
(AMETHYSTS, MARKET << US, 10002, 1, 537600)
(AMETHYSTS, MARKET << US, 10002, 1, 537600)
(AMETHYSTS, MARKET << US, 10002, 1, 537600)
(AMETHYSTS, MARKET << US, 10002, 1, 537600)
(AMETHYSTS, MARKET << US, 10002, 1, 537600)
(AMETHYSTS, MARKET << US, 10002, 1, 537600)
(AMETHYSTS, MARKET << US, 10002, 1, 537600)
(AMETHYSTS, MARKET << US, 10002, 1, 537600)
(STARFRUIT, US << MARKET, 5054, 1, 537600)","{""AMETHYSTS"": -6, ""STARFRUIT"": 15}",4548,5057,9999
538000,14947,3634,"(AMETHYSTS, MARKET << US, 10004, 1, 538000)
(AMETHYSTS, MARKET << US, 10004, 1, 538000)
(STARFRUIT, US << MARKET, 5061, 1, 538000)","{""AMETHYSTS"": -8, ""STARFRUIT"": 16}",4562,5059,10002
538100,35434,39068,"(STARFRUIT, MARKET << US, 5062, 1, 538100)
(STARFRUIT, MARKET << US, 5062, 1, 538100)
(STARFRUIT, MARKET << US, 5062, 1, 538100)
(STARFRUIT, MARKET << US, 5062, 1, 538100)
(STARFRUIT, MARKET << US, 5062, 1, 538100)
(STARFRUIT, MARKET << US, 5062, 1, 538100)
(STARFRUIT, MARKET << US, 5062, 1, 538100)","{""AMETHYSTS"": -8, ""STARFRUIT"": 9}",4607,5059,9999
538800,-99980,-60912,"(AMETHYSTS, US << MARKET, 9998, 1, 538800)
(AMETHYSTS, US << MARKET, 9998, 1, 538800)
(AMETHYSTS, US << MARKET, 9998, 1, 538800)
(AMETHYSTS, US << MARKET, 9998, 1, 538800)
(AMETHYSTS, US << MARKET, 9998, 1, 538800)
(AMETHYSTS, US << MARKET, 9998, 1, 538800)
(AMETHYSTS, US << MARKET, 9998, 1, 538800)
(AMETHYSTS, US << MARKET, 9998, 1, 538800)
(AMETHYSTS, US << MARKET, 9998, 1, 538800)
(AMETHYSTS, US << MARKET, 9998, 1, 538800)","{""AMETHYSTS"": 2, ""STARFRUIT"": 9}",4613,5059,9997
539200,-10118,-71030,"(STARFRUIT, US << MARKET, 5059, 1, 539200)
(STARFRUIT, US << MARKET, 5059, 1, 539200)","{""AMETHYSTS"": 2, ""STARFRUIT"": 11}",4608,5058,10000
539400,-14933,-85963,"(AMETHYSTS, US << MARKET, 9998, 1, 539400)
(AMETHYSTS, US << MARKET, 9998, 1, 539400)
(STARFRUIT, MARKET << US, 5063, 1, 539400)","{""AMETHYSTS"": 4, ""STARFRUIT"": 10}",4655,5063,9997
540000,-5064,-91027,"(STARFRUIT, US << MARKET, 5064, 1, 540000)","{""AMETHYSTS"": 4, ""STARFRUIT"": 11}",4681,5064,10001
540200,35406,-55621,"(STARFRUIT, MARKET << US, 5058, 1, 540200)
(STARFRUIT, MARKET << US, 5058, 1, 540200)
(STARFRUIT, MARKET << US, 5058, 1, 540200)
(STARFRUIT, MARKET << US, 5058, 1, 540200)
(STARFRUIT, MARKET << US, 5058, 1, 540200)
(STARFRUIT, MARKET << US, 5058, 1, 540200)
(STARFRUIT, MARKET << US, 5058, 1, 540200)","{""AMETHYSTS"": 4, ""STARFRUIT"": 4}",4607,5061,9996
540400,9998,-45623,"(AMETHYSTS, MARKET << US, 9998, 1, 540400)","{""AMETHYSTS"": 3, ""STARFRUIT"": 4}",4609,5061,9996
540600,-79984,-125607,"(AMETHYSTS, US << MARKET, 9998, 1, 540600)
(AMETHYSTS, US << MARKET, 9998, 1, 540600)
(AMETHYSTS, US << MARKET, 9998, 1, 540600)
(AMETHYSTS, US << MARKET, 9998, 1, 540600)
(AMETHYSTS, US << MARKET, 9998, 1, 540600)
(AMETHYSTS, US << MARKET, 9998, 1, 540600)
(AMETHYSTS, US << MARKET, 9998, 1, 540600)
(AMETHYSTS, US << MARKET, 9998, 1, 540600)","{""AMETHYSTS"": 11, ""STARFRUIT"": 4}",4604,5061,9997
540700,-80040,-205647,"(AMETHYSTS, US << MARKET, 10005, 1, 540700)
(AMETHYSTS, US << MARKET, 10005, 1, 540700)
(AMETHYSTS, US << MARKET, 10005, 1, 540700)
(AMETHYSTS, US << MARKET, 10005, 1, 540700)
(AMETHYSTS, US << MARKET, 10005, 1, 540700)
(AMETHYSTS, US << MARKET, 10005, 1, 540700)
(AMETHYSTS, US << MARKET, 10005, 1, 540700)
(AMETHYSTS, US << MARKET, 10005, 1, 540700)","{""AMETHYSTS"": 19, ""STARFRUIT"": 4}",4593,5060,10000
541200,20004,-185643,"(AMETHYSTS, MARKET << US, 10002, 1, 541200)
(AMETHYSTS, MARKET << US, 10002, 1, 541200)","{""AMETHYSTS"": 17, ""STARFRUIT"": 4}",4652,5061,10003
541300,15061,-170582,"(AMETHYSTS, MARKET << US, 9998, 1, 541300)
(STARFRUIT, MARKET << US, 5063, 1, 541300)","{""AMETHYSTS"": 16, ""STARFRUIT"": 3}",4601,5061,10000
541500,49980,-120602,"(AMETHYSTS, MARKET << US, 9996, 1, 541500)
(AMETHYSTS, MARKET << US, 9996, 1, 541500)
(AMETHYSTS, MARKET << US, 9996, 1, 541500)
(AMETHYSTS, MARKET << US, 9996, 1, 541500)
(AMETHYSTS, MARKET << US, 9996, 1, 541500)","{""AMETHYSTS"": 11, ""STARFRUIT"": 3}",4584,5062,10000
541700,-25310,-145912,"(STARFRUIT, US << MARKET, 5062, 1, 541700)
(STARFRUIT, US << MARKET, 5062, 1, 541700)
(STARFRUIT, US << MARKET, 5062, 1, 541700)
(STARFRUIT, US << MARKET, 5062, 1, 541700)
(STARFRUIT, US << MARKET, 5062, 1, 541700)","{""AMETHYSTS"": 11, ""STARFRUIT"": 8}",4622,5064,10002
541800,-5059,-150971,"(STARFRUIT, US << MARKET, 5059, 1, 541800)","{""AMETHYSTS"": 11, ""STARFRUIT"": 9}",4578,5061,10000
542200,5059,-145912,"(STARFRUIT, MARKET << US, 5059, 1, 542200)","{""AMETHYSTS"": 11, ""STARFRUIT"": 8}",4576,5061,10000
542400,-19996,-165908,"(AMETHYSTS, US << MARKET, 9998, 1, 542400)
(AMETHYSTS, US << MARKET, 9998, 1, 542400)","{""AMETHYSTS"": 13, ""STARFRUIT"": 8}",4585,5060,10001
542600,9998,-155910,"(AMETHYSTS, MARKET << US, 9998, 1, 542600)","{""AMETHYSTS"": 12, ""STARFRUIT"": 8}",4542,5061,9997
542700,-69965,-225875,"(AMETHYSTS, US << MARKET, 9995, 1, 542700)
(AMETHYSTS, US << MARKET, 9995, 1, 542700)
(AMETHYSTS, US << MARKET, 9995, 1, 542700)
(AMETHYSTS, US << MARKET, 9995, 1, 542700)
(AMETHYSTS, US << MARKET, 9995, 1, 542700)
(AMETHYSTS, US << MARKET, 9995, 1, 542700)
(AMETHYSTS, US << MARKET, 9995, 1, 542700)","{""AMETHYSTS"": 19, ""STARFRUIT"": 8}",4605,5060,10000
542800,14943,-210932,"(AMETHYSTS, MARKET << US, 10004, 1, 542800)
(AMETHYSTS, MARKET << US, 10004, 1, 542800)
(STARFRUIT, US << MARKET, 5065, 1, 542800)","{""AMETHYSTS"": 17, ""STARFRUIT"": 9}",4617,5061,10000
543300,10364,-200568,"(AMETHYSTS, US << MARKET, 9998, 1, 543300)
(AMETHYSTS, US << MARKET, 9998, 1, 543300)
(STARFRUIT, MARKET << US, 5060, 1, 543300)
(STARFRUIT, MARKET << US, 5060, 1, 543300)
(STARFRUIT, MARKET << US, 5060, 1, 543300)
(STARFRUIT, MARKET << US, 5060, 1, 543300)
(STARFRUIT, MARKET << US, 5060, 1, 543300)
(STARFRUIT, MARKET << US, 5060, 1, 543300)","{""AMETHYSTS"": 19, ""STARFRUIT"": 3}",4533,5059,9996
543700,-25300,-225868,"(STARFRUIT, US << MARKET, 5060, 1, 543700)
(STARFRUIT, US << MARKET, 5060, 1, 543700)
(STARFRUIT, US << MARKET, 5060, 1, 543700)
(STARFRUIT, US << MARKET, 5060, 1, 543700)
(STARFRUIT, US << MARKET, 5060, 1, 543700)","{""AMETHYSTS"": 19, ""STARFRUIT"": 8}",4604,5059,10000
543800,-20236,-246104,"(STARFRUIT, US << MARKET, 5059, 1, 543800)
(STARFRUIT, US << MARKET, 5059, 1, 543800)
(STARFRUIT, US << MARKET, 5059, 1, 543800)
(STARFRUIT, US << MARKET, 5059, 1, 543800)","{""AMETHYSTS"": 19, ""STARFRUIT"": 12}",4659,5062,10001
543900,-5064,-251168,"(STARFRUIT, US << MARKET, 5064, 1, 543900)","{""AMETHYSTS"": 19, ""STARFRUIT"": 13}",4625,5061,10000
544000,14940,-236228,"(AMETHYSTS, MARKET << US, 10002, 1, 544000)
(AMETHYSTS, MARKET << US, 10002, 1, 544000)
(STARFRUIT, US << MARKET, 5064, 1, 544000)","{""AMETHYSTS"": 17, ""STARFRUIT"": 14}",4719,5064,10003
544200,25068,-211160,"(AMETHYSTS, MARKET << US, 10002, 1, 544200)
(AMETHYSTS, MARKET << US, 10002, 1, 544200)
(STARFRUIT, MARKET << US, 5064, 1, 544200)","{""AMETHYSTS"": 15, ""STARFRUIT"": 13}",4618,5061,9999
544500,9998,-201162,"(AMETHYSTS, MARKET << US, 9998, 1, 544500)","{""AMETHYSTS"": 14, ""STARFRUIT"": 13}",4575,5061,9996
544800,35455,-165707,"(STARFRUIT, MARKET << US, 5065, 1, 544800)
(STARFRUIT, MARKET << US, 5065, 1, 544800)
(STARFRUIT, MARKET << US, 5065, 1, 544800)
(STARFRUIT, MARKET << US, 5065, 1, 544800)
(STARFRUIT, MARKET << US, 5065, 1, 544800)
(STARFRUIT, MARKET << US, 5065, 1, 544800)
(STARFRUIT, MARKET << US, 5065, 1, 544800)","{""AMETHYSTS"": 14, ""STARFRUIT"": 6}",4659,5061,10000
545000,5063,-160644,"(STARFRUIT, MARKET << US, 5063, 1, 545000)","{""AMETHYSTS"": 14, ""STARFRUIT"": 5}",4637,5059,9999
545200,25320,-135324,"(STARFRUIT, MARKET << US, 5064, 1, 545200)
(STARFRUIT, MARKET << US, 5064, 1, 545200)
(STARFRUIT, MARKET << US, 5064, 1, 545200)
(STARFRUIT, MARKET << US, 5064, 1, 545200)
(STARFRUIT, MARKET << US, 5064, 1, 545200)","{""AMETHYSTS"": 14, ""STARFRUIT"": 0}",4676,5060,10000
545500,19996,-115328,"(AMETHYSTS, MARKET << US, 9998, 1, 545500)
(AMETHYSTS, MARKET << US, 9998, 1, 545500)","{""AMETHYSTS"": 12, ""STARFRUIT"": 0}",4636,5062,9997
545600,-10130,-125458,"(STARFRUIT, US << MARKET, 5065, 1, 545600)
(STARFRUIT, US << MARKET, 5065, 1, 545600)","{""AMETHYSTS"": 12, ""STARFRUIT"": 2}",4664,5061,10000
545800,5060,-120398,"(STARFRUIT, MARKET << US, 5060, 1, 545800)","{""AMETHYSTS"": 12, ""STARFRUIT"": 1}",4690,5064,10002
545900,-10004,-130402,"(AMETHYSTS, US << MARKET, 10004, 1, 545900)","{""AMETHYSTS"": 13, ""STARFRUIT"": 1}",4674,5063,10001
546000,60012,-70390,"(AMETHYSTS, MARKET << US, 10002, 1, 546000)
(AMETHYSTS, MARKET << US, 10002, 1, 546000)
(AMETHYSTS, MARKET << US, 10002, 1, 546000)
(AMETHYSTS, MARKET << US, 10002, 1, 546000)
(AMETHYSTS, MARKET << US, 10002, 1, 546000)
(AMETHYSTS, MARKET << US, 10002, 1, 546000)","{""AMETHYSTS"": 7, ""STARFRUIT"": 1}",4693,5062,10003
546100,-40268,-110658,"(AMETHYSTS, US << MARKET, 10002, 1, 546100)
(AMETHYSTS, US << MARKET, 10002, 1, 546100)
(STARFRUIT, US << MARKET, 5066, 1, 546100)
(STARFRUIT, US << MARKET, 5066, 1, 546100)
(STARFRUIT, US << MARKET, 5066, 1, 546100)
(STARFRUIT, US << MARKET, 5066, 1, 546100)","{""AMETHYSTS"": 9, ""STARFRUIT"": 5}",4634,5062,9998
546500,65030,-45628,"(AMETHYSTS, MARKET << US, 9995, 1, 546500)
(AMETHYSTS, MARKET << US, 9995, 1, 546500)
(AMETHYSTS, MARKET << US, 9995, 1, 546500)
(AMETHYSTS, MARKET << US, 9995, 1, 546500)
(AMETHYSTS, MARKET << US, 9995, 1, 546500)
(AMETHYSTS, MARKET << US, 9995, 1, 546500)
(STARFRUIT, MARKET << US, 5060, 1, 546500)","{""AMETHYSTS"": 3, ""STARFRUIT"": 4}",4624,5063,10000
546900,50140,4512,"(AMETHYSTS, MARKET << US, 10002, 1, 546900)
(AMETHYSTS, MARKET << US, 10002, 1, 546900)
(AMETHYSTS, MARKET << US, 10002, 1, 546900)
(AMETHYSTS, MARKET << US, 10002, 1, 546900)
(STARFRUIT, MARKET << US, 5066, 1, 546900)
(STARFRUIT, MARKET << US, 5066, 1, 546900)","{""AMETHYSTS"": -1, ""STARFRUIT"": 2}",4639,5063,9999
547000,-14931,-10419,"(AMETHYSTS, US << MARKET, 9998, 1, 547000)
(AMETHYSTS, US << MARKET, 9998, 1, 547000)
(STARFRUIT, MARKET << US, 5065, 1, 547000)","{""AMETHYSTS"": 1, ""STARFRUIT"": 1}",4643,5065,9997
547300,10120,-299,"(STARFRUIT, MARKET << US, 5060, 1, 547300)
(STARFRUIT, MARKET << US, 5060, 1, 547300)","{""AMETHYSTS"": 1, ""STARFRUIT"": -1}",4642,5059,10000
547600,-134,-433,"(AMETHYSTS, MARKET << US, 9998, 1, 547600)
(STARFRUIT, US << MARKET, 5066, 1, 547600)
(STARFRUIT, US << MARKET, 5066, 1, 547600)","{""AMETHYSTS"": 0, ""STARFRUIT"": 1}",4632,5065,9997
548300,-5061,-5494,"(STARFRUIT, US << MARKET, 5061, 1, 548300)
(STARFRUIT, US << MARKET, 5061, 1, 548300)
(STARFRUIT, US << MARKET, 5061, 1, 548300)
(STARFRUIT, US << MARKET, 5061, 1, 548300)
(STARFRUIT, MARKET << US, 5061, 1, 548300)
(STARFRUIT, MARKET << US, 5061, 1, 548300)
(STARFRUIT, MARKET << US, 5061, 1, 548300)","{""AMETHYSTS"": 0, ""STARFRUIT"": 2}",4634,5064,9999
548500,-16,-5510,"(AMETHYSTS, US << MARKET, 10002, 1, 548500)
(AMETHYSTS, US << MARKET, 10002, 1, 548500)
(AMETHYSTS, US << MARKET, 10002, 1, 548500)
(AMETHYSTS, US << MARKET, 10002, 1, 548500)
(AMETHYSTS, MARKET << US, 9998, 1, 548500)
(AMETHYSTS, MARKET << US, 9998, 1, 548500)
(AMETHYSTS, MARKET << US, 9998, 1, 548500)
(AMETHYSTS, MARKET << US, 9998, 1, 548500)","{""AMETHYSTS"": 0, ""STARFRUIT"": 2}",4616,5063,10003
549100,20004,14494,"(AMETHYSTS, MARKET << US, 10002, 1, 549100)
(AMETHYSTS, MARKET << US, 10002, 1, 549100)","{""AMETHYSTS"": -2, ""STARFRUIT"": 2}",4612,5062,10003
549700,10270,24764,"(AMETHYSTS, US << MARKET, 10002, 1, 549700)
(STARFRUIT, MARKET << US, 5068, 1, 549700)
(STARFRUIT, MARKET << US, 5068, 1, 549700)
(STARFRUIT, MARKET << US, 5068, 1, 549700)
(STARFRUIT, MARKET << US, 5068, 1, 549700)","{""AMETHYSTS"": -1, ""STARFRUIT"": -2}",4637,5064,9999
549800,-402,24362,"(AMETHYSTS, MARKET << US, 9998, 1, 549800)
(AMETHYSTS, MARKET << US, 9998, 1, 549800)
(AMETHYSTS, MARKET << US, 9998, 1, 549800)
(STARFRUIT, US << MARKET, 5066, 1, 549800)
(STARFRUIT, US << MARKET, 5066, 1, 549800)
(STARFRUIT, US << MARKET, 5066, 1, 549800)
(STARFRUIT, US << MARKET, 5066, 1, 549800)
(STARFRUIT, US << MARKET, 5066, 1, 549800)
(STARFRUIT, US << MARKET, 5066, 1, 549800)","{""AMETHYSTS"": -4, ""STARFRUIT"": 4}",4646,5067,9996
549900,-10134,14228,"(STARFRUIT, US << MARKET, 5067, 1, 549900)
(STARFRUIT, US << MARKET, 5067, 1, 549900)","{""AMETHYSTS"": -4, ""STARFRUIT"": 6}",4612,5064,10000
550100,99960,114188,"(AMETHYSTS, MARKET << US, 9996, 1, 550100)
(AMETHYSTS, MARKET << US, 9996, 1, 550100)
(AMETHYSTS, MARKET << US, 9996, 1, 550100)
(AMETHYSTS, MARKET << US, 9996, 1, 550100)
(AMETHYSTS, MARKET << US, 9996, 1, 550100)
(AMETHYSTS, MARKET << US, 9996, 1, 550100)
(AMETHYSTS, MARKET << US, 9996, 1, 550100)
(AMETHYSTS, MARKET << US, 9996, 1, 550100)
(AMETHYSTS, MARKET << US, 9996, 1, 550100)
(AMETHYSTS, MARKET << US, 9996, 1, 550100)","{""AMETHYSTS"": -14, ""STARFRUIT"": 6}",4578,5065,10000
550200,25315,139503,"(STARFRUIT, MARKET << US, 5063, 1, 550200)
(STARFRUIT, MARKET << US, 5063, 1, 550200)
(STARFRUIT, MARKET << US, 5063, 1, 550200)
(STARFRUIT, MARKET << US, 5063, 1, 550200)
(STARFRUIT, MARKET << US, 5063, 1, 550200)","{""AMETHYSTS"": -14, ""STARFRUIT"": 1}",4565,5062,10000
550300,9998,149501,"(AMETHYSTS, MARKET << US, 9998, 1, 550300)","{""AMETHYSTS"": -15, ""STARFRUIT"": 1}",4628,5067,9996
550700,15195,164696,"(STARFRUIT, MARKET << US, 5065, 1, 550700)
(STARFRUIT, MARKET << US, 5065, 1, 550700)
(STARFRUIT, MARKET << US, 5065, 1, 550700)","{""AMETHYSTS"": -15, ""STARFRUIT"": -2}",4568,5064,10000
551300,10132,174828,"(STARFRUIT, MARKET << US, 5066, 1, 551300)
(STARFRUIT, MARKET << US, 5066, 1, 551300)","{""AMETHYSTS"": -15, ""STARFRUIT"": -4}",4602,5064,9998
551800,-120060,54768,"(AMETHYSTS, US << MARKET, 10005, 1, 551800)
(AMETHYSTS, US << MARKET, 10005, 1, 551800)
(AMETHYSTS, US << MARKET, 10005, 1, 551800)
(AMETHYSTS, US << MARKET, 10005, 1, 551800)
(AMETHYSTS, US << MARKET, 10005, 1, 551800)
(AMETHYSTS, US << MARKET, 10005, 1, 551800)
(AMETHYSTS, US << MARKET, 10005, 1, 551800)
(AMETHYSTS, US << MARKET, 10005, 1, 551800)
(AMETHYSTS, US << MARKET, 10005, 1, 551800)
(AMETHYSTS, US << MARKET, 10005, 1, 551800)
(AMETHYSTS, US << MARKET, 10005, 1, 551800)
(AMETHYSTS, US << MARKET, 10005, 1, 551800)","{""AMETHYSTS"": -3, ""STARFRUIT"": -4}",4504,5066,10000
552300,10128,64896,"(STARFRUIT, MARKET << US, 5064, 1, 552300)
(STARFRUIT, MARKET << US, 5064, 1, 552300)","{""AMETHYSTS"": -3, ""STARFRUIT"": -6}",4515,5063,10001
552400,-34920,29976,"(AMETHYSTS, US << MARKET, 9996, 1, 552400)
(AMETHYSTS, US << MARKET, 9996, 1, 552400)
(AMETHYSTS, US << MARKET, 9996, 1, 552400)
(AMETHYSTS, US << MARKET, 9996, 1, 552400)
(STARFRUIT, MARKET << US, 5064, 1, 552400)","{""AMETHYSTS"": 1, ""STARFRUIT"": -7}",4507,5067,10000
552600,-10128,19848,"(STARFRUIT, US << MARKET, 5064, 1, 552600)
(STARFRUIT, US << MARKET, 5064, 1, 552600)","{""AMETHYSTS"": 1, ""STARFRUIT"": -5}",4518,5066,10000
552800,15067,34915,"(AMETHYSTS, MARKET << US, 9998, 1, 552800)
(STARFRUIT, MARKET << US, 5069, 1, 552800)","{""AMETHYSTS"": 0, ""STARFRUIT"": -6}",4501,5069,9996
553500,5065,39980,"(STARFRUIT, MARKET << US, 5065, 1, 553500)","{""AMETHYSTS"": 0, ""STARFRUIT"": -7}",4504,5068,9999
554100,-10130,29850,"(STARFRUIT, US << MARKET, 5065, 1, 554100)
(STARFRUIT, US << MARKET, 5065, 1, 554100)","{""AMETHYSTS"": 0, ""STARFRUIT"": -5}",4515,5067,10001
554600,-19996,9854,"(AMETHYSTS, US << MARKET, 9998, 1, 554600)
(AMETHYSTS, US << MARKET, 9998, 1, 554600)","{""AMETHYSTS"": 2, ""STARFRUIT"": -5}",4508,5068,9997
554700,5065,14919,"(STARFRUIT, MARKET << US, 5065, 1, 554700)","{""AMETHYSTS"": 2, ""STARFRUIT"": -6}",4513,5068,10001
554800,-19996,-5077,"(AMETHYSTS, US << MARKET, 9998, 1, 554800)
(AMETHYSTS, US << MARKET, 9998, 1, 554800)","{""AMETHYSTS"": 4, ""STARFRUIT"": -6}",4503,5068,9997
555000,-40008,-45085,"(AMETHYSTS, US << MARKET, 10002, 1, 555000)
(AMETHYSTS, US << MARKET, 10002, 1, 555000)
(AMETHYSTS, US << MARKET, 10002, 1, 555000)
(AMETHYSTS, US << MARKET, 10002, 1, 555000)","{""AMETHYSTS"": 8, ""STARFRUIT"": -6}",4531,5068,10003
555200,-10002,-55087,"(AMETHYSTS, US << MARKET, 10002, 1, 555200)","{""AMETHYSTS"": 9, ""STARFRUIT"": -6}",4538,5067,10003
555300,-10002,-65089,"(AMETHYSTS, US << MARKET, 10002, 1, 555300)","{""AMETHYSTS"": 10, ""STARFRUIT"": -6}",4533,5068,10003
555400,9998,-55091,"(AMETHYSTS, MARKET << US, 9998, 1, 555400)","{""AMETHYSTS"": 9, ""STARFRUIT"": -6}",4471,5067,9996
555600,20004,-35087,"(AMETHYSTS, MARKET << US, 10002, 1, 555600)
(AMETHYSTS, MARKET << US, 10002, 1, 555600)","{""AMETHYSTS"": 7, ""STARFRUIT"": -6}",4526,5068,10003
555900,20004,-15083,"(AMETHYSTS, MARKET << US, 10002, 1, 555900)
(AMETHYSTS, MARKET << US, 10002, 1, 555900)","{""AMETHYSTS"": 5, ""STARFRUIT"": -6}",4524,5068,10003
556100,-34919,-50002,"(AMETHYSTS, US << MARKET, 9996, 1, 556100)
(AMETHYSTS, US << MARKET, 9996, 1, 556100)
(AMETHYSTS, US << MARKET, 9996, 1, 556100)
(AMETHYSTS, US << MARKET, 9996, 1, 556100)
(STARFRUIT, MARKET << US, 5065, 1, 556100)","{""AMETHYSTS"": 9, ""STARFRUIT"": -7}",4513,5068,9999
556400,-30410,-80412,"(STARFRUIT, US << MARKET, 5065, 1, 556400)
(STARFRUIT, US << MARKET, 5065, 1, 556400)
(STARFRUIT, US << MARKET, 5070, 1, 556400)
(STARFRUIT, US << MARKET, 5070, 1, 556400)
(STARFRUIT, US << MARKET, 5070, 1, 556400)
(STARFRUIT, US << MARKET, 5070, 1, 556400)","{""AMETHYSTS"": 9, ""STARFRUIT"": -1}",4520,5068,10000
557100,15192,-65220,"(STARFRUIT, MARKET << US, 5064, 1, 557100)
(STARFRUIT, MARKET << US, 5064, 1, 557100)
(STARFRUIT, MARKET << US, 5064, 1, 557100)","{""AMETHYSTS"": 9, ""STARFRUIT"": -4}",4521,5067,10001
557300,-35455,-100675,"(STARFRUIT, US << MARKET, 5065, 1, 557300)
(STARFRUIT, US << MARKET, 5065, 1, 557300)
(STARFRUIT, US << MARKET, 5065, 1, 557300)
(STARFRUIT, US << MARKET, 5065, 1, 557300)
(STARFRUIT, US << MARKET, 5065, 1, 557300)
(STARFRUIT, US << MARKET, 5065, 1, 557300)
(STARFRUIT, US << MARKET, 5065, 1, 557300)","{""AMETHYSTS"": 9, ""STARFRUIT"": 3}",4556,5068,10003
557600,15059,-85616,"(AMETHYSTS, MARKET << US, 9996, 1, 557600)
(STARFRUIT, MARKET << US, 5063, 1, 557600)","{""AMETHYSTS"": 8, ""STARFRUIT"": 2}",4516,5066,10000
557700,-10126,-95742,"(STARFRUIT, US << MARKET, 5063, 1, 557700)
(STARFRUIT, US << MARKET, 5063, 1, 557700)","{""AMETHYSTS"": 8, ""STARFRUIT"": 4}",4522,5066,10000
557900,19996,-75746,"(AMETHYSTS, MARKET << US, 9998, 1, 557900)
(AMETHYSTS, MARKET << US, 9998, 1, 557900)","{""AMETHYSTS"": 6, ""STARFRUIT"": 4}",4500,5066,9997
558000,-10138,-85884,"(STARFRUIT, US << MARKET, 5069, 1, 558000)
(STARFRUIT, US << MARKET, 5069, 1, 558000)","{""AMETHYSTS"": 6, ""STARFRUIT"": 6}",4536,5069,10001
558900,-69986,-155870,"(AMETHYSTS, US << MARKET, 9998, 1, 558900)
(AMETHYSTS, US << MARKET, 9998, 1, 558900)
(AMETHYSTS, US << MARKET, 9998, 1, 558900)
(AMETHYSTS, US << MARKET, 9998, 1, 558900)
(AMETHYSTS, US << MARKET, 9998, 1, 558900)
(AMETHYSTS, US << MARKET, 9998, 1, 558900)
(AMETHYSTS, US << MARKET, 9998, 1, 558900)
(AMETHYSTS, US << MARKET, 9998, 1, 558900)
(AMETHYSTS, MARKET << US, 9998, 1, 558900)","{""AMETHYSTS"": 13, ""STARFRUIT"": 6}",4480,5067,9996
559100,-14929,-170799,"(AMETHYSTS, US << MARKET, 9996, 1, 559100)
(AMETHYSTS, US << MARKET, 9996, 1, 559100)
(STARFRUIT, MARKET << US, 5063, 1, 559100)","{""AMETHYSTS"": 15, ""STARFRUIT"": 5}",4526,5065,10000
559200,-10002,-180801,"(AMETHYSTS, US << MARKET, 10002, 1, 559200)","{""AMETHYSTS"": 16, ""STARFRUIT"": 5}",4513,5066,9999
559400,-10002,-190803,"(AMETHYSTS, US << MARKET, 10002, 1, 559400)","{""AMETHYSTS"": 17, ""STARFRUIT"": 5}",4583,5067,10003
559600,-19996,-210799,"(AMETHYSTS, US << MARKET, 9998, 1, 559600)
(AMETHYSTS, US << MARKET, 9998, 1, 559600)","{""AMETHYSTS"": 19, ""STARFRUIT"": 5}",4555,5067,10001
560200,-10130,-220929,"(STARFRUIT, US << MARKET, 5065, 1, 560200)
(STARFRUIT, US << MARKET, 5065, 1, 560200)","{""AMETHYSTS"": 19, ""STARFRUIT"": 7}",4604,5068,10003
560500,20004,-200925,"(AMETHYSTS, MARKET << US, 10002, 1, 560500)
(AMETHYSTS, MARKET << US, 10002, 1, 560500)","{""AMETHYSTS"": 17, ""STARFRUIT"": 7}",4602,5068,10003
560700,-15219,-216144,"(STARFRUIT, US << MARKET, 5071, 1, 560700)
(STARFRUIT, US << MARKET, 5071, 1, 560700)
(STARFRUIT, US << MARKET, 5071, 1, 560700)
(STARFRUIT, US << MARKET, 5071, 1, 560700)
(STARFRUIT, MARKET << US, 5065, 1, 560700)","{""AMETHYSTS"": 17, ""STARFRUIT"": 10}",4553,5068,10001
560800,15063,-201081,"(AMETHYSTS, MARKET << US, 9998, 1, 560800)
(STARFRUIT, MARKET << US, 5065, 1, 560800)","{""AMETHYSTS"": 16, ""STARFRUIT"": 9}",4547,5068,10001
560900,-19996,-221077,"(AMETHYSTS, US << MARKET, 9998, 1, 560900)
(AMETHYSTS, US << MARKET, 9998, 1, 560900)","{""AMETHYSTS"": 18, ""STARFRUIT"": 9}",4553,5068,10001
561200,25325,-195752,"(STARFRUIT, MARKET << US, 5065, 1, 561200)
(STARFRUIT, MARKET << US, 5065, 1, 561200)
(STARFRUIT, MARKET << US, 5065, 1, 561200)
(STARFRUIT, MARKET << US, 5065, 1, 561200)
(STARFRUIT, MARKET << US, 5065, 1, 561200)","{""AMETHYSTS"": 18, ""STARFRUIT"": 4}",4504,5064,10000
561300,-40248,-236000,"(AMETHYSTS, US << MARKET, 9996, 1, 561300)
(AMETHYSTS, US << MARKET, 9996, 1, 561300)
(STARFRUIT, US << MARKET, 5064, 1, 561300)
(STARFRUIT, US << MARKET, 5064, 1, 561300)
(STARFRUIT, US << MARKET, 5064, 1, 561300)
(STARFRUIT, US << MARKET, 5064, 1, 561300)","{""AMETHYSTS"": 20, ""STARFRUIT"": 8}",4528,5066,10000
562100,20004,-215996,"(AMETHYSTS, MARKET << US, 10002, 1, 562100)
(AMETHYSTS, MARKET << US, 10002, 1, 562100)","{""AMETHYSTS"": 18, ""STARFRUIT"": 8}",4586,5066,10003
562200,-4,-216000,"(AMETHYSTS, US << MARKET, 10002, 1, 562200)
(AMETHYSTS, MARKET << US, 9998, 1, 562200)","{""AMETHYSTS"": 18, ""STARFRUIT"": 8}",4574,5065,10003
562300,-20252,-236252,"(STARFRUIT, US << MARKET, 5063, 1, 562300)
(STARFRUIT, US << MARKET, 5063, 1, 562300)
(STARFRUIT, US << MARKET, 5063, 1, 562300)
(STARFRUIT, US << MARKET, 5063, 1, 562300)","{""AMETHYSTS"": 18, ""STARFRUIT"": 12}",4546,5065,10001
562400,20272,-215980,"(STARFRUIT, MARKET << US, 5068, 1, 562400)
(STARFRUIT, MARKET << US, 5068, 1, 562400)
(STARFRUIT, MARKET << US, 5068, 1, 562400)
(STARFRUIT, MARKET << US, 5068, 1, 562400)","{""AMETHYSTS"": 18, ""STARFRUIT"": 8}",4504,5065,9998
562500,30420,-185560,"(STARFRUIT, MARKET << US, 5070, 1, 562500)
(STARFRUIT, MARKET << US, 5070, 1, 562500)
(STARFRUIT, MARKET << US, 5070, 1, 562500)
(STARFRUIT, MARKET << US, 5070, 1, 562500)
(STARFRUIT, MARKET << US, 5070, 1, 562500)
(STARFRUIT, MARKET << US, 5070, 1, 562500)","{""AMETHYSTS"": 18, ""STARFRUIT"": 2}",4574,5067,10000
562600,19992,-165568,"(AMETHYSTS, MARKET << US, 9996, 1, 562600)
(AMETHYSTS, MARKET << US, 9996, 1, 562600)","{""AMETHYSTS"": 16, ""STARFRUIT"": 2}",4564,5066,10000
563200,-10136,-175704,"(STARFRUIT, US << MARKET, 5068, 1, 563200)
(STARFRUIT, US << MARKET, 5068, 1, 563200)","{""AMETHYSTS"": 16, ""STARFRUIT"": 4}",4588,5069,10001
563300,5069,-170635,"(STARFRUIT, MARKET << US, 5069, 1, 563300)","{""AMETHYSTS"": 16, ""STARFRUIT"": 3}",4576,5065,10001
563500,-19996,-190631,"(AMETHYSTS, US << MARKET, 9998, 1, 563500)
(AMETHYSTS, US << MARKET, 9998, 1, 563500)","{""AMETHYSTS"": 18, ""STARFRUIT"": 3}",4585,5066,10001
563700,-19992,-210623,"(AMETHYSTS, US << MARKET, 9996, 1, 563700)
(AMETHYSTS, US << MARKET, 9996, 1, 563700)","{""AMETHYSTS"": 20, ""STARFRUIT"": 3}",4572,5065,10000
564200,10154,-200469,"(STARFRUIT, US << MARKET, 5063, 1, 564200)
(STARFRUIT, US << MARKET, 5063, 1, 564200)
(STARFRUIT, MARKET << US, 5070, 1, 564200)
(STARFRUIT, MARKET << US, 5070, 1, 564200)
(STARFRUIT, MARKET << US, 5070, 1, 564200)
(STARFRUIT, MARKET << US, 5070, 1, 564200)","{""AMETHYSTS"": 20, ""STARFRUIT"": 1}",4517,5066,9996
564600,5069,-195400,"(STARFRUIT, MARKET << US, 5069, 1, 564600)","{""AMETHYSTS"": 20, ""STARFRUIT"": 0}",4600,5069,10000
564700,-20382,-215782,"(AMETHYSTS, MARKET << US, 9996, 1, 564700)
(STARFRUIT, US << MARKET, 5063, 1, 564700)
(STARFRUIT, US << MARKET, 5063, 1, 564700)
(STARFRUIT, US << MARKET, 5063, 1, 564700)
(STARFRUIT, US << MARKET, 5063, 1, 564700)
(STARFRUIT, US << MARKET, 5063, 1, 564700)
(STARFRUIT, US << MARKET, 5063, 1, 564700)","{""AMETHYSTS"": 19, ""STARFRUIT"": 6}",4608,5065,10000
564800,-15192,-230974,"(STARFRUIT, US << MARKET, 5064, 1, 564800)
(STARFRUIT, US << MARKET, 5064, 1, 564800)
(STARFRUIT, US << MARKET, 5064, 1, 564800)","{""AMETHYSTS"": 19, ""STARFRUIT"": 9}",4629,5067,10000
564900,-4934,-235908,"(AMETHYSTS, US << MARKET, 10004, 1, 564900)
(STARFRUIT, MARKET << US, 5070, 1, 564900)","{""AMETHYSTS"": 20, ""STARFRUIT"": 8}",4620,5066,10000
565100,14941,-220967,"(AMETHYSTS, MARKET << US, 10005, 1, 565100)
(AMETHYSTS, MARKET << US, 10005, 1, 565100)
(STARFRUIT, US << MARKET, 5069, 1, 565100)","{""AMETHYSTS"": 18, ""STARFRUIT"": 9}",4618,5065,10000
565200,-5063,-226030,"(STARFRUIT, US << MARKET, 5063, 1, 565200)","{""AMETHYSTS"": 18, ""STARFRUIT"": 10}",4620,5065,10000
566100,-10002,-236032,"(AMETHYSTS, US << MARKET, 10002, 1, 566100)","{""AMETHYSTS"": 19, ""STARFRUIT"": 10}",4608,5064,10000
566200,-9998,-246030,"(AMETHYSTS, US << MARKET, 9998, 1, 566200)","{""AMETHYSTS"": 20, ""STARFRUIT"": 10}",4540,5063,9997
566400,30360,-215670,"(STARFRUIT, MARKET << US, 5060, 1, 566400)
(STARFRUIT, MARKET << US, 5060, 1, 566400)
(STARFRUIT, MARKET << US, 5060, 1, 566400)
(STARFRUIT, MARKET << US, 5060, 1, 566400)
(STARFRUIT, MARKET << US, 5060, 1, 566400)
(STARFRUIT, MARKET << US, 5060, 1, 566400)","{""AMETHYSTS"": 20, ""STARFRUIT"": 4}",4502,5063,9996
566600,-20244,-235914,"(STARFRUIT, US << MARKET, 5061, 1, 566600)
(STARFRUIT, US << MARKET, 5061, 1, 566600)
(STARFRUIT, US << MARKET, 5061, 1, 566600)
(STARFRUIT, US << MARKET, 5061, 1, 566600)","{""AMETHYSTS"": 20, ""STARFRUIT"": 8}",4618,5064,10001
566900,25066,-210848,"(AMETHYSTS, MARKET << US, 10002, 1, 566900)
(AMETHYSTS, MARKET << US, 10002, 1, 566900)
(STARFRUIT, MARKET << US, 5062, 1, 566900)","{""AMETHYSTS"": 18, ""STARFRUIT"": 7}",4661,5065,10003
567200,15056,-195792,"(AMETHYSTS, MARKET << US, 9996, 1, 567200)
(STARFRUIT, MARKET << US, 5060, 1, 567200)","{""AMETHYSTS"": 17, ""STARFRUIT"": 6}",4586,5063,10000
567300,-10132,-205924,"(STARFRUIT, US << MARKET, 5066, 1, 567300)
(STARFRUIT, US << MARKET, 5066, 1, 567300)","{""AMETHYSTS"": 17, ""STARFRUIT"": 8}",4623,5062,10003
567500,9868,-196056,"(AMETHYSTS, MARKET << US, 9996, 1, 567500)
(AMETHYSTS, MARKET << US, 9996, 1, 567500)
(STARFRUIT, US << MARKET, 5062, 1, 567500)
(STARFRUIT, US << MARKET, 5062, 1, 567500)","{""AMETHYSTS"": 15, ""STARFRUIT"": 10}",4594,5065,10000
567800,-5067,-201123,"(STARFRUIT, US << MARKET, 5067, 1, 567800)","{""AMETHYSTS"": 15, ""STARFRUIT"": 11}",4659,5067,10003
568600,-19996,-221119,"(AMETHYSTS, US << MARKET, 9998, 1, 568600)
(AMETHYSTS, US << MARKET, 9998, 1, 568600)","{""AMETHYSTS"": 17, ""STARFRUIT"": 11}",4546,5062,9999
569100,-20004,-241123,"(AMETHYSTS, US << MARKET, 10002, 1, 569100)
(AMETHYSTS, US << MARKET, 10002, 1, 569100)","{""AMETHYSTS"": 19, ""STARFRUIT"": 11}",4638,5064,10003
569200,-4935,-246058,"(AMETHYSTS, US << MARKET, 9996, 1, 569200)
(STARFRUIT, MARKET << US, 5061, 1, 569200)","{""AMETHYSTS"": 20, ""STARFRUIT"": 10}",4582,5064,10000
569400,40358,-205700,"(AMETHYSTS, MARKET << US, 9998, 1, 569400)
(STARFRUIT, MARKET << US, 5060, 1, 569400)
(STARFRUIT, MARKET << US, 5060, 1, 569400)
(STARFRUIT, MARKET << US, 5060, 1, 569400)
(STARFRUIT, MARKET << US, 5060, 1, 569400)
(STARFRUIT, MARKET << US, 5060, 1, 569400)
(STARFRUIT, MARKET << US, 5060, 1, 569400)","{""AMETHYSTS"": 19, ""STARFRUIT"": 4}",4476,5063,9996
569500,55179,-150521,"(AMETHYSTS, US << MARKET, 9996, 1, 569500)
(AMETHYSTS, MARKET << US, 9996, 1, 569500)
(AMETHYSTS, MARKET << US, 9996, 1, 569500)
(AMETHYSTS, MARKET << US, 9996, 1, 569500)
(AMETHYSTS, MARKET << US, 9996, 1, 569500)
(AMETHYSTS, MARKET << US, 9996, 1, 569500)
(STARFRUIT, MARKET << US, 5065, 1, 569500)
(STARFRUIT, MARKET << US, 5065, 1, 569500)
(STARFRUIT, MARKET << US, 5065, 1, 569500)","{""AMETHYSTS"": 15, ""STARFRUIT"": 1}",4530,5066,9999
569600,10122,-140399,"(STARFRUIT, MARKET << US, 5061, 1, 569600)
(STARFRUIT, MARKET << US, 5061, 1, 569600)","{""AMETHYSTS"": 15, ""STARFRUIT"": -1}",4541,5060,10000
569800,-10122,-150521,"(STARFRUIT, US << MARKET, 5061, 1, 569800)
(STARFRUIT, US << MARKET, 5061, 1, 569800)","{""AMETHYSTS"": 15, ""STARFRUIT"": 1}",4554,5060,10001
570600,-25330,-175851,"(STARFRUIT, US << MARKET, 5066, 1, 570600)
(STARFRUIT, US << MARKET, 5066, 1, 570600)
(STARFRUIT, US << MARKET, 5066, 1, 570600)
(STARFRUIT, US << MARKET, 5066, 1, 570600)
(STARFRUIT, US << MARKET, 5066, 1, 570600)","{""AMETHYSTS"": 15, ""STARFRUIT"": 6}",4551,5067,10000
571200,15201,-160650,"(STARFRUIT, US << MARKET, 5067, 1, 571200)
(STARFRUIT, US << MARKET, 5067, 1, 571200)
(STARFRUIT, MARKET << US, 5067, 1, 571200)
(STARFRUIT, MARKET << US, 5067, 1, 571200)
(STARFRUIT, MARKET << US, 5067, 1, 571200)
(STARFRUIT, MARKET << US, 5067, 1, 571200)
(STARFRUIT, MARKET << US, 5067, 1, 571200)","{""AMETHYSTS"": 15, ""STARFRUIT"": 3}",4542,5064,10000
571500,19996,-140654,"(AMETHYSTS, MARKET << US, 9998, 1, 571500)
(AMETHYSTS, MARKET << US, 9998, 1, 571500)","{""AMETHYSTS"": 13, ""STARFRUIT"": 3}",4493,5062,9997
571600,5063,-135591,"(STARFRUIT, MARKET << US, 5063, 1, 571600)","{""AMETHYSTS"": 13, ""STARFRUIT"": 2}",4567,5066,10002
572900,264,-135327,"(AMETHYSTS, US << MARKET, 9998, 1, 572900)
(AMETHYSTS, US << MARKET, 9998, 1, 572900)
(STARFRUIT, MARKET << US, 5065, 1, 572900)
(STARFRUIT, MARKET << US, 5065, 1, 572900)
(STARFRUIT, MARKET << US, 5065, 1, 572900)
(STARFRUIT, MARKET << US, 5065, 1, 572900)","{""AMETHYSTS"": 15, ""STARFRUIT"": -2}",4492,5068,9997
573300,-40008,-175335,"(AMETHYSTS, US << MARKET, 10002, 1, 573300)
(AMETHYSTS, US << MARKET, 10002, 1, 573300)
(AMETHYSTS, US << MARKET, 10002, 1, 573300)
(AMETHYSTS, US << MARKET, 10002, 1, 573300)","{""AMETHYSTS"": 19, ""STARFRUIT"": -2}",4466,5071,9997
573400,-10002,-185337,"(AMETHYSTS, US << MARKET, 10002, 1, 573400)","{""AMETHYSTS"": 20, ""STARFRUIT"": -2}",4589,5067,10003
574600,0,-185337,,"{""AMETHYSTS"": 20, ""STARFRUIT"": -2}",4587,5068,10003
575300,-10134,-195471,"(STARFRUIT, US << MARKET, 5067, 1, 575300)
(STARFRUIT, US << MARKET, 5067, 1, 575300)","{""AMETHYSTS"": 20, ""STARFRUIT"": 0}",4509,5069,9999
575800,5073,-190398,"(STARFRUIT, MARKET << US, 5073, 1, 575800)","{""AMETHYSTS"": 20, ""STARFRUIT"": -1}",4533,5069,10000
575900,-20268,-210666,"(STARFRUIT, US << MARKET, 5067, 1, 575900)
(STARFRUIT, US << MARKET, 5067, 1, 575900)
(STARFRUIT, US << MARKET, 5067, 1, 575900)
(STARFRUIT, US << MARKET, 5067, 1, 575900)","{""AMETHYSTS"": 20, ""STARFRUIT"": 3}",4544,5070,10000
576000,4932,-205734,"(AMETHYSTS, MARKET << US, 9998, 1, 576000)
(STARFRUIT, US << MARKET, 5067, 1, 576000)
(STARFRUIT, US << MARKET, 5067, 1, 576000)
(STARFRUIT, MARKET << US, 5068, 1, 576000)","{""AMETHYSTS"": 19, ""STARFRUIT"": 4}",4565,5070,10001
576200,9862,-195872,"(AMETHYSTS, MARKET << US, 10002, 1, 576200)
(AMETHYSTS, MARKET << US, 10002, 1, 576200)
(STARFRUIT, US << MARKET, 5071, 1, 576200)
(STARFRUIT, US << MARKET, 5071, 1, 576200)","{""AMETHYSTS"": 17, ""STARFRUIT"": 6}",4611,5072,10003
576300,-10132,-206004,"(STARFRUIT, US << MARKET, 5066, 1, 576300)
(STARFRUIT, US << MARKET, 5066, 1, 576300)","{""AMETHYSTS"": 17, ""STARFRUIT"": 8}",4548,5069,10000
576700,-10002,-216006,"(AMETHYSTS, US << MARKET, 10002, 1, 576700)","{""AMETHYSTS"": 18, ""STARFRUIT"": 8}",4608,5070,10003
576800,4930,-211076,"(AMETHYSTS, MARKET << US, 9996, 1, 576800)
(STARFRUIT, US << MARKET, 5066, 1, 576800)","{""AMETHYSTS"": 17, ""STARFRUIT"": 9}",4519,5068,9999
577400,5065,-206011,"(STARFRUIT, MARKET << US, 5065, 1, 577400)","{""AMETHYSTS"": 17, ""STARFRUIT"": 8}",4534,5066,10001
577700,-20004,-226015,"(AMETHYSTS, US << MARKET, 10002, 1, 577700)
(AMETHYSTS, US << MARKET, 10002, 1, 577700)","{""AMETHYSTS"": 19, ""STARFRUIT"": 8}",4502,5067,9999
577800,20004,-206011,"(AMETHYSTS, MARKET << US, 10002, 1, 577800)
(AMETHYSTS, MARKET << US, 10002, 1, 577800)","{""AMETHYSTS"": 17, ""STARFRUIT"": 8}",4500,5066,9999
578200,25079,-180932,"(AMETHYSTS, MARKET << US, 10004, 1, 578200)
(AMETHYSTS, MARKET << US, 10004, 1, 578200)
(STARFRUIT, MARKET << US, 5071, 1, 578200)","{""AMETHYSTS"": 15, ""STARFRUIT"": 7}",4589,5068,10003
578300,-5065,-185997,"(STARFRUIT, US << MARKET, 5065, 1, 578300)","{""AMETHYSTS"": 15, ""STARFRUIT"": 8}",4515,5064,10000
578400,-10286,-196283,"(AMETHYSTS, MARKET << US, 9998, 1, 578400)
(STARFRUIT, US << MARKET, 5071, 1, 578400)
(STARFRUIT, US << MARKET, 5071, 1, 578400)
(STARFRUIT, US << MARKET, 5071, 1, 578400)
(STARFRUIT, US << MARKET, 5071, 1, 578400)","{""AMETHYSTS"": 14, ""STARFRUIT"": 12}",4465,5067,9996
578600,-19996,-216279,"(AMETHYSTS, US << MARKET, 9998, 1, 578600)
(AMETHYSTS, US << MARKET, 9998, 1, 578600)","{""AMETHYSTS"": 16, ""STARFRUIT"": 12}",4581,5069,10002
578800,29876,-186403,"(AMETHYSTS, MARKET << US, 10004, 1, 578800)
(AMETHYSTS, MARKET << US, 10004, 1, 578800)
(AMETHYSTS, MARKET << US, 10004, 1, 578800)
(AMETHYSTS, MARKET << US, 10004, 1, 578800)
(STARFRUIT, US << MARKET, 5070, 1, 578800)
(STARFRUIT, US << MARKET, 5070, 1, 578800)","{""AMETHYSTS"": 12, ""STARFRUIT"": 14}",4535,5067,10000
578900,-14928,-201331,"(AMETHYSTS, US << MARKET, 9996, 1, 578900)
(AMETHYSTS, US << MARKET, 9996, 1, 578900)
(STARFRUIT, MARKET << US, 5064, 1, 578900)","{""AMETHYSTS"": 14, ""STARFRUIT"": 13}",4540,5067,10000
579000,-5069,-206400,"(STARFRUIT, US << MARKET, 5069, 1, 579000)","{""AMETHYSTS"": 14, ""STARFRUIT"": 14}",4496,5065,9999
579100,4934,-201466,"(AMETHYSTS, MARKET << US, 9998, 1, 579100)
(STARFRUIT, US << MARKET, 5064, 1, 579100)","{""AMETHYSTS"": 13, ""STARFRUIT"": 15}",4552,5067,10001
579300,5063,-196403,"(STARFRUIT, MARKET << US, 5063, 1, 579300)","{""AMETHYSTS"": 13, ""STARFRUIT"": 14}",4521,5066,10000
579500,4933,-191470,"(AMETHYSTS, US << MARKET, 10005, 1, 579500)
(AMETHYSTS, MARKET << US, 10004, 1, 579500)
(AMETHYSTS, MARKET << US, 10004, 1, 579500)
(STARFRUIT, US << MARKET, 5070, 1, 579500)","{""AMETHYSTS"": 12, ""STARFRUIT"": 15}",4520,5066,10000
579600,25320,-166150,"(STARFRUIT, MARKET << US, 5064, 1, 579600)
(STARFRUIT, MARKET << US, 5064, 1, 579600)
(STARFRUIT, MARKET << US, 5064, 1, 579600)
(STARFRUIT, MARKET << US, 5064, 1, 579600)
(STARFRUIT, MARKET << US, 5064, 1, 579600)","{""AMETHYSTS"": 12, ""STARFRUIT"": 10}",4472,5067,9996
579800,0,-166150,"(STARFRUIT, US << MARKET, 5069, 1, 579800)
(STARFRUIT, MARKET << US, 5069, 1, 579800)","{""AMETHYSTS"": 12, ""STARFRUIT"": 10}",4562,5070,10001
580000,5070,-161080,"(STARFRUIT, MARKET << US, 5070, 1, 580000)","{""AMETHYSTS"": 12, ""STARFRUIT"": 9}",4499,5067,9998
580500,10132,-150948,"(STARFRUIT, MARKET << US, 5066, 1, 580500)
(STARFRUIT, MARKET << US, 5066, 1, 580500)","{""AMETHYSTS"": 12, ""STARFRUIT"": 7}",4507,5065,10000
580800,-5070,-156018,"(STARFRUIT, US << MARKET, 5070, 1, 580800)","{""AMETHYSTS"": 12, ""STARFRUIT"": 8}",4542,5070,10000
580900,-10004,-166022,"(AMETHYSTS, US << MARKET, 10004, 1, 580900)
(AMETHYSTS, US << MARKET, 10004, 1, 580900)
(AMETHYSTS, US << MARKET, 10004, 1, 580900)
(AMETHYSTS, MARKET << US, 10004, 1, 580900)
(AMETHYSTS, MARKET << US, 10004, 1, 580900)","{""AMETHYSTS"": 13, ""STARFRUIT"": 8}",4522,5068,10000
581600,154993,-11029,"(AMETHYSTS, MARKET << US, 10004, 1, 581600)
(AMETHYSTS, MARKET << US, 10004, 1, 581600)
(AMETHYSTS, MARKET << US, 10004, 1, 581600)
(AMETHYSTS, MARKET << US, 10004, 1, 581600)
(AMETHYSTS, MARKET << US, 10004, 1, 581600)
(AMETHYSTS, MARKET << US, 10004, 1, 581600)
(AMETHYSTS, MARKET << US, 10004, 1, 581600)
(AMETHYSTS, MARKET << US, 10004, 1, 581600)
(AMETHYSTS, MARKET << US, 10004, 1, 581600)
(AMETHYSTS, MARKET << US, 10004, 1, 581600)
(AMETHYSTS, MARKET << US, 10004, 1, 581600)
(AMETHYSTS, MARKET << US, 10004, 1, 581600)
(AMETHYSTS, MARKET << US, 10004, 1, 581600)
(AMETHYSTS, MARKET << US, 10004, 1, 581600)
(AMETHYSTS, MARKET << US, 10004, 1, 581600)
(AMETHYSTS, MARKET << US, 10004, 1, 581600)
(STARFRUIT, US << MARKET, 5071, 1, 581600)","{""AMETHYSTS"": -3, ""STARFRUIT"": 9}",4610,5071,10000
581800,80016,68987,"(AMETHYSTS, MARKET << US, 10002, 1, 581800)
(AMETHYSTS, MARKET << US, 10002, 1, 581800)
(AMETHYSTS, MARKET << US, 10002, 1, 581800)
(AMETHYSTS, MARKET << US, 10002, 1, 581800)
(AMETHYSTS, MARKET << US, 10002, 1, 581800)
(AMETHYSTS, MARKET << US, 10002, 1, 581800)
(AMETHYSTS, MARKET << US, 10002, 1, 581800)
(AMETHYSTS, MARKET << US, 10002, 1, 581800)","{""AMETHYSTS"": -11, ""STARFRUIT"": 9}",4575,5069,10003
582000,-59988,8999,"(AMETHYSTS, US << MARKET, 9998, 1, 582000)
(AMETHYSTS, US << MARKET, 9998, 1, 582000)
(AMETHYSTS, US << MARKET, 9998, 1, 582000)
(AMETHYSTS, US << MARKET, 9998, 1, 582000)
(AMETHYSTS, US << MARKET, 9998, 1, 582000)
(AMETHYSTS, US << MARKET, 9998, 1, 582000)","{""AMETHYSTS"": -5, ""STARFRUIT"": 9}",4579,5065,10001
582400,5071,14070,"(STARFRUIT, MARKET << US, 5071, 1, 582400)","{""AMETHYSTS"": -5, ""STARFRUIT"": 8}",4614,5068,10000
582500,-5067,9003,"(STARFRUIT, US << MARKET, 5067, 1, 582500)","{""AMETHYSTS"": -5, ""STARFRUIT"": 9}",4618,5070,10003
582700,-5067,3936,"(STARFRUIT, US << MARKET, 5067, 1, 582700)","{""AMETHYSTS"": -5, ""STARFRUIT"": 10}",4591,5066,10001
583200,5068,9004,"(STARFRUIT, MARKET << US, 5068, 1, 583200)","{""AMETHYSTS"": -5, ""STARFRUIT"": 9}",4607,5067,10000
583400,-264,8740,"(AMETHYSTS, MARKET << US, 10002, 1, 583400)
(AMETHYSTS, MARKET << US, 10002, 1, 583400)
(STARFRUIT, US << MARKET, 5067, 1, 583400)
(STARFRUIT, US << MARKET, 5067, 1, 583400)
(STARFRUIT, US << MARKET, 5067, 1, 583400)
(STARFRUIT, US << MARKET, 5067, 1, 583400)","{""AMETHYSTS"": -7, ""STARFRUIT"": 13}",4629,5070,10003
583600,5073,13813,"(STARFRUIT, US << MARKET, 5067, 1, 583600)
(STARFRUIT, MARKET << US, 5070, 1, 583600)
(STARFRUIT, MARKET << US, 5070, 1, 583600)","{""AMETHYSTS"": -7, ""STARFRUIT"": 12}",4643,5068,9998
583700,-10270,3543,"(AMETHYSTS, MARKET << US, 9998, 1, 583700)
(STARFRUIT, US << MARKET, 5067, 1, 583700)
(STARFRUIT, US << MARKET, 5067, 1, 583700)
(STARFRUIT, US << MARKET, 5067, 1, 583700)
(STARFRUIT, US << MARKET, 5067, 1, 583700)","{""AMETHYSTS"": -8, ""STARFRUIT"": 16}",4695,5070,9996
583900,-5068,-1525,"(STARFRUIT, US << MARKET, 5068, 1, 583900)","{""AMETHYSTS"": -8, ""STARFRUIT"": 17}",4665,5070,10000
584500,20004,18479,"(AMETHYSTS, MARKET << US, 10002, 1, 584500)
(AMETHYSTS, MARKET << US, 10002, 1, 584500)","{""AMETHYSTS"": -10, ""STARFRUIT"": 17}",4639,5070,10003
585100,-5068,13411,"(STARFRUIT, US << MARKET, 5068, 1, 585100)","{""AMETHYSTS"": -10, ""STARFRUIT"": 18}",4689,5071,10000
585900,-10144,3267,"(STARFRUIT, US << MARKET, 5072, 1, 585900)
(STARFRUIT, US << MARKET, 5072, 1, 585900)","{""AMETHYSTS"": -10, ""STARFRUIT"": 20}",4687,5070,9998
586500,-20008,-16741,"(AMETHYSTS, US << MARKET, 10004, 1, 586500)
(AMETHYSTS, US << MARKET, 10004, 1, 586500)","{""AMETHYSTS"": -8, ""STARFRUIT"": 20}",4699,5072,10000
586600,25061,8320,"(AMETHYSTS, MARKET << US, 9996, 1, 586600)
(AMETHYSTS, MARKET << US, 9996, 1, 586600)
(STARFRUIT, MARKET << US, 5069, 1, 586600)","{""AMETHYSTS"": -10, ""STARFRUIT"": 19}",4688,5072,10000
587500,35213,43533,"(AMETHYSTS, MARKET << US, 10000, 1, 587500)
(AMETHYSTS, MARKET << US, 10000, 1, 587500)
(STARFRUIT, MARKET << US, 5071, 1, 587500)
(STARFRUIT, MARKET << US, 5071, 1, 587500)
(STARFRUIT, MARKET << US, 5071, 1, 587500)","{""AMETHYSTS"": -12, ""STARFRUIT"": 16}",4661,5069,9998
587600,-5074,38459,"(STARFRUIT, US << MARKET, 5074, 1, 587600)","{""AMETHYSTS"": -12, ""STARFRUIT"": 17}",4654,5071,10001
587700,5074,43533,"(STARFRUIT, MARKET << US, 5074, 1, 587700)","{""AMETHYSTS"": -12, ""STARFRUIT"": 16}",4717,5074,10000
588200,5073,48606,"(STARFRUIT, MARKET << US, 5073, 1, 588200)","{""AMETHYSTS"": -12, ""STARFRUIT"": 15}",4620,5070,10003
588300,-129831,-81225,"(AMETHYSTS, US << MARKET, 9998, 1, 588300)
(AMETHYSTS, US << MARKET, 9998, 1, 588300)
(AMETHYSTS, US << MARKET, 9998, 1, 588300)
(AMETHYSTS, US << MARKET, 9998, 1, 588300)
(AMETHYSTS, US << MARKET, 9998, 1, 588300)
(AMETHYSTS, US << MARKET, 9998, 1, 588300)
(AMETHYSTS, US << MARKET, 9998, 1, 588300)
(AMETHYSTS, US << MARKET, 9998, 1, 588300)
(AMETHYSTS, US << MARKET, 9998, 1, 588300)
(AMETHYSTS, US << MARKET, 9998, 1, 588300)
(AMETHYSTS, US << MARKET, 9998, 1, 588300)
(AMETHYSTS, US << MARKET, 9998, 1, 588300)
(AMETHYSTS, US << MARKET, 9998, 1, 588300)
(AMETHYSTS, US << MARKET, 9998, 1, 588300)
(STARFRUIT, US << MARKET, 5069, 1, 588300)
(STARFRUIT, MARKET << US, 5070, 1, 588300)
(STARFRUIT, MARKET << US, 5070, 1, 588300)
(STARFRUIT, MARKET << US, 5070, 1, 588300)","{""AMETHYSTS"": 2, ""STARFRUIT"": 13}",4651,5068,9996
588700,-9856,-91081,"(AMETHYSTS, US << MARKET, 9996, 1, 588700)
(AMETHYSTS, US << MARKET, 9996, 1, 588700)
(STARFRUIT, MARKET << US, 5068, 1, 588700)
(STARFRUIT, MARKET << US, 5068, 1, 588700)","{""AMETHYSTS"": 4, ""STARFRUIT"": 11}",4700,5071,10000
588800,-20284,-111365,"(STARFRUIT, US << MARKET, 5071, 1, 588800)
(STARFRUIT, US << MARKET, 5071, 1, 588800)
(STARFRUIT, US << MARKET, 5071, 1, 588800)
(STARFRUIT, US << MARKET, 5071, 1, 588800)","{""AMETHYSTS"": 4, ""STARFRUIT"": 15}",4666,5069,9999
589000,-5068,-116433,"(STARFRUIT, US << MARKET, 5068, 1, 589000)","{""AMETHYSTS"": 4, ""STARFRUIT"": 16}",4719,5072,10000
589500,-25064,-141497,"(AMETHYSTS, US << MARKET, 9998, 1, 589500)
(AMETHYSTS, US << MARKET, 9998, 1, 589500)
(STARFRUIT, US << MARKET, 5068, 1, 589500)","{""AMETHYSTS"": 6, ""STARFRUIT"": 17}",4716,5071,10001
589800,-4929,-146426,"(AMETHYSTS, US << MARKET, 10004, 1, 589800)
(STARFRUIT, MARKET << US, 5075, 1, 589800)","{""AMETHYSTS"": 7, ""STARFRUIT"": 16}",4710,5071,10000
589900,-25060,-171486,"(AMETHYSTS, US << MARKET, 9996, 1, 589900)
(AMETHYSTS, US << MARKET, 9996, 1, 589900)
(STARFRUIT, US << MARKET, 5068, 1, 589900)","{""AMETHYSTS"": 9, ""STARFRUIT"": 17}",4721,5071,10000
590000,-19996,-191482,"(AMETHYSTS, US << MARKET, 9998, 1, 590000)
(AMETHYSTS, US << MARKET, 9998, 1, 590000)","{""AMETHYSTS"": 11, ""STARFRUIT"": 17}",4702,5069,10001
590100,-39984,-231466,"(AMETHYSTS, US << MARKET, 9996, 1, 590100)
(AMETHYSTS, US << MARKET, 9996, 1, 590100)
(AMETHYSTS, US << MARKET, 9996, 1, 590100)
(AMETHYSTS, US << MARKET, 9996, 1, 590100)","{""AMETHYSTS"": 15, ""STARFRUIT"": 17}",4679,5070,9997
590200,14934,-216532,"(AMETHYSTS, MARKET << US, 10004, 1, 590200)
(AMETHYSTS, MARKET << US, 10004, 1, 590200)
(STARFRUIT, US << MARKET, 5074, 1, 590200)","{""AMETHYSTS"": 13, ""STARFRUIT"": 18}",4728,5070,10000
590300,15065,-201467,"(AMETHYSTS, MARKET << US, 9998, 1, 590300)
(STARFRUIT, MARKET << US, 5067, 1, 590300)","{""AMETHYSTS"": 12, ""STARFRUIT"": 17}",4759,5070,10003
590400,-19996,-221463,"(AMETHYSTS, US << MARKET, 9998, 1, 590400)
(AMETHYSTS, US << MARKET, 9998, 1, 590400)","{""AMETHYSTS"": 14, ""STARFRUIT"": 17}",4741,5070,10001
590600,40016,-181447,"(AMETHYSTS, MARKET << US, 10004, 1, 590600)
(AMETHYSTS, MARKET << US, 10004, 1, 590600)
(AMETHYSTS, MARKET << US, 10004, 1, 590600)
(AMETHYSTS, MARKET << US, 10004, 1, 590600)","{""AMETHYSTS"": 10, ""STARFRUIT"": 17}",4743,5070,10000
591100,-20010,-201457,"(AMETHYSTS, US << MARKET, 10005, 1, 591100)
(AMETHYSTS, US << MARKET, 10005, 1, 591100)","{""AMETHYSTS"": 12, ""STARFRUIT"": 17}",4728,5069,10001
591300,35469,-165988,"(STARFRUIT, MARKET << US, 5067, 1, 591300)
(STARFRUIT, MARKET << US, 5067, 1, 591300)
(STARFRUIT, MARKET << US, 5067, 1, 591300)
(STARFRUIT, MARKET << US, 5067, 1, 591300)
(STARFRUIT, MARKET << US, 5067, 1, 591300)
(STARFRUIT, MARKET << US, 5067, 1, 591300)
(STARFRUIT, MARKET << US, 5067, 1, 591300)","{""AMETHYSTS"": 12, ""STARFRUIT"": 10}",4670,5067,9999
591400,30126,-135862,"(AMETHYSTS, MARKET << US, 9996, 1, 591400)
(AMETHYSTS, MARKET << US, 9996, 1, 591400)
(STARFRUIT, MARKET << US, 5067, 1, 591400)
(STARFRUIT, MARKET << US, 5067, 1, 591400)","{""AMETHYSTS"": 10, ""STARFRUIT"": 8}",4668,5070,9997
591500,4918,-130944,"(AMETHYSTS, MARKET << US, 9998, 1, 591500)
(STARFRUIT, US << MARKET, 5074, 1, 591500)
(STARFRUIT, US << MARKET, 5074, 1, 591500)
(STARFRUIT, MARKET << US, 5068, 1, 591500)","{""AMETHYSTS"": 9, ""STARFRUIT"": 9}",4659,5070,9997
591600,10146,-120798,"(STARFRUIT, MARKET << US, 5073, 1, 591600)
(STARFRUIT, MARKET << US, 5073, 1, 591600)","{""AMETHYSTS"": 9, ""STARFRUIT"": 7}",4702,5074,9998
591800,-10002,-130800,"(AMETHYSTS, US << MARKET, 10002, 1, 591800)","{""AMETHYSTS"": 10, ""STARFRUIT"": 7}",4687,5071,9999
592000,-5069,-135869,"(STARFRUIT, US << MARKET, 5069, 1, 592000)","{""AMETHYSTS"": 10, ""STARFRUIT"": 8}",4707,5072,10000
592200,-15232,-151101,"(STARFRUIT, US << MARKET, 5075, 1, 592200)
(STARFRUIT, US << MARKET, 5075, 1, 592200)
(STARFRUIT, US << MARKET, 5075, 1, 592200)
(STARFRUIT, US << MARKET, 5075, 1, 592200)
(STARFRUIT, MARKET << US, 5068, 1, 592200)","{""AMETHYSTS"": 10, ""STARFRUIT"": 11}",4680,5071,10000
592800,20004,-131097,"(AMETHYSTS, MARKET << US, 10002, 1, 592800)
(AMETHYSTS, MARKET << US, 10002, 1, 592800)","{""AMETHYSTS"": 8, ""STARFRUIT"": 11}",4660,5071,9997
592900,-30006,-161103,"(AMETHYSTS, US << MARKET, 10002, 1, 592900)
(AMETHYSTS, US << MARKET, 10002, 1, 592900)
(AMETHYSTS, US << MARKET, 10002, 1, 592900)","{""AMETHYSTS"": 11, ""STARFRUIT"": 11}",4711,5071,10003
593200,-5068,-166171,"(STARFRUIT, US << MARKET, 5068, 1, 593200)","{""AMETHYSTS"": 11, ""STARFRUIT"": 12}",4681,5071,10000
593600,-19996,-186167,"(AMETHYSTS, US << MARKET, 9998, 1, 593600)
(AMETHYSTS, US << MARKET, 9998, 1, 593600)","{""AMETHYSTS"": 13, ""STARFRUIT"": 12}",4674,5069,10001
594200,-5067,-191234,"(STARFRUIT, US << MARKET, 5067, 1, 594200)","{""AMETHYSTS"": 13, ""STARFRUIT"": 13}",4663,5070,9999
594300,-19996,-211230,"(AMETHYSTS, US << MARKET, 9998, 1, 594300)
(AMETHYSTS, US << MARKET, 9998, 1, 594300)","{""AMETHYSTS"": 15, ""STARFRUIT"": 13}",4620,5070,9996
594400,5067,-206163,"(STARFRUIT, MARKET << US, 5067, 1, 594400)","{""AMETHYSTS"": 15, ""STARFRUIT"": 12}",4677,5070,10000
594500,-10002,-216165,"(AMETHYSTS, US << MARKET, 10002, 1, 594500)","{""AMETHYSTS"": 16, ""STARFRUIT"": 12}",4723,5070,10003
595200,25073,-191092,"(AMETHYSTS, MARKET << US, 10002, 1, 595200)
(AMETHYSTS, MARKET << US, 10002, 1, 595200)
(STARFRUIT, MARKET << US, 5069, 1, 595200)","{""AMETHYSTS"": 14, ""STARFRUIT"": 11}",4742,5072,10003
595300,-50025,-241117,"(AMETHYSTS, US << MARKET, 10005, 1, 595300)
(AMETHYSTS, US << MARKET, 10005, 1, 595300)
(AMETHYSTS, US << MARKET, 10005, 1, 595300)
(AMETHYSTS, US << MARKET, 10005, 1, 595300)
(AMETHYSTS, US << MARKET, 10005, 1, 595300)","{""AMETHYSTS"": 19, ""STARFRUIT"": 11}",4697,5074,10000
596000,-10004,-251121,"(AMETHYSTS, US << MARKET, 10004, 1, 596000)","{""AMETHYSTS"": 20, ""STARFRUIT"": 11}",4720,5071,10003
596300,0,-251121,,"{""AMETHYSTS"": 20, ""STARFRUIT"": 11}",4622,5073,9997
596400,10142,-240979,"(STARFRUIT, MARKET << US, 5071, 1, 596400)
(STARFRUIT, MARKET << US, 5071, 1, 596400)","{""AMETHYSTS"": 20, ""STARFRUIT"": 9}",4582,5069,9997
597300,29994,-210985,"(AMETHYSTS, MARKET << US, 9998, 1, 597300)
(AMETHYSTS, MARKET << US, 9998, 1, 597300)
(AMETHYSTS, MARKET << US, 9998, 1, 597300)","{""AMETHYSTS"": 17, ""STARFRUIT"": 9}",4577,5070,9996
597400,79960,-131025,"(AMETHYSTS, MARKET << US, 9995, 1, 597400)
(AMETHYSTS, MARKET << US, 9995, 1, 597400)
(AMETHYSTS, MARKET << US, 9995, 1, 597400)
(AMETHYSTS, MARKET << US, 9995, 1, 597400)
(AMETHYSTS, MARKET << US, 9995, 1, 597400)
(AMETHYSTS, MARKET << US, 9995, 1, 597400)
(AMETHYSTS, MARKET << US, 9995, 1, 597400)
(AMETHYSTS, MARKET << US, 9995, 1, 597400)","{""AMETHYSTS"": 9, ""STARFRUIT"": 9}",4605,5072,9998
597500,-14925,-145950,"(AMETHYSTS, US << MARKET, 10004, 1, 597500)
(AMETHYSTS, US << MARKET, 10004, 1, 597500)
(STARFRUIT, US << MARKET, 5069, 1, 597500)
(STARFRUIT, MARKET << US, 5076, 1, 597500)
(STARFRUIT, MARKET << US, 5076, 1, 597500)","{""AMETHYSTS"": 11, ""STARFRUIT"": 8}",4634,5073,10000
598000,85034,-60916,"(AMETHYSTS, MARKET << US, 9995, 1, 598000)
(AMETHYSTS, MARKET << US, 9995, 1, 598000)
(AMETHYSTS, MARKET << US, 9995, 1, 598000)
(AMETHYSTS, MARKET << US, 9995, 1, 598000)
(AMETHYSTS, MARKET << US, 9995, 1, 598000)
(AMETHYSTS, MARKET << US, 9995, 1, 598000)
(AMETHYSTS, MARKET << US, 9995, 1, 598000)
(AMETHYSTS, MARKET << US, 9995, 1, 598000)
(STARFRUIT, MARKET << US, 5074, 1, 598000)","{""AMETHYSTS"": 3, ""STARFRUIT"": 7}",4603,5075,9998
598800,-5073,-65989,"(STARFRUIT, US << MARKET, 5073, 1, 598800)","{""AMETHYSTS"": 3, ""STARFRUIT"": 8}",4603,5074,10000
599000,15069,-50920,"(AMETHYSTS, US << MARKET, 10002, 1, 599000)
(AMETHYSTS, MARKET << US, 10002, 1, 599000)
(AMETHYSTS, MARKET << US, 10002, 1, 599000)
(STARFRUIT, MARKET << US, 5067, 1, 599000)","{""AMETHYSTS"": 2, ""STARFRUIT"": 7}",4576,5070,10003
599200,-30146,-81066,"(AMETHYSTS, US << MARKET, 10002, 1, 599200)
(AMETHYSTS, US << MARKET, 10002, 1, 599200)
(STARFRUIT, US << MARKET, 5071, 1, 599200)
(STARFRUIT, US << MARKET, 5071, 1, 599200)","{""AMETHYSTS"": 4, ""STARFRUIT"": 9}",4542,5068,9999
599300,49866,-31200,"(AMETHYSTS, MARKET << US, 10002, 1, 599300)
(AMETHYSTS, MARKET << US, 10002, 1, 599300)
(AMETHYSTS, MARKET << US, 10002, 1, 599300)
(AMETHYSTS, MARKET << US, 10002, 1, 599300)
(AMETHYSTS, MARKET << US, 10002, 1, 599300)
(AMETHYSTS, MARKET << US, 10002, 1, 599300)
(STARFRUIT, US << MARKET, 5073, 1, 599300)
(STARFRUIT, US << MARKET, 5073, 1, 599300)","{""AMETHYSTS"": -2, ""STARFRUIT"": 11}",4564,5070,10003
599500,-25067,-56267,"(AMETHYSTS, US << MARKET, 9998, 1, 599500)
(AMETHYSTS, US << MARKET, 9998, 1, 599500)
(STARFRUIT, US << MARKET, 5071, 1, 599500)","{""AMETHYSTS"": 0, ""STARFRUIT"": 12}",4597,5072,10000
599900,-10002,-66269,"(AMETHYSTS, US << MARKET, 10002, 1, 599900)","{""AMETHYSTS"": 1, ""STARFRUIT"": 12}",4574,5070,10003
600100,-5073,-71342,"(STARFRUIT, US << MARKET, 5073, 1, 600100)","{""AMETHYSTS"": 1, ""STARFRUIT"": 13}",4607,5073,10000
600400,-4930,-76272,"(AMETHYSTS, US << MARKET, 10004, 1, 600400)
(STARFRUIT, MARKET << US, 5074, 1, 600400)","{""AMETHYSTS"": 2, ""STARFRUIT"": 12}",4586,5071,10003
600600,5073,-71199,"(STARFRUIT, MARKET << US, 5073, 1, 600600)","{""AMETHYSTS"": 2, ""STARFRUIT"": 11}",4606,5073,10001
600700,5073,-66126,"(STARFRUIT, MARKET << US, 5073, 1, 600700)","{""AMETHYSTS"": 2, ""STARFRUIT"": 10}",4604,5073,10000
600800,20272,-45854,"(STARFRUIT, MARKET << US, 5068, 1, 600800)
(STARFRUIT, MARKET << US, 5068, 1, 600800)
(STARFRUIT, MARKET << US, 5068, 1, 600800)
(STARFRUIT, MARKET << US, 5068, 1, 600800)","{""AMETHYSTS"": 2, ""STARFRUIT"": 6}",4548,5067,10000
601300,9860,-35994,"(AMETHYSTS, MARKET << US, 10005, 1, 601300)
(AMETHYSTS, MARKET << US, 10005, 1, 601300)
(STARFRUIT, US << MARKET, 5075, 1, 601300)
(STARFRUIT, US << MARKET, 5075, 1, 601300)","{""AMETHYSTS"": 0, ""STARFRUIT"": 8}",4574,5071,10003
601500,-10002,-45996,"(AMETHYSTS, US << MARKET, 10002, 1, 601500)","{""AMETHYSTS"": 1, ""STARFRUIT"": 8}",4546,5068,9998
602100,-25210,-71206,"(AMETHYSTS, US << MARKET, 10000, 1, 602100)
(STARFRUIT, US << MARKET, 5070, 1, 602100)
(STARFRUIT, US << MARKET, 5070, 1, 602100)
(STARFRUIT, US << MARKET, 5070, 1, 602100)","{""AMETHYSTS"": 2, ""STARFRUIT"": 11}",4612,5074,10002
602800,-35080,-106286,"(AMETHYSTS, US << MARKET, 10002, 1, 602800)
(AMETHYSTS, US << MARKET, 10002, 1, 602800)
(AMETHYSTS, US << MARKET, 10002, 1, 602800)
(STARFRUIT, US << MARKET, 5074, 1, 602800)","{""AMETHYSTS"": 5, ""STARFRUIT"": 12}",4629,5075,10003
603700,10142,-96144,"(STARFRUIT, US << MARKET, 5071, 1, 603700)
(STARFRUIT, US << MARKET, 5071, 1, 603700)
(STARFRUIT, US << MARKET, 5071, 1, 603700)
(STARFRUIT, US << MARKET, 5071, 1, 603700)
(STARFRUIT, MARKET << US, 5071, 1, 603700)
(STARFRUIT, MARKET << US, 5071, 1, 603700)
(STARFRUIT, MARKET << US, 5071, 1, 603700)
(STARFRUIT, MARKET << US, 5071, 1, 603700)
(STARFRUIT, MARKET << US, 5071, 1, 603700)
(STARFRUIT, MARKET << US, 5071, 1, 603700)","{""AMETHYSTS"": 5, ""STARFRUIT"": 10}",4586,5072,10002
603900,-20272,-116416,"(STARFRUIT, US << MARKET, 5068, 1, 603900)
(STARFRUIT, US << MARKET, 5068, 1, 603900)
(STARFRUIT, US << MARKET, 5068, 1, 603900)
(STARFRUIT, US << MARKET, 5068, 1, 603900)","{""AMETHYSTS"": 5, ""STARFRUIT"": 14}",4578,5071,10000
604000,5068,-111348,"(STARFRUIT, MARKET << US, 5068, 1, 604000)","{""AMETHYSTS"": 5, ""STARFRUIT"": 13}",4562,5070,10000
604200,20008,-91340,"(AMETHYSTS, MARKET << US, 10004, 1, 604200)
(AMETHYSTS, MARKET << US, 10004, 1, 604200)","{""AMETHYSTS"": 3, ""STARFRUIT"": 13}",4586,5071,10001
605000,-14927,-106267,"(AMETHYSTS, US << MARKET, 9998, 1, 605000)
(AMETHYSTS, US << MARKET, 9998, 1, 605000)
(STARFRUIT, MARKET << US, 5069, 1, 605000)","{""AMETHYSTS"": 5, ""STARFRUIT"": 12}",4534,5068,9997
605300,-5074,-111341,"(STARFRUIT, US << MARKET, 5074, 1, 605300)","{""AMETHYSTS"": 5, ""STARFRUIT"": 13}",4611,5074,9998
605900,-5071,-116412,"(STARFRUIT, US << MARKET, 5071, 1, 605900)","{""AMETHYSTS"": 5, ""STARFRUIT"": 14}",4625,5073,10003
606700,80016,-36396,"(AMETHYSTS, MARKET << US, 10002, 1, 606700)
(AMETHYSTS, MARKET << US, 10002, 1, 606700)
(AMETHYSTS, MARKET << US, 10002, 1, 606700)
(AMETHYSTS, MARKET << US, 10002, 1, 606700)
(AMETHYSTS, MARKET << US, 10002, 1, 606700)
(AMETHYSTS, MARKET << US, 10002, 1, 606700)
(AMETHYSTS, MARKET << US, 10002, 1, 606700)
(AMETHYSTS, MARKET << US, 10002, 1, 606700)","{""AMETHYSTS"": -3, ""STARFRUIT"": 14}",4632,5073,9998
606800,-5070,-41466,"(STARFRUIT, US << MARKET, 5070, 1, 606800)","{""AMETHYSTS"": -3, ""STARFRUIT"": 15}",4632,5073,9999
607300,20296,-21170,"(STARFRUIT, MARKET << US, 5074, 1, 607300)
(STARFRUIT, MARKET << US, 5074, 1, 607300)
(STARFRUIT, MARKET << US, 5074, 1, 607300)
(STARFRUIT, MARKET << US, 5074, 1, 607300)","{""AMETHYSTS"": -3, ""STARFRUIT"": 11}",4613,5072,10003
607800,5071,-16099,"(STARFRUIT, MARKET << US, 5071, 1, 607800)","{""AMETHYSTS"": -3, ""STARFRUIT"": 10}",4628,5073,10001
607900,-39992,-56091,"(AMETHYSTS, US << MARKET, 9998, 1, 607900)
(AMETHYSTS, US << MARKET, 9998, 1, 607900)
(AMETHYSTS, US << MARKET, 9998, 1, 607900)
(AMETHYSTS, US << MARKET, 9998, 1, 607900)","{""AMETHYSTS"": 1, ""STARFRUIT"": 10}",4635,5073,9996
608700,5071,-51020,"(STARFRUIT, MARKET << US, 5071, 1, 608700)","{""AMETHYSTS"": 1, ""STARFRUIT"": 9}",4608,5070,9998
608800,30164,-20856,"(AMETHYSTS, MARKET << US, 10005, 1, 608800)
(AMETHYSTS, MARKET << US, 10005, 1, 608800)
(STARFRUIT, MARKET << US, 5078, 1, 608800)
(STARFRUIT, MARKET << US, 5076, 1, 608800)","{""AMETHYSTS"": -1, ""STARFRUIT"": 7}",4683,5077,10000
609100,142,-20714,"(AMETHYSTS, US << MARKET, 9996, 1, 609100)
(AMETHYSTS, US << MARKET, 9996, 1, 609100)
(AMETHYSTS, MARKET << US, 9996, 1, 609100)
(STARFRUIT, MARKET << US, 5069, 1, 609100)
(STARFRUIT, MARKET << US, 5069, 1, 609100)","{""AMETHYSTS"": 0, ""STARFRUIT"": 5}",4641,5071,10000
609200,9998,-10716,"(AMETHYSTS, MARKET << US, 9998, 1, 609200)","{""AMETHYSTS"": -1, ""STARFRUIT"": 5}",4652,5073,9997
609300,50162,39446,"(AMETHYSTS, MARKET << US, 10002, 1, 609300)
(AMETHYSTS, MARKET << US, 10002, 1, 609300)
(AMETHYSTS, MARKET << US, 10002, 1, 609300)
(AMETHYSTS, MARKET << US, 10002, 1, 609300)
(STARFRUIT, MARKET << US, 5077, 1, 609300)
(STARFRUIT, MARKET << US, 5077, 1, 609300)","{""AMETHYSTS"": -5, ""STARFRUIT"": 3}",4670,5073,9999
609900,-25380,14066,"(STARFRUIT, US << MARKET, 5076, 1, 609900)
(STARFRUIT, US << MARKET, 5076, 1, 609900)
(STARFRUIT, US << MARKET, 5076, 1, 609900)
(STARFRUIT, US << MARKET, 5076, 1, 609900)
(STARFRUIT, US << MARKET, 5076, 1, 609900)","{""AMETHYSTS"": -5, ""STARFRUIT"": 8}",4650,5073,10000
610000,-5070,8996,"(STARFRUIT, US << MARKET, 5070, 1, 610000)","{""AMETHYSTS"": -5, ""STARFRUIT"": 9}",4644,5072,10000
610600,30456,39452,"(STARFRUIT, MARKET << US, 5076, 1, 610600)
(STARFRUIT, MARKET << US, 5076, 1, 610600)
(STARFRUIT, MARKET << US, 5076, 1, 610600)
(STARFRUIT, MARKET << US, 5076, 1, 610600)
(STARFRUIT, MARKET << US, 5076, 1, 610600)
(STARFRUIT, MARKET << US, 5076, 1, 610600)","{""AMETHYSTS"": -5, ""STARFRUIT"": 3}",4668,5072,10000
610700,5069,44521,"(STARFRUIT, MARKET << US, 5069, 1, 610700)","{""AMETHYSTS"": -5, ""STARFRUIT"": 2}",4660,5072,10001
611400,-59988,-15467,"(AMETHYSTS, US << MARKET, 9998, 1, 611400)
(AMETHYSTS, US << MARKET, 9998, 1, 611400)
(AMETHYSTS, US << MARKET, 9998, 1, 611400)
(AMETHYSTS, US << MARKET, 9998, 1, 611400)
(AMETHYSTS, US << MARKET, 9998, 1, 611400)
(AMETHYSTS, US << MARKET, 9998, 1, 611400)","{""AMETHYSTS"": 1, ""STARFRUIT"": 2}",4676,5073,9997
613300,-19996,-35463,"(AMETHYSTS, US << MARKET, 9998, 1, 613300)
(AMETHYSTS, US << MARKET, 9998, 1, 613300)","{""AMETHYSTS"": 3, ""STARFRUIT"": 2}",4671,5073,9996
613800,5070,-30393,"(STARFRUIT, MARKET << US, 5070, 1, 613800)","{""AMETHYSTS"": 3, ""STARFRUIT"": 1}",4679,5072,10000
613900,5075,-25318,"(STARFRUIT, MARKET << US, 5075, 1, 613900)","{""AMETHYSTS"": 3, ""STARFRUIT"": 0}",4682,5075,10000
614000,-10436,-35754,"(AMETHYSTS, MARKET << US, 9998, 1, 614000)
(AMETHYSTS, MARKET << US, 9998, 1, 614000)
(STARFRUIT, US << MARKET, 5072, 1, 614000)
(STARFRUIT, US << MARKET, 5072, 1, 614000)
(STARFRUIT, US << MARKET, 5072, 1, 614000)
(STARFRUIT, US << MARKET, 5072, 1, 614000)
(STARFRUIT, US << MARKET, 5072, 1, 614000)
(STARFRUIT, US << MARKET, 5072, 1, 614000)","{""AMETHYSTS"": 1, ""STARFRUIT"": 6}",4669,5071,9997
614200,20004,-15750,"(AMETHYSTS, MARKET << US, 10002, 1, 614200)
(AMETHYSTS, MARKET << US, 10002, 1, 614200)","{""AMETHYSTS"": -1, ""STARFRUIT"": 6}",4701,5075,9999
614300,-10138,-25888,"(STARFRUIT, US << MARKET, 5069, 1, 614300)
(STARFRUIT, US << MARKET, 5069, 1, 614300)","{""AMETHYSTS"": -1, ""STARFRUIT"": 8}",4697,5073,9999
614600,-5069,-30957,"(STARFRUIT, US << MARKET, 5069, 1, 614600)","{""AMETHYSTS"": -1, ""STARFRUIT"": 9}",4688,5072,10003
614800,0,-30957,"(STARFRUIT, US << MARKET, 5073, 1, 614800)
(STARFRUIT, MARKET << US, 5073, 1, 614800)","{""AMETHYSTS"": -1, ""STARFRUIT"": 9}",4708,5074,10001
615200,30432,-525,"(STARFRUIT, MARKET << US, 5072, 1, 615200)
(STARFRUIT, MARKET << US, 5072, 1, 615200)
(STARFRUIT, MARKET << US, 5072, 1, 615200)
(STARFRUIT, MARKET << US, 5072, 1, 615200)
(STARFRUIT, MARKET << US, 5072, 1, 615200)
(STARFRUIT, MARKET << US, 5072, 1, 615200)","{""AMETHYSTS"": -1, ""STARFRUIT"": 3}",4693,5073,10001
615800,-20283,-20808,"(STARFRUIT, US << MARKET, 5071, 1, 615800)
(STARFRUIT, US << MARKET, 5071, 1, 615800)
(STARFRUIT, US << MARKET, 5071, 1, 615800)
(STARFRUIT, US << MARKET, 5071, 1, 615800)
(STARFRUIT, US << MARKET, 5071, 1, 615800)
(STARFRUIT, MARKET << US, 5072, 1, 615800)","{""AMETHYSTS"": -1, ""STARFRUIT"": 7}",4696,5072,10000
616100,10132,-10676,"(STARFRUIT, MARKET << US, 5066, 1, 616100)
(STARFRUIT, MARKET << US, 5066, 1, 616100)","{""AMETHYSTS"": -1, ""STARFRUIT"": 5}",4673,5069,9996
616300,-10142,-20818,"(STARFRUIT, US << MARKET, 5071, 1, 616300)
(STARFRUIT, US << MARKET, 5071, 1, 616300)","{""AMETHYSTS"": -1, ""STARFRUIT"": 7}",4658,5068,10000
616500,-5064,-25882,"(STARFRUIT, US << MARKET, 5064, 1, 616500)","{""AMETHYSTS"": -1, ""STARFRUIT"": 8}",4654,5067,10000
616800,9998,-15884,"(AMETHYSTS, MARKET << US, 9998, 1, 616800)","{""AMETHYSTS"": -2, ""STARFRUIT"": 8}",4652,5066,9996
617100,-19996,-35880,"(AMETHYSTS, US << MARKET, 9998, 1, 617100)
(AMETHYSTS, US << MARKET, 9998, 1, 617100)","{""AMETHYSTS"": 0, ""STARFRUIT"": 8}",4656,5067,9997
617500,-5064,-40944,"(STARFRUIT, US << MARKET, 5064, 1, 617500)","{""AMETHYSTS"": 0, ""STARFRUIT"": 9}",4650,5066,10001
618000,-5061,-46005,"(STARFRUIT, US << MARKET, 5061, 1, 618000)","{""AMETHYSTS"": 0, ""STARFRUIT"": 10}",4635,5064,9998
618300,0,-46005,"(STARFRUIT, US << MARKET, 5066, 1, 618300)
(STARFRUIT, MARKET << US, 5066, 1, 618300)","{""AMETHYSTS"": 0, ""STARFRUIT"": 10}",4665,5067,9999
618700,-5064,-51069,"(STARFRUIT, US << MARKET, 5064, 1, 618700)","{""AMETHYSTS"": 0, ""STARFRUIT"": 11}",4679,5068,10002
619100,5064,-46005,"(STARFRUIT, MARKET << US, 5064, 1, 619100)","{""AMETHYSTS"": 0, ""STARFRUIT"": 10}",4665,5067,10000
619200,-10002,-56007,"(AMETHYSTS, US << MARKET, 10002, 1, 619200)","{""AMETHYSTS"": 1, ""STARFRUIT"": 10}",4662,5067,9999
619400,-5065,-61072,"(STARFRUIT, US << MARKET, 5065, 1, 619400)","{""AMETHYSTS"": 1, ""STARFRUIT"": 11}",4676,5068,10000
619600,19996,-41076,"(AMETHYSTS, MARKET << US, 9998, 1, 619600)
(AMETHYSTS, MARKET << US, 9998, 1, 619600)","{""AMETHYSTS"": -1, ""STARFRUIT"": 11}",4686,5069,9997
620100,5070,-36006,"(STARFRUIT, MARKET << US, 5070, 1, 620100)","{""AMETHYSTS"": -1, ""STARFRUIT"": 10}",4701,5071,10003
620300,-4936,-40942,"(AMETHYSTS, US << MARKET, 10002, 1, 620300)
(STARFRUIT, MARKET << US, 5066, 1, 620300)","{""AMETHYSTS"": 0, ""STARFRUIT"": 9}",4643,5065,10003
620400,29872,-11070,"(AMETHYSTS, MARKET << US, 10004, 1, 620400)
(AMETHYSTS, MARKET << US, 10004, 1, 620400)
(AMETHYSTS, MARKET << US, 10004, 1, 620400)
(AMETHYSTS, MARKET << US, 10004, 1, 620400)
(STARFRUIT, US << MARKET, 5072, 1, 620400)
(STARFRUIT, US << MARKET, 5072, 1, 620400)","{""AMETHYSTS"": -4, ""STARFRUIT"": 11}",4678,5068,10000
620800,-5065,-16135,"(STARFRUIT, US << MARKET, 5065, 1, 620800)","{""AMETHYSTS"": -4, ""STARFRUIT"": 12}",4633,5064,10000
621600,-5064,-21199,"(STARFRUIT, US << MARKET, 5064, 1, 621600)","{""AMETHYSTS"": -4, ""STARFRUIT"": 13}",4676,5067,9999
621800,-19996,-41195,"(AMETHYSTS, US << MARKET, 9998, 1, 621800)
(AMETHYSTS, US << MARKET, 9998, 1, 621800)","{""AMETHYSTS"": -2, ""STARFRUIT"": 13}",4682,5067,9997
622100,99980,58785,"(AMETHYSTS, MARKET << US, 9998, 1, 622100)
(AMETHYSTS, MARKET << US, 9998, 1, 622100)
(AMETHYSTS, MARKET << US, 9998, 1, 622100)
(AMETHYSTS, MARKET << US, 9998, 1, 622100)
(AMETHYSTS, MARKET << US, 9998, 1, 622100)
(AMETHYSTS, MARKET << US, 9998, 1, 622100)
(AMETHYSTS, MARKET << US, 9998, 1, 622100)
(AMETHYSTS, MARKET << US, 9998, 1, 622100)
(AMETHYSTS, MARKET << US, 9998, 1, 622100)
(AMETHYSTS, MARKET << US, 9998, 1, 622100)","{""AMETHYSTS"": -12, ""STARFRUIT"": 13}",4717,5068,9996
622300,-5065,53720,"(STARFRUIT, US << MARKET, 5065, 1, 622300)","{""AMETHYSTS"": -12, ""STARFRUIT"": 14}",4672,5068,10000
622800,-20260,33460,"(STARFRUIT, US << MARKET, 5065, 1, 622800)
(STARFRUIT, US << MARKET, 5065, 1, 622800)
(STARFRUIT, US << MARKET, 5065, 1, 622800)
(STARFRUIT, US << MARKET, 5065, 1, 622800)","{""AMETHYSTS"": -12, ""STARFRUIT"": 18}",4654,5067,10001
623400,20004,53464,"(AMETHYSTS, MARKET << US, 10002, 1, 623400)
(AMETHYSTS, MARKET << US, 10002, 1, 623400)","{""AMETHYSTS"": -14, ""STARFRUIT"": 18}",4628,5067,10003
623500,-10144,43320,"(STARFRUIT, US << MARKET, 5072, 1, 623500)
(STARFRUIT, US << MARKET, 5072, 1, 623500)","{""AMETHYSTS"": -14, ""STARFRUIT"": 20}",4666,5068,10001
623600,5065,48385,"(STARFRUIT, MARKET << US, 5065, 1, 623600)","{""AMETHYSTS"": -14, ""STARFRUIT"": 19}",4677,5068,10000
623800,-5072,43313,"(STARFRUIT, US << MARKET, 5072, 1, 623800)","{""AMETHYSTS"": -14, ""STARFRUIT"": 20}",4753,5072,10000
623900,0,43313,,"{""AMETHYSTS"": -14, ""STARFRUIT"": 20}",4733,5071,10000
624100,-10002,33311,"(AMETHYSTS, US << MARKET, 10002, 1, 624100)","{""AMETHYSTS"": -13, ""STARFRUIT"": 20}",4718,5071,10001
624300,35490,68801,"(STARFRUIT, MARKET << US, 5070, 1, 624300)
(STARFRUIT, MARKET << US, 5070, 1, 624300)
(STARFRUIT, MARKET << US, 5070, 1, 624300)
(STARFRUIT, MARKET << US, 5070, 1, 624300)
(STARFRUIT, MARKET << US, 5070, 1, 624300)
(STARFRUIT, MARKET << US, 5070, 1, 624300)
(STARFRUIT, MARKET << US, 5070, 1, 624300)","{""AMETHYSTS"": -13, ""STARFRUIT"": 13}",4672,5067,10000
624400,25080,93881,"(AMETHYSTS, MARKET << US, 10004, 1, 624400)
(AMETHYSTS, MARKET << US, 10004, 1, 624400)
(STARFRUIT, MARKET << US, 5072, 1, 624400)","{""AMETHYSTS"": -15, ""STARFRUIT"": 12}",4697,5068,10000
625000,5066,98947,"(STARFRUIT, MARKET << US, 5066, 1, 625000)","{""AMETHYSTS"": -15, ""STARFRUIT"": 11}",4706,5069,10000
625600,-5072,93875,"(STARFRUIT, US << MARKET, 5072, 1, 625600)","{""AMETHYSTS"": -15, ""STARFRUIT"": 12}",4724,5072,10001
625900,40016,133891,"(AMETHYSTS, MARKET << US, 10004, 1, 625900)
(AMETHYSTS, MARKET << US, 10004, 1, 625900)
(AMETHYSTS, MARKET << US, 10004, 1, 625900)
(AMETHYSTS, MARKET << US, 10004, 1, 625900)","{""AMETHYSTS"": -19, ""STARFRUIT"": 12}",4719,5069,10000
626200,-19996,113895,"(AMETHYSTS, US << MARKET, 9998, 1, 626200)
(AMETHYSTS, US << MARKET, 9998, 1, 626200)","{""AMETHYSTS"": -17, ""STARFRUIT"": 12}",4815,5071,9996
626400,5068,118963,"(STARFRUIT, MARKET << US, 5068, 1, 626400)","{""AMETHYSTS"": -17, ""STARFRUIT"": 11}",4700,5067,10000
626700,-30148,88815,"(AMETHYSTS, US << MARKET, 9998, 1, 626700)
(AMETHYSTS, US << MARKET, 9998, 1, 626700)
(STARFRUIT, US << MARKET, 5076, 1, 626700)
(STARFRUIT, US << MARKET, 5076, 1, 626700)
(STARFRUIT, US << MARKET, 5076, 1, 626700)
(STARFRUIT, US << MARKET, 5076, 1, 626700)
(STARFRUIT, MARKET << US, 5076, 1, 626700)
(STARFRUIT, MARKET << US, 5076, 1, 626700)","{""AMETHYSTS"": -15, ""STARFRUIT"": 13}",4809,5073,9997
627200,50010,138825,"(AMETHYSTS, MARKET << US, 10002, 1, 627200)
(AMETHYSTS, MARKET << US, 10002, 1, 627200)
(AMETHYSTS, MARKET << US, 10002, 1, 627200)
(AMETHYSTS, MARKET << US, 10002, 1, 627200)
(AMETHYSTS, MARKET << US, 10002, 1, 627200)","{""AMETHYSTS"": -20, ""STARFRUIT"": 13}",4794,5073,9999
627300,-5077,133748,"(STARFRUIT, US << MARKET, 5077, 1, 627300)","{""AMETHYSTS"": -20, ""STARFRUIT"": 14}",4784,5074,10000
627500,5076,138824,"(STARFRUIT, MARKET << US, 5076, 1, 627500)","{""AMETHYSTS"": -20, ""STARFRUIT"": 13}",4760,5072,10000
627600,0,138824,,"{""AMETHYSTS"": -20, ""STARFRUIT"": 13}",4780,5072,9999
627700,-4927,133897,"(AMETHYSTS, US << MARKET, 10002, 1, 627700)
(STARFRUIT, MARKET << US, 5075, 1, 627700)","{""AMETHYSTS"": -19, ""STARFRUIT"": 12}",4752,5076,10003
627800,5069,138966,"(STARFRUIT, MARKET << US, 5069, 1, 627800)","{""AMETHYSTS"": -19, ""STARFRUIT"": 11}",4701,5072,10003
628200,9998,148964,"(AMETHYSTS, MARKET << US, 9998, 1, 628200)","{""AMETHYSTS"": -20, ""STARFRUIT"": 11}",4827,5073,9997
628400,0,148964,,"{""AMETHYSTS"": -20, ""STARFRUIT"": 11}",4765,5071,9999
629000,5070,154034,"(STARFRUIT, MARKET << US, 5070, 1, 629000)","{""AMETHYSTS"": -20, ""STARFRUIT"": 10}",4734,5072,10001
629100,-20292,133742,"(STARFRUIT, US << MARKET, 5073, 1, 629100)
(STARFRUIT, US << MARKET, 5073, 1, 629100)
(STARFRUIT, US << MARKET, 5073, 1, 629100)
(STARFRUIT, US << MARKET, 5073, 1, 629100)","{""AMETHYSTS"": -20, ""STARFRUIT"": 14}",4810,5072,9997
629300,-60292,73450,"(AMETHYSTS, US << MARKET, 10002, 1, 629300)
(AMETHYSTS, US << MARKET, 10002, 1, 629300)
(AMETHYSTS, US << MARKET, 10002, 1, 629300)
(AMETHYSTS, US << MARKET, 10002, 1, 629300)
(STARFRUIT, US << MARKET, 5071, 1, 629300)
(STARFRUIT, US << MARKET, 5071, 1, 629300)
(STARFRUIT, US << MARKET, 5071, 1, 629300)
(STARFRUIT, US << MARKET, 5071, 1, 629300)","{""AMETHYSTS"": -16, ""STARFRUIT"": 18}",4734,5074,10003
629400,-25062,48388,"(AMETHYSTS, US << MARKET, 9995, 1, 629400)
(AMETHYSTS, US << MARKET, 9995, 1, 629400)
(STARFRUIT, US << MARKET, 5072, 1, 629400)","{""AMETHYSTS"": -14, ""STARFRUIT"": 19}",4813,5075,10000
629500,-19996,28392,"(AMETHYSTS, US << MARKET, 9998, 1, 629500)
(AMETHYSTS, US << MARKET, 9998, 1, 629500)","{""AMETHYSTS"": -12, ""STARFRUIT"": 19}",4743,5073,10003
629600,-94909,-66517,"(AMETHYSTS, US << MARKET, 9998, 1, 629600)
(AMETHYSTS, US << MARKET, 9998, 1, 629600)
(AMETHYSTS, US << MARKET, 9998, 1, 629600)
(AMETHYSTS, US << MARKET, 9998, 1, 629600)
(AMETHYSTS, US << MARKET, 9998, 1, 629600)
(AMETHYSTS, US << MARKET, 9998, 1, 629600)
(AMETHYSTS, US << MARKET, 9998, 1, 629600)
(AMETHYSTS, US << MARKET, 9998, 1, 629600)
(AMETHYSTS, US << MARKET, 9998, 1, 629600)
(AMETHYSTS, US << MARKET, 9998, 1, 629600)
(STARFRUIT, MARKET << US, 5071, 1, 629600)","{""AMETHYSTS"": -2, ""STARFRUIT"": 18}",4823,5074,9996
629800,-5070,-71587,"(STARFRUIT, US << MARKET, 5070, 1, 629800)","{""AMETHYSTS"": -2, ""STARFRUIT"": 19}",4804,5073,9998
629900,5071,-66516,"(STARFRUIT, MARKET << US, 5071, 1, 629900)","{""AMETHYSTS"": -2, ""STARFRUIT"": 18}",4814,5074,10001
630100,-10142,-76658,"(STARFRUIT, US << MARKET, 5071, 1, 630100)
(STARFRUIT, US << MARKET, 5071, 1, 630100)","{""AMETHYSTS"": -2, ""STARFRUIT"": 20}",4820,5074,10001
630300,-10002,-86660,"(AMETHYSTS, US << MARKET, 10002, 1, 630300)","{""AMETHYSTS"": -1, ""STARFRUIT"": 20}",4821,5074,9999
630400,-19996,-106656,"(AMETHYSTS, US << MARKET, 9998, 1, 630400)
(AMETHYSTS, US << MARKET, 9998, 1, 630400)","{""AMETHYSTS"": 1, ""STARFRUIT"": 20}",4841,5075,9997
630500,25080,-81576,"(AMETHYSTS, MARKET << US, 10002, 1, 630500)
(AMETHYSTS, MARKET << US, 10002, 1, 630500)
(STARFRUIT, MARKET << US, 5076, 1, 630500)","{""AMETHYSTS"": -1, ""STARFRUIT"": 19}",4812,5073,9999
630900,-5074,-86650,"(STARFRUIT, US << MARKET, 5074, 1, 630900)","{""AMETHYSTS"": -1, ""STARFRUIT"": 20}",4810,5073,10000
631300,10148,-76502,"(STARFRUIT, MARKET << US, 5074, 1, 631300)
(STARFRUIT, MARKET << US, 5074, 1, 631300)","{""AMETHYSTS"": -1, ""STARFRUIT"": 18}",4813,5073,9999
631400,-15083,-91585,"(AMETHYSTS, US << MARKET, 10004, 1, 631400)
(STARFRUIT, US << MARKET, 5079, 1, 631400)","{""AMETHYSTS"": 0, ""STARFRUIT"": 19}",4840,5075,10001
631500,-5072,-96657,"(STARFRUIT, US << MARKET, 5072, 1, 631500)","{""AMETHYSTS"": 0, ""STARFRUIT"": 20}",4843,5075,10000
631600,0,-96657,,"{""AMETHYSTS"": 0, ""STARFRUIT"": 20}",4883,5077,10001
631700,-94879,-191536,"(AMETHYSTS, US << MARKET, 9995, 1, 631700)
(AMETHYSTS, US << MARKET, 9995, 1, 631700)
(AMETHYSTS, US << MARKET, 9995, 1, 631700)
(AMETHYSTS, US << MARKET, 9995, 1, 631700)
(AMETHYSTS, US << MARKET, 9995, 1, 631700)
(AMETHYSTS, US << MARKET, 9995, 1, 631700)
(AMETHYSTS, US << MARKET, 9995, 1, 631700)
(AMETHYSTS, US << MARKET, 9995, 1, 631700)
(AMETHYSTS, US << MARKET, 9995, 1, 631700)
(AMETHYSTS, US << MARKET, 9995, 1, 631700)
(STARFRUIT, MARKET << US, 5071, 1, 631700)","{""AMETHYSTS"": 10, ""STARFRUIT"": 19}",4851,5073,10000
632400,20636,-170900,"(AMETHYSTS, US << MARKET, 9998, 1, 632400)
(AMETHYSTS, US << MARKET, 9998, 1, 632400)
(STARFRUIT, US << MARKET, 5079, 1, 632400)
(STARFRUIT, MARKET << US, 5079, 1, 632400)
(STARFRUIT, MARKET << US, 5079, 1, 632400)
(STARFRUIT, MARKET << US, 5079, 1, 632400)
(STARFRUIT, MARKET << US, 5079, 1, 632400)
(STARFRUIT, MARKET << US, 5079, 1, 632400)
(STARFRUIT, MARKET << US, 5079, 1, 632400)
(STARFRUIT, MARKET << US, 5079, 1, 632400)
(STARFRUIT, MARKET << US, 5079, 1, 632400)
(STARFRUIT, MARKET << US, 5079, 1, 632400)","{""AMETHYSTS"": 12, ""STARFRUIT"": 11}",4900,5076,9997
632700,9998,-160902,"(AMETHYSTS, MARKET << US, 9998, 1, 632700)","{""AMETHYSTS"": 11, ""STARFRUIT"": 11}",4934,5075,10001
632900,20140,-140762,"(AMETHYSTS, MARKET << US, 9996, 1, 632900)
(STARFRUIT, MARKET << US, 5072, 1, 632900)
(STARFRUIT, MARKET << US, 5072, 1, 632900)","{""AMETHYSTS"": 10, ""STARFRUIT"": 9}",4903,5075,9999
633100,10148,-130614,"(STARFRUIT, MARKET << US, 5074, 1, 633100)
(STARFRUIT, MARKET << US, 5074, 1, 633100)","{""AMETHYSTS"": 10, ""STARFRUIT"": 7}",4887,5073,9999
633400,-5079,-135693,"(STARFRUIT, US << MARKET, 5079, 1, 633400)","{""AMETHYSTS"": 10, ""STARFRUIT"": 8}",4947,5080,10000
633500,24911,-110782,"(AMETHYSTS, MARKET << US, 9995, 1, 633500)
(AMETHYSTS, MARKET << US, 9995, 1, 633500)
(AMETHYSTS, MARKET << US, 9995, 1, 633500)
(STARFRUIT, US << MARKET, 5074, 1, 633500)","{""AMETHYSTS"": 7, ""STARFRUIT"": 9}",4911,5077,10000
633700,5079,-105703,"(STARFRUIT, MARKET << US, 5079, 1, 633700)","{""AMETHYSTS"": 7, ""STARFRUIT"": 8}",4915,5079,9998
633800,5078,-100625,"(STARFRUIT, MARKET << US, 5078, 1, 633800)","{""AMETHYSTS"": 7, ""STARFRUIT"": 7}",4928,5078,10001
633900,25390,-75235,"(STARFRUIT, MARKET << US, 5078, 1, 633900)
(STARFRUIT, MARKET << US, 5078, 1, 633900)
(STARFRUIT, MARKET << US, 5078, 1, 633900)
(STARFRUIT, MARKET << US, 5078, 1, 633900)
(STARFRUIT, MARKET << US, 5078, 1, 633900)","{""AMETHYSTS"": 7, ""STARFRUIT"": 2}",4923,5079,10000
634100,-10146,-85381,"(STARFRUIT, US << MARKET, 5073, 1, 634100)
(STARFRUIT, US << MARKET, 5073, 1, 634100)","{""AMETHYSTS"": 7, ""STARFRUIT"": 4}",4907,5072,10000
634200,20316,-65065,"(STARFRUIT, MARKET << US, 5079, 1, 634200)
(STARFRUIT, MARKET << US, 5079, 1, 634200)
(STARFRUIT, MARKET << US, 5079, 1, 634200)
(STARFRUIT, MARKET << US, 5079, 1, 634200)","{""AMETHYSTS"": 7, ""STARFRUIT"": 0}",4935,5076,10000
634400,25083,-39982,"(AMETHYSTS, MARKET << US, 10002, 1, 634400)
(AMETHYSTS, MARKET << US, 10002, 1, 634400)
(STARFRUIT, MARKET << US, 5079, 1, 634400)","{""AMETHYSTS"": 5, ""STARFRUIT"": -1}",4933,5075,9998
634900,-25380,-65362,"(STARFRUIT, US << MARKET, 5076, 1, 634900)
(STARFRUIT, US << MARKET, 5076, 1, 634900)
(STARFRUIT, US << MARKET, 5076, 1, 634900)
(STARFRUIT, US << MARKET, 5076, 1, 634900)
(STARFRUIT, US << MARKET, 5076, 1, 634900)","{""AMETHYSTS"": 5, ""STARFRUIT"": 4}",4929,5074,9999
635000,-8,-65370,"(AMETHYSTS, US << MARKET, 10005, 1, 635000)
(AMETHYSTS, US << MARKET, 10005, 1, 635000)
(AMETHYSTS, MARKET << US, 9995, 1, 635000)
(AMETHYSTS, MARKET << US, 9995, 1, 635000)
(STARFRUIT, US << MARKET, 5074, 1, 635000)
(STARFRUIT, US << MARKET, 5074, 1, 635000)
(STARFRUIT, MARKET << US, 5080, 1, 635000)
(STARFRUIT, MARKET << US, 5080, 1, 635000)","{""AMETHYSTS"": 5, ""STARFRUIT"": 4}",4938,5077,10000
635600,59976,-5394,"(AMETHYSTS, MARKET << US, 9996, 1, 635600)
(AMETHYSTS, MARKET << US, 9996, 1, 635600)
(AMETHYSTS, MARKET << US, 9996, 1, 635600)
(AMETHYSTS, MARKET << US, 9996, 1, 635600)
(AMETHYSTS, MARKET << US, 9996, 1, 635600)
(AMETHYSTS, MARKET << US, 9996, 1, 635600)","{""AMETHYSTS"": -1, ""STARFRUIT"": 4}",4918,5078,10000
635700,-34928,-40322,"(AMETHYSTS, US << MARKET, 10002, 1, 635700)
(AMETHYSTS, US << MARKET, 10002, 1, 635700)
(AMETHYSTS, US << MARKET, 10002, 1, 635700)
(AMETHYSTS, US << MARKET, 10002, 1, 635700)
(STARFRUIT, MARKET << US, 5080, 1, 635700)","{""AMETHYSTS"": 3, ""STARFRUIT"": 3}",4927,5080,10003
636000,-5079,-45401,"(STARFRUIT, US << MARKET, 5079, 1, 636000)
(STARFRUIT, US << MARKET, 5079, 1, 636000)
(STARFRUIT, US << MARKET, 5079, 1, 636000)
(STARFRUIT, US << MARKET, 5079, 1, 636000)
(STARFRUIT, US << MARKET, 5079, 1, 636000)
(STARFRUIT, MARKET << US, 5079, 1, 636000)
(STARFRUIT, MARKET << US, 5079, 1, 636000)
(STARFRUIT, MARKET << US, 5079, 1, 636000)
(STARFRUIT, MARKET << US, 5079, 1, 636000)","{""AMETHYSTS"": 3, ""STARFRUIT"": 4}",4903,5076,10000
636300,5080,-40321,"(STARFRUIT, MARKET << US, 5080, 1, 636300)","{""AMETHYSTS"": 3, ""STARFRUIT"": 3}",4913,5080,9998
636500,-10150,-50471,"(STARFRUIT, US << MARKET, 5075, 1, 636500)
(STARFRUIT, US << MARKET, 5075, 1, 636500)","{""AMETHYSTS"": 3, ""STARFRUIT"": 5}",4914,5077,10000
636700,25091,-25380,"(AMETHYSTS, MARKET << US, 10005, 1, 636700)
(AMETHYSTS, MARKET << US, 10005, 1, 636700)
(STARFRUIT, MARKET << US, 5081, 1, 636700)","{""AMETHYSTS"": 1, ""STARFRUIT"": 4}",4928,5077,10000
637200,40016,14636,"(AMETHYSTS, MARKET << US, 10004, 1, 637200)
(AMETHYSTS, MARKET << US, 10004, 1, 637200)
(AMETHYSTS, MARKET << US, 10004, 1, 637200)
(AMETHYSTS, MARKET << US, 10004, 1, 637200)","{""AMETHYSTS"": -3, ""STARFRUIT"": 4}",4944,5077,10000
637500,-19996,-5360,"(AMETHYSTS, US << MARKET, 9998, 1, 637500)
(AMETHYSTS, US << MARKET, 9998, 1, 637500)","{""AMETHYSTS"": -1, ""STARFRUIT"": 4}",4951,5077,9997
637600,-80040,-85400,"(AMETHYSTS, US << MARKET, 10005, 1, 637600)
(AMETHYSTS, US << MARKET, 10005, 1, 637600)
(AMETHYSTS, US << MARKET, 10005, 1, 637600)
(AMETHYSTS, US << MARKET, 10005, 1, 637600)
(AMETHYSTS, US << MARKET, 10005, 1, 637600)
(AMETHYSTS, US << MARKET, 10005, 1, 637600)
(AMETHYSTS, US << MARKET, 10005, 1, 637600)
(AMETHYSTS, US << MARKET, 10005, 1, 637600)","{""AMETHYSTS"": 7, ""STARFRUIT"": 4}",4911,5076,10001
638400,-20280,-105680,"(STARFRUIT, US << MARKET, 5070, 1, 638400)
(STARFRUIT, US << MARKET, 5070, 1, 638400)
(STARFRUIT, US << MARKET, 5070, 1, 638400)
(STARFRUIT, US << MARKET, 5070, 1, 638400)","{""AMETHYSTS"": 7, ""STARFRUIT"": 8}",4904,5073,10000
638600,-14934,-120614,"(AMETHYSTS, US << MARKET, 10002, 1, 638600)
(AMETHYSTS, US << MARKET, 10002, 1, 638600)
(AMETHYSTS, US << MARKET, 10002, 1, 638600)
(AMETHYSTS, US << MARKET, 10002, 1, 638600)
(AMETHYSTS, MARKET << US, 10002, 1, 638600)
(AMETHYSTS, MARKET << US, 10002, 1, 638600)
(STARFRUIT, MARKET << US, 5070, 1, 638600)","{""AMETHYSTS"": 9, ""STARFRUIT"": 7}",4917,5072,10003
638700,9842,-110772,"(AMETHYSTS, MARKET << US, 9998, 1, 638700)
(AMETHYSTS, MARKET << US, 9998, 1, 638700)
(STARFRUIT, US << MARKET, 5077, 1, 638700)
(STARFRUIT, US << MARKET, 5077, 1, 638700)","{""AMETHYSTS"": 7, ""STARFRUIT"": 9}",4864,5073,9997
638800,20004,-90768,"(AMETHYSTS, MARKET << US, 10002, 1, 638800)
(AMETHYSTS, MARKET << US, 10002, 1, 638800)","{""AMETHYSTS"": 5, ""STARFRUIT"": 9}",4904,5073,10003
639100,25370,-65398,"(STARFRUIT, MARKET << US, 5074, 1, 639100)
(STARFRUIT, MARKET << US, 5074, 1, 639100)
(STARFRUIT, MARKET << US, 5074, 1, 639100)
(STARFRUIT, MARKET << US, 5074, 1, 639100)
(STARFRUIT, MARKET << US, 5074, 1, 639100)","{""AMETHYSTS"": 5, ""STARFRUIT"": 4}",4902,5075,10000
639600,40008,-25390,"(AMETHYSTS, MARKET << US, 10002, 1, 639600)
(AMETHYSTS, MARKET << US, 10002, 1, 639600)
(AMETHYSTS, MARKET << US, 10002, 1, 639600)
(AMETHYSTS, MARKET << US, 10002, 1, 639600)","{""AMETHYSTS"": 1, ""STARFRUIT"": 4}",4911,5076,9997
639800,-55190,-80580,"(AMETHYSTS, US << MARKET, 9995, 1, 639800)
(AMETHYSTS, US << MARKET, 9995, 1, 639800)
(AMETHYSTS, US << MARKET, 9995, 1, 639800)
(AMETHYSTS, US << MARKET, 9995, 1, 639800)
(STARFRUIT, US << MARKET, 5070, 1, 639800)
(STARFRUIT, US << MARKET, 5070, 1, 639800)
(STARFRUIT, US << MARKET, 5070, 1, 639800)","{""AMETHYSTS"": 5, ""STARFRUIT"": 7}",4931,5073,10000
640600,-75059,-155639,"(AMETHYSTS, US << MARKET, 9998, 1, 640600)
(AMETHYSTS, US << MARKET, 9998, 1, 640600)
(AMETHYSTS, US << MARKET, 9998, 1, 640600)
(AMETHYSTS, US << MARKET, 9998, 1, 640600)
(AMETHYSTS, US << MARKET, 9998, 1, 640600)
(AMETHYSTS, US << MARKET, 9998, 1, 640600)
(AMETHYSTS, US << MARKET, 9998, 1, 640600)
(AMETHYSTS, US << MARKET, 9998, 1, 640600)
(AMETHYSTS, MARKET << US, 9996, 1, 640600)
(STARFRUIT, US << MARKET, 5071, 1, 640600)","{""AMETHYSTS"": 12, ""STARFRUIT"": 8}",4917,5074,9997
641000,-5071,-160710,"(STARFRUIT, US << MARKET, 5071, 1, 641000)","{""AMETHYSTS"": 12, ""STARFRUIT"": 9}",4956,5074,10000
641500,-5070,-165780,"(STARFRUIT, US << MARKET, 5070, 1, 641500)","{""AMETHYSTS"": 12, ""STARFRUIT"": 10}",4950,5073,10000
642300,-5071,-170851,"(STARFRUIT, US << MARKET, 5071, 1, 642300)","{""AMETHYSTS"": 12, ""STARFRUIT"": 11}",4919,5070,10000
642400,-5070,-175921,"(STARFRUIT, US << MARKET, 5070, 1, 642400)","{""AMETHYSTS"": 12, ""STARFRUIT"": 12}",4955,5073,10000
642600,-5070,-180991,"(STARFRUIT, US << MARKET, 5070, 1, 642600)","{""AMETHYSTS"": 12, ""STARFRUIT"": 13}",4958,5073,10000
642700,-14921,-195912,"(AMETHYSTS, US << MARKET, 9995, 1, 642700)
(AMETHYSTS, US << MARKET, 9995, 1, 642700)
(STARFRUIT, MARKET << US, 5069, 1, 642700)","{""AMETHYSTS"": 14, ""STARFRUIT"": 12}",4952,5072,10000
643100,-20288,-216200,"(STARFRUIT, US << MARKET, 5072, 1, 643100)
(STARFRUIT, US << MARKET, 5072, 1, 643100)
(STARFRUIT, US << MARKET, 5072, 1, 643100)
(STARFRUIT, US << MARKET, 5072, 1, 643100)","{""AMETHYSTS"": 14, ""STARFRUIT"": 16}",4878,5070,9997
643400,5070,-211130,"(STARFRUIT, MARKET << US, 5070, 1, 643400)","{""AMETHYSTS"": 14, ""STARFRUIT"": 15}",4965,5073,10000
643600,-20004,-231134,"(AMETHYSTS, US << MARKET, 10002, 1, 643600)
(AMETHYSTS, US << MARKET, 10002, 1, 643600)","{""AMETHYSTS"": 16, ""STARFRUIT"": 15}",4994,5072,10003
644100,20004,-211130,"(AMETHYSTS, MARKET << US, 10002, 1, 644100)
(AMETHYSTS, MARKET << US, 10002, 1, 644100)","{""AMETHYSTS"": 14, ""STARFRUIT"": 15}",4992,5072,10003
644300,-20272,-231402,"(STARFRUIT, US << MARKET, 5068, 1, 644300)
(STARFRUIT, US << MARKET, 5068, 1, 644300)
(STARFRUIT, US << MARKET, 5068, 1, 644300)
(STARFRUIT, US << MARKET, 5068, 1, 644300)","{""AMETHYSTS"": 14, ""STARFRUIT"": 19}",4947,5071,10000
644400,-5069,-236471,"(STARFRUIT, US << MARKET, 5069, 1, 644400)","{""AMETHYSTS"": 14, ""STARFRUIT"": 20}",4903,5068,10001
644500,9996,-226475,"(AMETHYSTS, MARKET << US, 9996, 1, 644500)","{""AMETHYSTS"": 13, ""STARFRUIT"": 20}",4992,5074,9999
644600,0,-226475,,"{""AMETHYSTS"": 13, ""STARFRUIT"": 20}",4945,5071,10000
644700,-59988,-286463,"(AMETHYSTS, US << MARKET, 9998, 1, 644700)
(AMETHYSTS, US << MARKET, 9998, 1, 644700)
(AMETHYSTS, US << MARKET, 9998, 1, 644700)
(AMETHYSTS, US << MARKET, 9998, 1, 644700)
(AMETHYSTS, US << MARKET, 9998, 1, 644700)
(AMETHYSTS, US << MARKET, 9998, 1, 644700)","{""AMETHYSTS"": 19, ""STARFRUIT"": 20}",4880,5070,9997
645500,5067,-281396,"(STARFRUIT, MARKET << US, 5067, 1, 645500)","{""AMETHYSTS"": 19, ""STARFRUIT"": 19}",4820,5068,9996
645800,-4932,-286328,"(AMETHYSTS, US << MARKET, 10004, 1, 645800)
(STARFRUIT, MARKET << US, 5072, 1, 645800)","{""AMETHYSTS"": 20, ""STARFRUIT"": 18}",4934,5069,10001
645900,-5072,-291400,"(STARFRUIT, US << MARKET, 5072, 1, 645900)","{""AMETHYSTS"": 20, ""STARFRUIT"": 19}",5047,5073,10003
646000,0,-291400,,"{""AMETHYSTS"": 20, ""STARFRUIT"": 19}",4930,5070,10000
646100,0,-291400,,"{""AMETHYSTS"": 20, ""STARFRUIT"": 19}",4990,5070,10003
646500,-5064,-296464,"(STARFRUIT, US << MARKET, 5064, 1, 646500)","{""AMETHYSTS"": 20, ""STARFRUIT"": 20}",4896,5068,10000
647000,50704,-245760,"(STARFRUIT, MARKET << US, 5071, 1, 647000)
(STARFRUIT, MARKET << US, 5071, 1, 647000)
(STARFRUIT, MARKET << US, 5071, 1, 647000)
(STARFRUIT, MARKET << US, 5071, 1, 647000)
(STARFRUIT, MARKET << US, 5071, 1, 647000)
(STARFRUIT, MARKET << US, 5071, 1, 647000)
(STARFRUIT, MARKET << US, 5071, 1, 647000)
(STARFRUIT, MARKET << US, 5071, 1, 647000)
(STARFRUIT, MARKET << US, 5068, 1, 647000)
(STARFRUIT, MARKET << US, 5068, 1, 647000)","{""AMETHYSTS"": 20, ""STARFRUIT"": 10}",4950,5069,10001
647100,30420,-215340,"(STARFRUIT, MARKET << US, 5070, 1, 647100)
(STARFRUIT, MARKET << US, 5070, 1, 647100)
(STARFRUIT, MARKET << US, 5070, 1, 647100)
(STARFRUIT, MARKET << US, 5070, 1, 647100)
(STARFRUIT, MARKET << US, 5070, 1, 647100)
(STARFRUIT, MARKET << US, 5070, 1, 647100)","{""AMETHYSTS"": 20, ""STARFRUIT"": 4}",4928,5067,10000
647800,5070,-210270,"(STARFRUIT, MARKET << US, 5070, 1, 647800)","{""AMETHYSTS"": 20, ""STARFRUIT"": 3}",4920,5070,9999
647900,-20276,-230546,"(STARFRUIT, US << MARKET, 5069, 1, 647900)
(STARFRUIT, US << MARKET, 5069, 1, 647900)
(STARFRUIT, US << MARKET, 5069, 1, 647900)
(STARFRUIT, US << MARKET, 5069, 1, 647900)","{""AMETHYSTS"": 20, ""STARFRUIT"": 7}",4944,5070,10000
648100,9998,-220548,"(AMETHYSTS, MARKET << US, 9998, 1, 648100)","{""AMETHYSTS"": 19, ""STARFRUIT"": 7}",4954,5069,10001
648300,-5065,-225613,"(STARFRUIT, US << MARKET, 5065, 1, 648300)","{""AMETHYSTS"": 19, ""STARFRUIT"": 8}",4931,5068,10000
648600,-15068,-240681,"(AMETHYSTS, US << MARKET, 10000, 1, 648600)
(STARFRUIT, US << MARKET, 5068, 1, 648600)","{""AMETHYSTS"": 20, ""STARFRUIT"": 9}",4980,5069,10002
648800,4932,-235749,"(AMETHYSTS, MARKET << US, 9998, 1, 648800)
(STARFRUIT, US << MARKET, 5066, 1, 648800)","{""AMETHYSTS"": 19, ""STARFRUIT"": 10}",4920,5065,10001
648900,-5071,-240820,"(STARFRUIT, US << MARKET, 5071, 1, 648900)","{""AMETHYSTS"": 19, ""STARFRUIT"": 11}",4961,5071,10000
649100,5071,-235749,"(STARFRUIT, MARKET << US, 5071, 1, 649100)","{""AMETHYSTS"": 19, ""STARFRUIT"": 10}",4961,5071,10000
649200,20434,-215315,"(AMETHYSTS, US << MARKET, 9998, 1, 649200)
(STARFRUIT, MARKET << US, 5072, 1, 649200)
(STARFRUIT, MARKET << US, 5072, 1, 649200)
(STARFRUIT, MARKET << US, 5072, 1, 649200)
(STARFRUIT, MARKET << US, 5072, 1, 649200)
(STARFRUIT, MARKET << US, 5072, 1, 649200)
(STARFRUIT, MARKET << US, 5072, 1, 649200)","{""AMETHYSTS"": 20, ""STARFRUIT"": 4}",4977,5068,10001
649300,-5064,-220379,"(STARFRUIT, US << MARKET, 5065, 1, 649300)
(STARFRUIT, US << MARKET, 5065, 1, 649300)
(STARFRUIT, MARKET << US, 5066, 1, 649300)","{""AMETHYSTS"": 20, ""STARFRUIT"": 5}",4946,5065,10000
649500,0,-220379,,"{""AMETHYSTS"": 20, ""STARFRUIT"": 5}",4901,5068,9997
649600,-20268,-240647,"(STARFRUIT, US << MARKET, 5067, 1, 649600)
(STARFRUIT, US << MARKET, 5067, 1, 649600)
(STARFRUIT, US << MARKET, 5067, 1, 649600)
(STARFRUIT, US << MARKET, 5067, 1, 649600)","{""AMETHYSTS"": 20, ""STARFRUIT"": 9}",4878,5065,9997
649900,5066,-235581,"(STARFRUIT, MARKET << US, 5066, 1, 649900)","{""AMETHYSTS"": 20, ""STARFRUIT"": 8}",4939,5065,10000
650500,5072,-230509,"(STARFRUIT, MARKET << US, 5072, 1, 650500)","{""AMETHYSTS"": 20, ""STARFRUIT"": 7}",4894,5069,9996
650800,9996,-220513,"(AMETHYSTS, MARKET << US, 9996, 1, 650800)","{""AMETHYSTS"": 19, ""STARFRUIT"": 7}",4958,5070,9999
651000,-10002,-230515,"(AMETHYSTS, US << MARKET, 10002, 1, 651000)","{""AMETHYSTS"": 20, ""STARFRUIT"": 7}",5035,5070,10003
651100,0,-230515,,"{""AMETHYSTS"": 20, ""STARFRUIT"": 7}",4888,5069,9996
651500,25340,-205175,"(STARFRUIT, MARKET << US, 5068, 1, 651500)
(STARFRUIT, MARKET << US, 5068, 1, 651500)
(STARFRUIT, MARKET << US, 5068, 1, 651500)
(STARFRUIT, MARKET << US, 5068, 1, 651500)
(STARFRUIT, MARKET << US, 5068, 1, 651500)","{""AMETHYSTS"": 20, ""STARFRUIT"": 2}",4907,5071,9997
651600,-10136,-215311,"(STARFRUIT, US << MARKET, 5068, 1, 651600)
(STARFRUIT, US << MARKET, 5068, 1, 651600)","{""AMETHYSTS"": 20, ""STARFRUIT"": 4}",4973,5071,10000
651900,-15219,-230530,"(STARFRUIT, US << MARKET, 5073, 1, 651900)
(STARFRUIT, US << MARKET, 5073, 1, 651900)
(STARFRUIT, US << MARKET, 5073, 1, 651900)","{""AMETHYSTS"": 20, ""STARFRUIT"": 7}",4960,5070,10000
652100,0,-230530,,"{""AMETHYSTS"": 20, ""STARFRUIT"": 7}",4953,5069,10000
652200,49990,-180540,"(AMETHYSTS, MARKET << US, 9998, 1, 652200)
(AMETHYSTS, MARKET << US, 9998, 1, 652200)
(AMETHYSTS, MARKET << US, 9998, 1, 652200)
(AMETHYSTS, MARKET << US, 9998, 1, 652200)
(AMETHYSTS, MARKET << US, 9998, 1, 652200)","{""AMETHYSTS"": 15, ""STARFRUIT"": 7}",4905,5070,9997
652700,-14929,-195469,"(AMETHYSTS, US << MARKET, 9998, 1, 652700)
(AMETHYSTS, US << MARKET, 9998, 1, 652700)
(STARFRUIT, MARKET << US, 5067, 1, 652700)","{""AMETHYSTS"": 17, ""STARFRUIT"": 6}",4877,5069,9996
652900,100020,-95449,"(AMETHYSTS, MARKET << US, 10002, 1, 652900)
(AMETHYSTS, MARKET << US, 10002, 1, 652900)
(AMETHYSTS, MARKET << US, 10002, 1, 652900)
(AMETHYSTS, MARKET << US, 10002, 1, 652900)
(AMETHYSTS, MARKET << US, 10002, 1, 652900)
(AMETHYSTS, MARKET << US, 10002, 1, 652900)
(AMETHYSTS, MARKET << US, 10002, 1, 652900)
(AMETHYSTS, MARKET << US, 10002, 1, 652900)
(AMETHYSTS, MARKET << US, 10002, 1, 652900)
(AMETHYSTS, MARKET << US, 10002, 1, 652900)","{""AMETHYSTS"": 7, ""STARFRUIT"": 6}",4986,5069,10003
653000,25340,-70109,"(STARFRUIT, MARKET << US, 5072, 1, 653000)
(STARFRUIT, MARKET << US, 5067, 1, 653000)
(STARFRUIT, MARKET << US, 5067, 1, 653000)
(STARFRUIT, MARKET << US, 5067, 1, 653000)
(STARFRUIT, MARKET << US, 5067, 1, 653000)","{""AMETHYSTS"": 7, ""STARFRUIT"": 1}",4960,5069,10000
653200,9998,-60111,"(AMETHYSTS, MARKET << US, 9998, 1, 653200)","{""AMETHYSTS"": 6, ""STARFRUIT"": 1}",4941,5070,9997
653600,40016,-20095,"(AMETHYSTS, MARKET << US, 10004, 1, 653600)
(AMETHYSTS, MARKET << US, 10004, 1, 653600)
(AMETHYSTS, MARKET << US, 10004, 1, 653600)
(AMETHYSTS, MARKET << US, 10004, 1, 653600)","{""AMETHYSTS"": 2, ""STARFRUIT"": 1}",4977,5072,10000
654000,40016,19921,"(AMETHYSTS, MARKET << US, 10004, 1, 654000)
(AMETHYSTS, MARKET << US, 10004, 1, 654000)
(AMETHYSTS, MARKET << US, 10004, 1, 654000)
(AMETHYSTS, MARKET << US, 10004, 1, 654000)","{""AMETHYSTS"": -2, ""STARFRUIT"": 1}",4987,5066,10000
654100,-10130,9791,"(STARFRUIT, US << MARKET, 5065, 1, 654100)
(STARFRUIT, US << MARKET, 5065, 1, 654100)","{""AMETHYSTS"": -2, ""STARFRUIT"": 3}",4995,5068,10000
654200,14811,24602,"(AMETHYSTS, US << MARKET, 10002, 1, 654200)
(AMETHYSTS, MARKET << US, 10002, 1, 654200)
(AMETHYSTS, MARKET << US, 10002, 1, 654200)
(AMETHYSTS, MARKET << US, 10002, 1, 654200)
(AMETHYSTS, MARKET << US, 10002, 1, 654200)
(STARFRUIT, US << MARKET, 5065, 1, 654200)
(STARFRUIT, US << MARKET, 5065, 1, 654200)
(STARFRUIT, US << MARKET, 5065, 1, 654200)","{""AMETHYSTS"": -5, ""STARFRUIT"": 6}",4995,5068,10003
654300,25074,49676,"(AMETHYSTS, MARKET << US, 10002, 1, 654300)
(AMETHYSTS, MARKET << US, 10002, 1, 654300)
(STARFRUIT, MARKET << US, 5070, 1, 654300)","{""AMETHYSTS"": -7, ""STARFRUIT"": 5}",5010,5071,10003
654700,-39936,9740,"(AMETHYSTS, US << MARKET, 9996, 1, 654700)
(AMETHYSTS, US << MARKET, 9996, 1, 654700)
(AMETHYSTS, US << MARKET, 9996, 1, 654700)
(AMETHYSTS, US << MARKET, 9996, 1, 654700)
(AMETHYSTS, US << MARKET, 9996, 1, 654700)
(AMETHYSTS, US << MARKET, 9996, 1, 654700)
(AMETHYSTS, US << MARKET, 9996, 1, 654700)
(AMETHYSTS, US << MARKET, 9996, 1, 654700)
(AMETHYSTS, US << MARKET, 9996, 1, 654700)
(AMETHYSTS, US << MARKET, 9996, 1, 654700)
(AMETHYSTS, US << MARKET, 9996, 1, 654700)
(AMETHYSTS, US << MARKET, 9996, 1, 654700)
(AMETHYSTS, MARKET << US, 10002, 1, 654700)
(AMETHYSTS, MARKET << US, 10002, 1, 654700)
(AMETHYSTS, MARKET << US, 10002, 1, 654700)
(AMETHYSTS, MARKET << US, 10002, 1, 654700)
(AMETHYSTS, MARKET << US, 10002, 1, 654700)
(AMETHYSTS, MARKET << US, 10002, 1, 654700)
(AMETHYSTS, MARKET << US, 10002, 1, 654700)
(AMETHYSTS, MARKET << US, 10002, 1, 654700)","{""AMETHYSTS"": -3, ""STARFRUIT"": 5}",5078,5067,9999
655000,9998,19738,"(AMETHYSTS, MARKET << US, 9998, 1, 655000)","{""AMETHYSTS"": -4, ""STARFRUIT"": 5}",5069,5067,10001
655200,25335,45073,"(STARFRUIT, MARKET << US, 5067, 1, 655200)
(STARFRUIT, MARKET << US, 5067, 1, 655200)
(STARFRUIT, MARKET << US, 5067, 1, 655200)
(STARFRUIT, MARKET << US, 5067, 1, 655200)
(STARFRUIT, MARKET << US, 5067, 1, 655200)","{""AMETHYSTS"": -4, ""STARFRUIT"": 0}",5081,5065,9998
655400,19724,64797,"(AMETHYSTS, MARKET << US, 10002, 1, 655400)
(AMETHYSTS, MARKET << US, 10002, 1, 655400)
(AMETHYSTS, MARKET << US, 10002, 1, 655400)
(AMETHYSTS, MARKET << US, 10002, 1, 655400)
(STARFRUIT, US << MARKET, 5071, 1, 655400)
(STARFRUIT, US << MARKET, 5071, 1, 655400)
(STARFRUIT, US << MARKET, 5071, 1, 655400)
(STARFRUIT, US << MARKET, 5071, 1, 655400)","{""AMETHYSTS"": -8, ""STARFRUIT"": 4}",5081,5067,9998
656000,9874,74671,"(AMETHYSTS, MARKET << US, 10002, 1, 656000)
(AMETHYSTS, MARKET << US, 10002, 1, 656000)
(STARFRUIT, US << MARKET, 5065, 1, 656000)
(STARFRUIT, US << MARKET, 5065, 1, 656000)","{""AMETHYSTS"": -10, ""STARFRUIT"": 6}",5073,5067,10000
656100,5070,79741,"(STARFRUIT, MARKET << US, 5070, 1, 656100)","{""AMETHYSTS"": -10, ""STARFRUIT"": 5}",5101,5070,9999
656400,-5071,74670,"(STARFRUIT, US << MARKET, 5071, 1, 656400)
(STARFRUIT, US << MARKET, 5071, 1, 656400)
(STARFRUIT, US << MARKET, 5071, 1, 656400)
(STARFRUIT, MARKET << US, 5071, 1, 656400)
(STARFRUIT, MARKET << US, 5071, 1, 656400)","{""AMETHYSTS"": -10, ""STARFRUIT"": 6}",5064,5069,10002
656600,45329,119999,"(AMETHYSTS, MARKET << US, 10002, 1, 656600)
(AMETHYSTS, MARKET << US, 10002, 1, 656600)
(STARFRUIT, MARKET << US, 5065, 1, 656600)
(STARFRUIT, MARKET << US, 5065, 1, 656600)
(STARFRUIT, MARKET << US, 5065, 1, 656600)
(STARFRUIT, MARKET << US, 5065, 1, 656600)
(STARFRUIT, MARKET << US, 5065, 1, 656600)","{""AMETHYSTS"": -12, ""STARFRUIT"": 1}",5030,5067,10003
657100,-142,119857,"(AMETHYSTS, MARKET << US, 9998, 1, 657100)
(STARFRUIT, US << MARKET, 5070, 1, 657100)
(STARFRUIT, US << MARKET, 5070, 1, 657100)","{""AMETHYSTS"": -13, ""STARFRUIT"": 3}",5122,5071,9996
657600,9864,129721,"(AMETHYSTS, MARKET << US, 10005, 1, 657600)
(AMETHYSTS, MARKET << US, 10005, 1, 657600)
(STARFRUIT, US << MARKET, 5073, 1, 657600)
(STARFRUIT, US << MARKET, 5073, 1, 657600)","{""AMETHYSTS"": -15, ""STARFRUIT"": 5}",5021,5069,10003
657800,-20276,109445,"(STARFRUIT, US << MARKET, 5069, 1, 657800)
(STARFRUIT, US << MARKET, 5069, 1, 657800)
(STARFRUIT, US << MARKET, 5069, 1, 657800)
(STARFRUIT, US << MARKET, 5069, 1, 657800)","{""AMETHYSTS"": -15, ""STARFRUIT"": 9}",5093,5067,9997
658100,5066,114511,"(STARFRUIT, MARKET << US, 5066, 1, 658100)","{""AMETHYSTS"": -15, ""STARFRUIT"": 8}",5048,5069,10001
658200,-20004,94507,"(AMETHYSTS, US << MARKET, 10002, 1, 658200)
(AMETHYSTS, US << MARKET, 10002, 1, 658200)","{""AMETHYSTS"": -13, ""STARFRUIT"": 8}",5020,5069,10003
658300,-14929,79578,"(AMETHYSTS, US << MARKET, 9998, 1, 658300)
(AMETHYSTS, US << MARKET, 9998, 1, 658300)
(STARFRUIT, MARKET << US, 5067, 1, 658300)","{""AMETHYSTS"": -11, ""STARFRUIT"": 7}",5050,5069,10001
658400,-40008,39570,"(AMETHYSTS, US << MARKET, 10002, 1, 658400)
(AMETHYSTS, US << MARKET, 10002, 1, 658400)
(AMETHYSTS, US << MARKET, 10002, 1, 658400)
(AMETHYSTS, US << MARKET, 10002, 1, 658400)","{""AMETHYSTS"": -7, ""STARFRUIT"": 7}",5025,5068,10003
658600,20004,59574,"(AMETHYSTS, MARKET << US, 10002, 1, 658600)
(AMETHYSTS, MARKET << US, 10002, 1, 658600)","{""AMETHYSTS"": -9, ""STARFRUIT"": 7}",5030,5069,10003
658700,25350,84924,"(STARFRUIT, MARKET << US, 5070, 1, 658700)
(STARFRUIT, MARKET << US, 5070, 1, 658700)
(STARFRUIT, MARKET << US, 5070, 1, 658700)
(STARFRUIT, MARKET << US, 5070, 1, 658700)
(STARFRUIT, MARKET << US, 5070, 1, 658700)","{""AMETHYSTS"": -9, ""STARFRUIT"": 2}",5066,5071,10000
658900,39694,124618,"(AMETHYSTS, MARKET << US, 9996, 1, 658900)
(AMETHYSTS, MARKET << US, 9996, 1, 658900)
(AMETHYSTS, MARKET << US, 9996, 1, 658900)
(AMETHYSTS, MARKET << US, 9996, 1, 658900)
(AMETHYSTS, MARKET << US, 9996, 1, 658900)
(AMETHYSTS, MARKET << US, 9996, 1, 658900)
(STARFRUIT, US << MARKET, 5071, 1, 658900)
(STARFRUIT, US << MARKET, 5071, 1, 658900)
(STARFRUIT, US << MARKET, 5071, 1, 658900)
(STARFRUIT, US << MARKET, 5071, 1, 658900)
(STARFRUIT, US << MARKET, 5071, 1, 658900)
(STARFRUIT, MARKET << US, 5073, 1, 658900)","{""AMETHYSTS"": -15, ""STARFRUIT"": 6}",5050,5072,10000
659000,-19996,104622,"(AMETHYSTS, US << MARKET, 9998, 1, 659000)
(AMETHYSTS, US << MARKET, 9998, 1, 659000)","{""AMETHYSTS"": -13, ""STARFRUIT"": 6}",5029,5070,10001
659300,-10134,94488,"(STARFRUIT, US << MARKET, 5067, 1, 659300)
(STARFRUIT, US << MARKET, 5067, 1, 659300)","{""AMETHYSTS"": -13, ""STARFRUIT"": 8}",5035,5070,10001
660000,-30136,64352,"(AMETHYSTS, US << MARKET, 10000, 1, 660000)
(AMETHYSTS, US << MARKET, 10000, 1, 660000)
(STARFRUIT, US << MARKET, 5068, 1, 660000)
(STARFRUIT, US << MARKET, 5068, 1, 660000)
(STARFRUIT, US << MARKET, 5068, 1, 660000)
(STARFRUIT, US << MARKET, 5068, 1, 660000)
(STARFRUIT, MARKET << US, 5068, 1, 660000)
(STARFRUIT, MARKET << US, 5068, 1, 660000)","{""AMETHYSTS"": -11, ""STARFRUIT"": 10}",5034,5066,9998
660100,-15201,49151,"(STARFRUIT, US << MARKET, 5067, 1, 660100)
(STARFRUIT, US << MARKET, 5067, 1, 660100)
(STARFRUIT, US << MARKET, 5067, 1, 660100)","{""AMETHYSTS"": -11, ""STARFRUIT"": 13}",5031,5066,9998
660200,10138,59289,"(STARFRUIT, MARKET << US, 5069, 1, 660200)
(STARFRUIT, MARKET << US, 5069, 1, 660200)","{""AMETHYSTS"": -11, ""STARFRUIT"": 11}",5015,5066,10000
660300,-9868,49421,"(AMETHYSTS, US << MARKET, 10004, 1, 660300)
(AMETHYSTS, US << MARKET, 10004, 1, 660300)
(STARFRUIT, MARKET << US, 5070, 1, 660300)
(STARFRUIT, MARKET << US, 5070, 1, 660300)","{""AMETHYSTS"": -9, ""STARFRUIT"": 9}",5024,5067,10000
660400,5064,54485,"(STARFRUIT, MARKET << US, 5064, 1, 660400)","{""AMETHYSTS"": -9, ""STARFRUIT"": 8}",5029,5068,10000
660500,-20276,34209,"(STARFRUIT, US << MARKET, 5069, 1, 660500)
(STARFRUIT, US << MARKET, 5069, 1, 660500)
(STARFRUIT, US << MARKET, 5069, 1, 660500)
(STARFRUIT, US << MARKET, 5069, 1, 660500)","{""AMETHYSTS"": -9, ""STARFRUIT"": 12}",5010,5066,9999
660700,20260,54469,"(STARFRUIT, MARKET << US, 5065, 1, 660700)
(STARFRUIT, MARKET << US, 5065, 1, 660700)
(STARFRUIT, MARKET << US, 5065, 1, 660700)
(STARFRUIT, MARKET << US, 5065, 1, 660700)","{""AMETHYSTS"": -9, ""STARFRUIT"": 8}",4981,5064,10000
660900,-14928,39541,"(AMETHYSTS, US << MARKET, 9996, 1, 660900)
(AMETHYSTS, US << MARKET, 9996, 1, 660900)
(STARFRUIT, MARKET << US, 5064, 1, 660900)","{""AMETHYSTS"": -7, ""STARFRUIT"": 7}",5003,5066,10000
661000,29854,69395,"(AMETHYSTS, MARKET << US, 9996, 1, 661000)
(AMETHYSTS, MARKET << US, 9996, 1, 661000)
(AMETHYSTS, MARKET << US, 9995, 1, 661000)
(AMETHYSTS, MARKET << US, 9995, 1, 661000)
(STARFRUIT, US << MARKET, 5064, 1, 661000)
(STARFRUIT, US << MARKET, 5064, 1, 661000)","{""AMETHYSTS"": -11, ""STARFRUIT"": 9}",4971,5064,10000
661100,5069,74464,"(STARFRUIT, MARKET << US, 5069, 1, 661100)","{""AMETHYSTS"": -11, ""STARFRUIT"": 8}",5024,5070,10000
661200,-10262,64202,"(AMETHYSTS, MARKET << US, 9998, 1, 661200)
(STARFRUIT, US << MARKET, 5065, 1, 661200)
(STARFRUIT, US << MARKET, 5065, 1, 661200)
(STARFRUIT, US << MARKET, 5065, 1, 661200)
(STARFRUIT, US << MARKET, 5065, 1, 661200)","{""AMETHYSTS"": -12, ""STARFRUIT"": 12}",5006,5064,9997
661400,-59988,4214,"(AMETHYSTS, US << MARKET, 9998, 1, 661400)
(AMETHYSTS, US << MARKET, 9998, 1, 661400)
(AMETHYSTS, US << MARKET, 9998, 1, 661400)
(AMETHYSTS, US << MARKET, 9998, 1, 661400)
(AMETHYSTS, US << MARKET, 9998, 1, 661400)
(AMETHYSTS, US << MARKET, 9998, 1, 661400)","{""AMETHYSTS"": -6, ""STARFRUIT"": 12}",5036,5067,9997
661700,-15212,-10998,"(STARFRUIT, US << MARKET, 5070, 1, 661700)
(STARFRUIT, US << MARKET, 5070, 1, 661700)
(STARFRUIT, US << MARKET, 5070, 1, 661700)
(STARFRUIT, US << MARKET, 5070, 1, 661700)
(STARFRUIT, MARKET << US, 5068, 1, 661700)","{""AMETHYSTS"": -6, ""STARFRUIT"": 15}",5037,5069,10000
661800,-15075,-26073,"(AMETHYSTS, US << MARKET, 10005, 1, 661800)
(STARFRUIT, US << MARKET, 5070, 1, 661800)","{""AMETHYSTS"": -5, ""STARFRUIT"": 16}",4978,5066,10001
661900,20004,-6069,"(AMETHYSTS, MARKET << US, 10002, 1, 661900)
(AMETHYSTS, MARKET << US, 10002, 1, 661900)","{""AMETHYSTS"": -7, ""STARFRUIT"": 16}",4966,5066,10003
662000,30006,23937,"(AMETHYSTS, MARKET << US, 10004, 1, 662000)
(AMETHYSTS, MARKET << US, 10004, 1, 662000)
(AMETHYSTS, MARKET << US, 9998, 1, 662000)","{""AMETHYSTS"": -10, ""STARFRUIT"": 16}",5031,5069,10001
662100,-5069,18868,"(STARFRUIT, US << MARKET, 5069, 1, 662100)","{""AMETHYSTS"": -10, ""STARFRUIT"": 17}",5041,5069,10000
662400,-5064,13804,"(STARFRUIT, US << MARKET, 5064, 1, 662400)","{""AMETHYSTS"": -10, ""STARFRUIT"": 18}",5050,5067,9996
663000,90542,104346,"(AMETHYSTS, MARKET << US, 9998, 1, 663000)
(AMETHYSTS, MARKET << US, 9998, 1, 663000)
(AMETHYSTS, MARKET << US, 9998, 1, 663000)
(AMETHYSTS, MARKET << US, 9998, 1, 663000)
(AMETHYSTS, MARKET << US, 9998, 1, 663000)
(STARFRUIT, MARKET << US, 5069, 1, 663000)
(STARFRUIT, MARKET << US, 5069, 1, 663000)
(STARFRUIT, MARKET << US, 5069, 1, 663000)
(STARFRUIT, MARKET << US, 5069, 1, 663000)
(STARFRUIT, MARKET << US, 5069, 1, 663000)
(STARFRUIT, MARKET << US, 5069, 1, 663000)
(STARFRUIT, MARKET << US, 5069, 1, 663000)
(STARFRUIT, MARKET << US, 5069, 1, 663000)","{""AMETHYSTS"": -15, ""STARFRUIT"": 10}",5106,5070,9996
663100,-5069,99277,"(STARFRUIT, US << MARKET, 5069, 1, 663100)","{""AMETHYSTS"": -15, ""STARFRUIT"": 11}",5047,5070,10000
663500,19992,119269,"(AMETHYSTS, MARKET << US, 9996, 1, 663500)
(AMETHYSTS, MARKET << US, 9996, 1, 663500)","{""AMETHYSTS"": -17, ""STARFRUIT"": 11}",5028,5069,10000
663800,-25205,94064,"(AMETHYSTS, US << MARKET, 10002, 1, 663800)
(STARFRUIT, US << MARKET, 5068, 1, 663800)
(STARFRUIT, US << MARKET, 5068, 1, 663800)
(STARFRUIT, US << MARKET, 5068, 1, 663800)
(STARFRUIT, US << MARKET, 5068, 1, 663800)
(STARFRUIT, MARKET << US, 5069, 1, 663800)","{""AMETHYSTS"": -16, ""STARFRUIT"": 14}",4968,5068,10003
664500,30006,124070,"(AMETHYSTS, MARKET << US, 10002, 1, 664500)
(AMETHYSTS, MARKET << US, 10002, 1, 664500)
(AMETHYSTS, MARKET << US, 10002, 1, 664500)","{""AMETHYSTS"": -19, ""STARFRUIT"": 14}",5060,5068,9998
664600,-15067,109003,"(AMETHYSTS, US << MARKET, 10002, 1, 664600)
(STARFRUIT, US << MARKET, 5065, 1, 664600)","{""AMETHYSTS"": -18, ""STARFRUIT"": 15}",4969,5068,10003
664700,20288,129291,"(STARFRUIT, MARKET << US, 5072, 1, 664700)
(STARFRUIT, MARKET << US, 5072, 1, 664700)
(STARFRUIT, MARKET << US, 5072, 1, 664700)
(STARFRUIT, MARKET << US, 5072, 1, 664700)","{""AMETHYSTS"": -18, ""STARFRUIT"": 11}",5039,5068,10000
664800,-20272,109019,"(STARFRUIT, US << MARKET, 5068, 1, 664800)
(STARFRUIT, US << MARKET, 5068, 1, 664800)
(STARFRUIT, US << MARKET, 5068, 1, 664800)
(STARFRUIT, US << MARKET, 5068, 1, 664800)","{""AMETHYSTS"": -18, ""STARFRUIT"": 15}",5045,5066,9998
665100,-10002,99017,"(AMETHYSTS, US << MARKET, 10002, 1, 665100)","{""AMETHYSTS"": -17, ""STARFRUIT"": 15}",4971,5067,10003
665400,-65083,33934,"(AMETHYSTS, US << MARKET, 10002, 1, 665400)
(AMETHYSTS, US << MARKET, 10002, 1, 665400)
(AMETHYSTS, US << MARKET, 10002, 1, 665400)
(AMETHYSTS, US << MARKET, 10002, 1, 665400)
(AMETHYSTS, US << MARKET, 10002, 1, 665400)
(AMETHYSTS, US << MARKET, 10002, 1, 665400)
(STARFRUIT, US << MARKET, 5071, 1, 665400)","{""AMETHYSTS"": -11, ""STARFRUIT"": 16}",5037,5071,10003
666400,-10132,23802,"(STARFRUIT, US << MARKET, 5066, 1, 666400)
(STARFRUIT, US << MARKET, 5066, 1, 666400)","{""AMETHYSTS"": -11, ""STARFRUIT"": 18}",4972,5065,10000
666600,15067,38869,"(AMETHYSTS, MARKET << US, 9998, 1, 666600)
(STARFRUIT, MARKET << US, 5069, 1, 666600)","{""AMETHYSTS"": -12, ""STARFRUIT"": 17}",5078,5069,9997
667200,20004,58873,"(AMETHYSTS, MARKET << US, 10002, 1, 667200)
(AMETHYSTS, MARKET << US, 10002, 1, 667200)","{""AMETHYSTS"": -14, ""STARFRUIT"": 17}",4953,5066,10003
667300,-10002,48871,"(AMETHYSTS, US << MARKET, 10002, 1, 667300)","{""AMETHYSTS"": -13, ""STARFRUIT"": 17}",5036,5067,9998
667500,60012,108883,"(AMETHYSTS, MARKET << US, 10002, 1, 667500)
(AMETHYSTS, MARKET << US, 10002, 1, 667500)
(AMETHYSTS, MARKET << US, 10002, 1, 667500)
(AMETHYSTS, MARKET << US, 10002, 1, 667500)
(AMETHYSTS, MARKET << US, 10002, 1, 667500)
(AMETHYSTS, MARKET << US, 10002, 1, 667500)","{""AMETHYSTS"": -19, ""STARFRUIT"": 17}",5043,5066,9998
667600,-19996,88887,"(AMETHYSTS, US << MARKET, 9998, 1, 667600)
(AMETHYSTS, US << MARKET, 9998, 1, 667600)","{""AMETHYSTS"": -17, ""STARFRUIT"": 17}",5060,5066,9997
667800,10128,99015,"(STARFRUIT, MARKET << US, 5064, 1, 667800)
(STARFRUIT, MARKET << US, 5064, 1, 667800)","{""AMETHYSTS"": -17, ""STARFRUIT"": 15}",5054,5067,9998
668300,5068,104083,"(STARFRUIT, MARKET << US, 5068, 1, 668300)","{""AMETHYSTS"": -17, ""STARFRUIT"": 14}",5018,5068,10001
668400,-4941,99142,"(AMETHYSTS, US << MARKET, 10004, 1, 668400)
(STARFRUIT, MARKET << US, 5063, 1, 668400)","{""AMETHYSTS"": -16, ""STARFRUIT"": 13}",4948,5062,10000
668600,50630,149772,"(STARFRUIT, MARKET << US, 5063, 1, 668600)
(STARFRUIT, MARKET << US, 5063, 1, 668600)
(STARFRUIT, MARKET << US, 5063, 1, 668600)
(STARFRUIT, MARKET << US, 5063, 1, 668600)
(STARFRUIT, MARKET << US, 5063, 1, 668600)
(STARFRUIT, MARKET << US, 5063, 1, 668600)
(STARFRUIT, MARKET << US, 5063, 1, 668600)
(STARFRUIT, MARKET << US, 5063, 1, 668600)
(STARFRUIT, MARKET << US, 5063, 1, 668600)
(STARFRUIT, MARKET << US, 5063, 1, 668600)","{""AMETHYSTS"": -16, ""STARFRUIT"": 3}",4970,5066,10000
668700,29994,179766,"(AMETHYSTS, MARKET << US, 9998, 1, 668700)
(AMETHYSTS, MARKET << US, 9998, 1, 668700)
(AMETHYSTS, MARKET << US, 9998, 1, 668700)","{""AMETHYSTS"": -19, ""STARFRUIT"": 3}",4942,5065,10001
668900,-39984,139782,"(AMETHYSTS, US << MARKET, 9996, 1, 668900)
(AMETHYSTS, US << MARKET, 9996, 1, 668900)
(AMETHYSTS, US << MARKET, 9996, 1, 668900)
(AMETHYSTS, US << MARKET, 9996, 1, 668900)","{""AMETHYSTS"": -15, ""STARFRUIT"": 3}",4977,5065,10000
669100,20252,160034,"(STARFRUIT, MARKET << US, 5063, 1, 669100)
(STARFRUIT, MARKET << US, 5063, 1, 669100)
(STARFRUIT, MARKET << US, 5063, 1, 669100)
(STARFRUIT, MARKET << US, 5063, 1, 669100)","{""AMETHYSTS"": -15, ""STARFRUIT"": -1}",4968,5066,10000
669300,15189,175223,"(STARFRUIT, MARKET << US, 5063, 1, 669300)
(STARFRUIT, MARKET << US, 5063, 1, 669300)
(STARFRUIT, MARKET << US, 5063, 1, 669300)","{""AMETHYSTS"": -15, ""STARFRUIT"": -4}",4993,5065,9998
669600,-60236,114987,"(AMETHYSTS, US << MARKET, 9995, 1, 669600)
(AMETHYSTS, US << MARKET, 9995, 1, 669600)
(AMETHYSTS, US << MARKET, 9995, 1, 669600)
(AMETHYSTS, US << MARKET, 9995, 1, 669600)
(STARFRUIT, US << MARKET, 5064, 1, 669600)
(STARFRUIT, US << MARKET, 5064, 1, 669600)
(STARFRUIT, US << MARKET, 5064, 1, 669600)
(STARFRUIT, US << MARKET, 5064, 1, 669600)","{""AMETHYSTS"": -11, ""STARFRUIT"": 0}",5009,5067,9998
669900,-10138,104849,"(STARFRUIT, US << MARKET, 5069, 1, 669900)
(STARFRUIT, US << MARKET, 5069, 1, 669900)","{""AMETHYSTS"": -11, ""STARFRUIT"": 2}",4976,5069,10001
670300,-10140,94709,"(STARFRUIT, US << MARKET, 5070, 1, 670300)
(STARFRUIT, US << MARKET, 5070, 1, 670300)","{""AMETHYSTS"": -11, ""STARFRUIT"": 4}",4944,5067,10003
670500,-20260,74449,"(STARFRUIT, US << MARKET, 5065, 1, 670500)
(STARFRUIT, US << MARKET, 5065, 1, 670500)
(STARFRUIT, US << MARKET, 5065, 1, 670500)
(STARFRUIT, US << MARKET, 5065, 1, 670500)","{""AMETHYSTS"": -11, ""STARFRUIT"": 8}",5004,5068,9999
670600,-5064,69385,"(STARFRUIT, US << MARKET, 5064, 1, 670600)","{""AMETHYSTS"": -11, ""STARFRUIT"": 9}",4988,5067,10000
670800,-20276,49109,"(STARFRUIT, US << MARKET, 5069, 1, 670800)
(STARFRUIT, US << MARKET, 5069, 1, 670800)
(STARFRUIT, US << MARKET, 5069, 1, 670800)
(STARFRUIT, US << MARKET, 5069, 1, 670800)","{""AMETHYSTS"": -11, ""STARFRUIT"": 13}",4967,5066,10000
671100,-5065,44044,"(STARFRUIT, US << MARKET, 5065, 1, 671100)","{""AMETHYSTS"": -11, ""STARFRUIT"": 14}",4940,5064,10000
671800,-19996,24048,"(AMETHYSTS, US << MARKET, 9998, 1, 671800)
(AMETHYSTS, US << MARKET, 9998, 1, 671800)","{""AMETHYSTS"": -9, ""STARFRUIT"": 14}",5022,5067,9996
672100,-119976,-95928,"(AMETHYSTS, US << MARKET, 9998, 1, 672100)
(AMETHYSTS, US << MARKET, 9998, 1, 672100)
(AMETHYSTS, US << MARKET, 9998, 1, 672100)
(AMETHYSTS, US << MARKET, 9998, 1, 672100)
(AMETHYSTS, US << MARKET, 9998, 1, 672100)
(AMETHYSTS, US << MARKET, 9998, 1, 672100)
(AMETHYSTS, US << MARKET, 9998, 1, 672100)
(AMETHYSTS, US << MARKET, 9998, 1, 672100)
(AMETHYSTS, US << MARKET, 9998, 1, 672100)
(AMETHYSTS, US << MARKET, 9998, 1, 672100)
(AMETHYSTS, US << MARKET, 9998, 1, 672100)
(AMETHYSTS, US << MARKET, 9998, 1, 672100)","{""AMETHYSTS"": 3, ""STARFRUIT"": 14}",4999,5066,10001
672400,-5064,-100992,"(STARFRUIT, US << MARKET, 5064, 1, 672400)","{""AMETHYSTS"": 3, ""STARFRUIT"": 15}",4956,5063,10001
672600,39992,-61000,"(AMETHYSTS, MARKET << US, 9998, 1, 672600)
(AMETHYSTS, MARKET << US, 9998, 1, 672600)
(AMETHYSTS, MARKET << US, 9998, 1, 672600)
(AMETHYSTS, MARKET << US, 9998, 1, 672600)","{""AMETHYSTS"": -1, ""STARFRUIT"": 15}",5009,5067,9996
672700,-15209,-76209,"(STARFRUIT, US << MARKET, 5068, 1, 672700)
(STARFRUIT, US << MARKET, 5068, 1, 672700)
(STARFRUIT, US << MARKET, 5068, 1, 672700)
(STARFRUIT, US << MARKET, 5068, 1, 672700)
(STARFRUIT, MARKET << US, 5063, 1, 672700)","{""AMETHYSTS"": -1, ""STARFRUIT"": 18}",5033,5069,10000
672900,-10002,-86211,"(AMETHYSTS, US << MARKET, 10002, 1, 672900)","{""AMETHYSTS"": 0, ""STARFRUIT"": 18}",4995,5067,10003
673100,-5063,-91274,"(STARFRUIT, US << MARKET, 5063, 1, 673100)","{""AMETHYSTS"": 0, ""STARFRUIT"": 19}",4980,5066,10000
673300,9998,-81276,"(AMETHYSTS, MARKET << US, 9998, 1, 673300)","{""AMETHYSTS"": -1, ""STARFRUIT"": 19}",4982,5066,9996
673700,-59988,-141264,"(AMETHYSTS, US << MARKET, 9998, 1, 673700)
(AMETHYSTS, US << MARKET, 9998, 1, 673700)
(AMETHYSTS, US << MARKET, 9998, 1, 673700)
(AMETHYSTS, US << MARKET, 9998, 1, 673700)
(AMETHYSTS, US << MARKET, 9998, 1, 673700)
(AMETHYSTS, US << MARKET, 9998, 1, 673700)","{""AMETHYSTS"": 5, ""STARFRUIT"": 19}",4975,5066,9997
673800,-5064,-146328,"(STARFRUIT, US << MARKET, 5064, 1, 673800)","{""AMETHYSTS"": 5, ""STARFRUIT"": 20}",4947,5063,10003
675200,5064,-141264,"(STARFRUIT, MARKET << US, 5064, 1, 675200)","{""AMETHYSTS"": 5, ""STARFRUIT"": 19}",5009,5067,10000
675300,19996,-121268,"(AMETHYSTS, MARKET << US, 9998, 1, 675300)
(AMETHYSTS, MARKET << US, 9998, 1, 675300)","{""AMETHYSTS"": 3, ""STARFRUIT"": 19}",4989,5066,10001
675500,19996,-101272,"(AMETHYSTS, MARKET << US, 9998, 1, 675500)
(AMETHYSTS, MARKET << US, 9998, 1, 675500)","{""AMETHYSTS"": 1, ""STARFRUIT"": 19}",4983,5066,10001
675700,30414,-70858,"(STARFRUIT, MARKET << US, 5069, 1, 675700)
(STARFRUIT, MARKET << US, 5069, 1, 675700)
(STARFRUIT, MARKET << US, 5069, 1, 675700)
(STARFRUIT, MARKET << US, 5069, 1, 675700)
(STARFRUIT, MARKET << US, 5069, 1, 675700)
(STARFRUIT, MARKET << US, 5069, 1, 675700)","{""AMETHYSTS"": 1, ""STARFRUIT"": 13}",5000,5066,10000
676400,-10002,-80860,"(AMETHYSTS, US << MARKET, 10002, 1, 676400)","{""AMETHYSTS"": 2, ""STARFRUIT"": 13}",5030,5068,10003
676900,-5071,-85931,"(STARFRUIT, US << MARKET, 5071, 1, 676900)","{""AMETHYSTS"": 2, ""STARFRUIT"": 14}",5017,5068,9998
677100,-100020,-185951,"(AMETHYSTS, US << MARKET, 10002, 1, 677100)
(AMETHYSTS, US << MARKET, 10002, 1, 677100)
(AMETHYSTS, US << MARKET, 10002, 1, 677100)
(AMETHYSTS, US << MARKET, 10002, 1, 677100)
(AMETHYSTS, US << MARKET, 10002, 1, 677100)
(AMETHYSTS, US << MARKET, 10002, 1, 677100)
(AMETHYSTS, US << MARKET, 10002, 1, 677100)
(AMETHYSTS, US << MARKET, 10002, 1, 677100)
(AMETHYSTS, US << MARKET, 10002, 1, 677100)
(AMETHYSTS, US << MARKET, 10002, 1, 677100)","{""AMETHYSTS"": 12, ""STARFRUIT"": 14}",4989,5068,9999
677200,-19997,-205948,"(AMETHYSTS, US << MARKET, 9998, 1, 677200)
(AMETHYSTS, US << MARKET, 9998, 1, 677200)
(STARFRUIT, US << MARKET, 5066, 1, 677200)
(STARFRUIT, MARKET << US, 5065, 1, 677200)","{""AMETHYSTS"": 14, ""STARFRUIT"": 14}",4976,5065,10001
677300,40576,-165372,"(STARFRUIT, MARKET << US, 5072, 1, 677300)
(STARFRUIT, MARKET << US, 5072, 1, 677300)
(STARFRUIT, MARKET << US, 5072, 1, 677300)
(STARFRUIT, MARKET << US, 5072, 1, 677300)
(STARFRUIT, MARKET << US, 5072, 1, 677300)
(STARFRUIT, MARKET << US, 5072, 1, 677300)
(STARFRUIT, MARKET << US, 5072, 1, 677300)
(STARFRUIT, MARKET << US, 5072, 1, 677300)","{""AMETHYSTS"": 14, ""STARFRUIT"": 6}",5036,5068,10000
677600,9998,-155374,"(AMETHYSTS, MARKET << US, 9998, 1, 677600)","{""AMETHYSTS"": 13, ""STARFRUIT"": 6}",4995,5068,9997
677800,25330,-130044,"(STARFRUIT, MARKET << US, 5066, 1, 677800)
(STARFRUIT, MARKET << US, 5066, 1, 677800)
(STARFRUIT, MARKET << US, 5066, 1, 677800)
(STARFRUIT, MARKET << US, 5066, 1, 677800)
(STARFRUIT, MARKET << US, 5066, 1, 677800)","{""AMETHYSTS"": 13, ""STARFRUIT"": 1}",5008,5065,9999
677900,5070,-124974,"(STARFRUIT, MARKET << US, 5070, 1, 677900)","{""AMETHYSTS"": 13, ""STARFRUIT"": 0}",5026,5071,10000
678000,-10002,-134976,"(AMETHYSTS, US << MARKET, 10002, 1, 678000)","{""AMETHYSTS"": 14, ""STARFRUIT"": 0}",5066,5068,10003
678200,-20272,-155248,"(STARFRUIT, US << MARKET, 5068, 1, 678200)
(STARFRUIT, US << MARKET, 5068, 1, 678200)
(STARFRUIT, US << MARKET, 5068, 1, 678200)
(STARFRUIT, US << MARKET, 5068, 1, 678200)","{""AMETHYSTS"": 14, ""STARFRUIT"": 4}",5042,5069,10001
679200,-19996,-175244,"(AMETHYSTS, US << MARKET, 9998, 1, 679200)
(AMETHYSTS, US << MARKET, 9998, 1, 679200)","{""AMETHYSTS"": 16, ""STARFRUIT"": 4}",4976,5067,9997
679300,40016,-135228,"(AMETHYSTS, MARKET << US, 10004, 1, 679300)
(AMETHYSTS, MARKET << US, 10004, 1, 679300)
(AMETHYSTS, MARKET << US, 10004, 1, 679300)
(AMETHYSTS, MARKET << US, 10004, 1, 679300)","{""AMETHYSTS"": 12, ""STARFRUIT"": 4}",5052,5067,10001
679600,-9876,-145104,"(AMETHYSTS, US << MARKET, 10002, 1, 679600)
(AMETHYSTS, US << MARKET, 10002, 1, 679600)
(AMETHYSTS, US << MARKET, 10002, 1, 679600)
(AMETHYSTS, US << MARKET, 10002, 1, 679600)
(AMETHYSTS, US << MARKET, 10002, 1, 679600)
(AMETHYSTS, US << MARKET, 10002, 1, 679600)
(AMETHYSTS, MARKET << US, 10002, 1, 679600)
(AMETHYSTS, MARKET << US, 10002, 1, 679600)
(AMETHYSTS, MARKET << US, 10002, 1, 679600)
(AMETHYSTS, MARKET << US, 10002, 1, 679600)
(STARFRUIT, MARKET << US, 5064, 1, 679600)
(STARFRUIT, MARKET << US, 5064, 1, 679600)","{""AMETHYSTS"": 14, ""STARFRUIT"": 2}",5072,5067,10003
679700,59825,-85279,"(AMETHYSTS, MARKET << US, 9995, 1, 679700)
(AMETHYSTS, MARKET << US, 9995, 1, 679700)
(AMETHYSTS, MARKET << US, 9995, 1, 679700)
(AMETHYSTS, MARKET << US, 9995, 1, 679700)
(AMETHYSTS, MARKET << US, 9995, 1, 679700)
(AMETHYSTS, MARKET << US, 9995, 1, 679700)
(AMETHYSTS, MARKET << US, 9995, 1, 679700)
(STARFRUIT, US << MARKET, 5070, 1, 679700)
(STARFRUIT, US << MARKET, 5070, 1, 679700)","{""AMETHYSTS"": 7, ""STARFRUIT"": 4}",5001,5070,10000
680000,-10262,-95541,"(AMETHYSTS, MARKET << US, 9998, 1, 680000)
(STARFRUIT, US << MARKET, 5065, 1, 680000)
(STARFRUIT, US << MARKET, 5065, 1, 680000)
(STARFRUIT, US << MARKET, 5065, 1, 680000)
(STARFRUIT, US << MARKET, 5065, 1, 680000)","{""AMETHYSTS"": 6, ""STARFRUIT"": 8}",4947,5064,9996
680200,-15072,-110613,"(AMETHYSTS, US << MARKET, 10004, 1, 680200)
(STARFRUIT, US << MARKET, 5068, 1, 680200)","{""AMETHYSTS"": 7, ""STARFRUIT"": 9}",4972,5065,10000
680600,5064,-105549,"(STARFRUIT, MARKET << US, 5064, 1, 680600)","{""AMETHYSTS"": 7, ""STARFRUIT"": 8}",4995,5068,10000
680800,-15076,-120625,"(AMETHYSTS, US << MARKET, 10005, 1, 680800)
(STARFRUIT, US << MARKET, 5071, 1, 680800)","{""AMETHYSTS"": 8, ""STARFRUIT"": 9}",5005,5070,10000
681000,5063,-115562,"(STARFRUIT, MARKET << US, 5063, 1, 681000)","{""AMETHYSTS"": 8, ""STARFRUIT"": 8}",4990,5066,10003
681500,-20244,-135806,"(STARFRUIT, US << MARKET, 5061, 1, 681500)
(STARFRUIT, US << MARKET, 5061, 1, 681500)
(STARFRUIT, US << MARKET, 5061, 1, 681500)
(STARFRUIT, US << MARKET, 5061, 1, 681500)","{""AMETHYSTS"": 8, ""STARFRUIT"": 12}",4950,5063,10000
682000,-50112,-185918,"(AMETHYSTS, US << MARKET, 9996, 1, 682000)
(AMETHYSTS, US << MARKET, 9996, 1, 682000)
(AMETHYSTS, US << MARKET, 9996, 1, 682000)
(AMETHYSTS, US << MARKET, 9996, 1, 682000)
(STARFRUIT, US << MARKET, 5064, 1, 682000)
(STARFRUIT, US << MARKET, 5064, 1, 682000)","{""AMETHYSTS"": 12, ""STARFRUIT"": 14}",5020,5067,10000
683000,-14934,-200852,"(AMETHYSTS, US << MARKET, 9998, 1, 683000)
(AMETHYSTS, US << MARKET, 9998, 1, 683000)
(STARFRUIT, MARKET << US, 5062, 1, 683000)","{""AMETHYSTS"": 14, ""STARFRUIT"": 13}",5007,5065,10001
683700,5066,-195786,"(STARFRUIT, MARKET << US, 5066, 1, 683700)","{""AMETHYSTS"": 14, ""STARFRUIT"": 12}",5018,5067,10000
683800,25325,-170461,"(STARFRUIT, MARKET << US, 5065, 1, 683800)
(STARFRUIT, MARKET << US, 5065, 1, 683800)
(STARFRUIT, MARKET << US, 5065, 1, 683800)
(STARFRUIT, MARKET << US, 5065, 1, 683800)
(STARFRUIT, MARKET << US, 5065, 1, 683800)","{""AMETHYSTS"": 14, ""STARFRUIT"": 7}",5001,5066,10000
684000,10122,-160339,"(STARFRUIT, MARKET << US, 5061, 1, 684000)
(STARFRUIT, MARKET << US, 5061, 1, 684000)","{""AMETHYSTS"": 14, ""STARFRUIT"": 5}",4990,5063,10001
684200,-20260,-180599,"(STARFRUIT, US << MARKET, 5065, 1, 684200)
(STARFRUIT, US << MARKET, 5065, 1, 684200)
(STARFRUIT, US << MARKET, 5065, 1, 684200)
(STARFRUIT, US << MARKET, 5065, 1, 684200)","{""AMETHYSTS"": 14, ""STARFRUIT"": 9}",4995,5066,10000
684600,5061,-175538,"(STARFRUIT, MARKET << US, 5061, 1, 684600)","{""AMETHYSTS"": 14, ""STARFRUIT"": 8}",4952,5063,9999
684700,-5061,-180599,"(STARFRUIT, US << MARKET, 5061, 1, 684700)","{""AMETHYSTS"": 14, ""STARFRUIT"": 9}",4977,5064,10000
684800,24926,-155673,"(AMETHYSTS, MARKET << US, 9996, 1, 684800)
(AMETHYSTS, MARKET << US, 9996, 1, 684800)
(AMETHYSTS, MARKET << US, 9995, 1, 684800)
(STARFRUIT, US << MARKET, 5061, 1, 684800)","{""AMETHYSTS"": 11, ""STARFRUIT"": 10}",4956,5064,9999
685000,-5067,-160740,"(STARFRUIT, US << MARKET, 5067, 1, 685000)","{""AMETHYSTS"": 11, ""STARFRUIT"": 11}",4953,5063,10000
685200,-5067,-165807,"(STARFRUIT, US << MARKET, 5067, 1, 685200)","{""AMETHYSTS"": 11, ""STARFRUIT"": 12}",4986,5067,9999
685500,-15189,-180996,"(STARFRUIT, US << MARKET, 5063, 1, 685500)
(STARFRUIT, US << MARKET, 5063, 1, 685500)
(STARFRUIT, US << MARKET, 5063, 1, 685500)","{""AMETHYSTS"": 11, ""STARFRUIT"": 15}",4934,5062,10000
685600,-5066,-186062,"(STARFRUIT, US << MARKET, 5066, 1, 685600)","{""AMETHYSTS"": 11, ""STARFRUIT"": 16}",5010,5067,10000
686100,49990,-136072,"(AMETHYSTS, MARKET << US, 9998, 1, 686100)
(AMETHYSTS, MARKET << US, 9998, 1, 686100)
(AMETHYSTS, MARKET << US, 9998, 1, 686100)
(AMETHYSTS, MARKET << US, 9998, 1, 686100)
(AMETHYSTS, MARKET << US, 9998, 1, 686100)","{""AMETHYSTS"": 6, ""STARFRUIT"": 16}",4934,5064,9997
686400,19992,-116080,"(AMETHYSTS, MARKET << US, 9996, 1, 686400)
(AMETHYSTS, MARKET << US, 9996, 1, 686400)","{""AMETHYSTS"": 4, ""STARFRUIT"": 16}",4920,5063,9998
686700,5062,-111018,"(STARFRUIT, MARKET << US, 5062, 1, 686700)","{""AMETHYSTS"": 4, ""STARFRUIT"": 15}",4901,5061,10001
686800,-5066,-116084,"(STARFRUIT, US << MARKET, 5066, 1, 686800)","{""AMETHYSTS"": 4, ""STARFRUIT"": 16}",4972,5066,10000
687600,5068,-111016,"(STARFRUIT, MARKET << US, 5068, 1, 687600)","{""AMETHYSTS"": 4, ""STARFRUIT"": 15}",5008,5068,10001
687700,-15211,-126227,"(STARFRUIT, US << MARKET, 5070, 1, 687700)
(STARFRUIT, US << MARKET, 5070, 1, 687700)
(STARFRUIT, US << MARKET, 5070, 1, 687700)
(STARFRUIT, US << MARKET, 5070, 1, 687700)
(STARFRUIT, MARKET << US, 5069, 1, 687700)","{""AMETHYSTS"": 4, ""STARFRUIT"": 18}",5015,5069,10000
687800,-14926,-141153,"(AMETHYSTS, US << MARKET, 9998, 1, 687800)
(AMETHYSTS, US << MARKET, 9998, 1, 687800)
(STARFRUIT, MARKET << US, 5070, 1, 687800)","{""AMETHYSTS"": 6, ""STARFRUIT"": 17}",4962,5067,9996
687900,60012,-81141,"(AMETHYSTS, MARKET << US, 10002, 1, 687900)
(AMETHYSTS, MARKET << US, 10002, 1, 687900)
(AMETHYSTS, MARKET << US, 10002, 1, 687900)
(AMETHYSTS, MARKET << US, 10002, 1, 687900)
(AMETHYSTS, MARKET << US, 10002, 1, 687900)
(AMETHYSTS, MARKET << US, 10002, 1, 687900)","{""AMETHYSTS"": 0, ""STARFRUIT"": 17}",4947,5064,10003
688000,-5067,-86208,"(STARFRUIT, US << MARKET, 5067, 1, 688000)","{""AMETHYSTS"": 0, ""STARFRUIT"": 18}",5016,5068,10000
688100,190076,103868,"(AMETHYSTS, MARKET << US, 10004, 1, 688100)
(AMETHYSTS, MARKET << US, 10004, 1, 688100)
(AMETHYSTS, MARKET << US, 10004, 1, 688100)
(AMETHYSTS, MARKET << US, 10004, 1, 688100)
(AMETHYSTS, MARKET << US, 10004, 1, 688100)
(AMETHYSTS, MARKET << US, 10004, 1, 688100)
(AMETHYSTS, MARKET << US, 10004, 1, 688100)
(AMETHYSTS, MARKET << US, 10004, 1, 688100)
(AMETHYSTS, MARKET << US, 10004, 1, 688100)
(AMETHYSTS, MARKET << US, 10004, 1, 688100)
(AMETHYSTS, MARKET << US, 10004, 1, 688100)
(AMETHYSTS, MARKET << US, 10004, 1, 688100)
(AMETHYSTS, MARKET << US, 10004, 1, 688100)
(AMETHYSTS, MARKET << US, 10004, 1, 688100)
(AMETHYSTS, MARKET << US, 10004, 1, 688100)
(AMETHYSTS, MARKET << US, 10004, 1, 688100)
(AMETHYSTS, MARKET << US, 10004, 1, 688100)
(AMETHYSTS, MARKET << US, 10004, 1, 688100)
(AMETHYSTS, MARKET << US, 10004, 1, 688100)","{""AMETHYSTS"": -19, ""STARFRUIT"": 18}",5038,5065,10000
688600,-10138,93730,"(STARFRUIT, US << MARKET, 5069, 1, 688600)
(STARFRUIT, US << MARKET, 5069, 1, 688600)","{""AMETHYSTS"": -19, ""STARFRUIT"": 20}",5050,5066,10000
689300,130,93860,"(AMETHYSTS, US << MARKET, 9996, 1, 689300)
(AMETHYSTS, US << MARKET, 9996, 1, 689300)
(AMETHYSTS, MARKET << US, 9996, 1, 689300)
(STARFRUIT, MARKET << US, 5063, 1, 689300)
(STARFRUIT, MARKET << US, 5063, 1, 689300)","{""AMETHYSTS"": -18, ""STARFRUIT"": 18}",5048,5066,10000
689600,-5064,88796,"(STARFRUIT, US << MARKET, 5064, 1, 689600)","{""AMETHYSTS"": -18, ""STARFRUIT"": 19}",4993,5063,10000
689700,-50010,38786,"(AMETHYSTS, US << MARKET, 10002, 1, 689700)
(AMETHYSTS, US << MARKET, 10002, 1, 689700)
(AMETHYSTS, US << MARKET, 10002, 1, 689700)
(AMETHYSTS, US << MARKET, 10002, 1, 689700)
(AMETHYSTS, US << MARKET, 10002, 1, 689700)","{""AMETHYSTS"": -13, ""STARFRUIT"": 19}",5020,5067,10003
689800,5064,43850,"(STARFRUIT, MARKET << US, 5064, 1, 689800)","{""AMETHYSTS"": -13, ""STARFRUIT"": 18}",5038,5066,10000
690100,-59988,-16138,"(AMETHYSTS, US << MARKET, 9998, 1, 690100)
(AMETHYSTS, US << MARKET, 9998, 1, 690100)
(AMETHYSTS, US << MARKET, 9998, 1, 690100)
(AMETHYSTS, US << MARKET, 9998, 1, 690100)
(AMETHYSTS, US << MARKET, 9998, 1, 690100)
(AMETHYSTS, US << MARKET, 9998, 1, 690100)","{""AMETHYSTS"": -7, ""STARFRUIT"": 18}",5089,5067,9997
690200,-4932,-21070,"(AMETHYSTS, US << MARKET, 10002, 1, 690200)
(STARFRUIT, MARKET << US, 5070, 1, 690200)","{""AMETHYSTS"": -6, ""STARFRUIT"": 17}",5081,5067,9998
690700,44826,23756,"(AMETHYSTS, MARKET << US, 10002, 1, 690700)
(AMETHYSTS, MARKET << US, 10002, 1, 690700)
(AMETHYSTS, MARKET << US, 10002, 1, 690700)
(AMETHYSTS, MARKET << US, 10002, 1, 690700)
(AMETHYSTS, MARKET << US, 10002, 1, 690700)
(AMETHYSTS, MARKET << US, 10002, 1, 690700)
(STARFRUIT, US << MARKET, 5062, 1, 690700)
(STARFRUIT, US << MARKET, 5062, 1, 690700)
(STARFRUIT, US << MARKET, 5062, 1, 690700)","{""AMETHYSTS"": -12, ""STARFRUIT"": 20}",5020,5065,10003
691000,9998,33754,"(AMETHYSTS, MARKET << US, 9998, 1, 691000)","{""AMETHYSTS"": -13, ""STARFRUIT"": 20}",5041,5065,10001
692000,45605,79359,"(STARFRUIT, MARKET << US, 5068, 1, 692000)
(STARFRUIT, MARKET << US, 5068, 1, 692000)
(STARFRUIT, MARKET << US, 5068, 1, 692000)
(STARFRUIT, MARKET << US, 5068, 1, 692000)
(STARFRUIT, MARKET << US, 5068, 1, 692000)
(STARFRUIT, MARKET << US, 5068, 1, 692000)
(STARFRUIT, MARKET << US, 5068, 1, 692000)
(STARFRUIT, MARKET << US, 5068, 1, 692000)
(STARFRUIT, MARKET << US, 5061, 1, 692000)","{""AMETHYSTS"": -13, ""STARFRUIT"": 11}",5063,5064,10000
692100,14937,94296,"(AMETHYSTS, MARKET << US, 9996, 1, 692100)
(AMETHYSTS, MARKET << US, 9996, 1, 692100)
(STARFRUIT, US << MARKET, 5061, 1, 692100)
(STARFRUIT, US << MARKET, 5061, 1, 692100)
(STARFRUIT, MARKET << US, 5067, 1, 692100)","{""AMETHYSTS"": -15, ""STARFRUIT"": 12}",5052,5063,10000
692200,45460,139756,"(AMETHYSTS, MARKET << US, 9998, 1, 692200)
(STARFRUIT, MARKET << US, 5066, 1, 692200)
(STARFRUIT, MARKET << US, 5066, 1, 692200)
(STARFRUIT, MARKET << US, 5066, 1, 692200)
(STARFRUIT, MARKET << US, 5066, 1, 692200)
(STARFRUIT, MARKET << US, 5066, 1, 692200)
(STARFRUIT, MARKET << US, 5066, 1, 692200)
(STARFRUIT, MARKET << US, 5066, 1, 692200)","{""AMETHYSTS"": -16, ""STARFRUIT"": 5}",5135,5063,9996
692900,-10134,129622,"(STARFRUIT, US << MARKET, 5067, 1, 692900)
(STARFRUIT, US << MARKET, 5067, 1, 692900)","{""AMETHYSTS"": -16, ""STARFRUIT"": 7}",5049,5061,10000
693100,-5066,124556,"(STARFRUIT, US << MARKET, 5066, 1, 693100)","{""AMETHYSTS"": -16, ""STARFRUIT"": 8}",5092,5067,10000
693200,24923,149479,"(AMETHYSTS, MARKET << US, 9995, 1, 693200)
(AMETHYSTS, MARKET << US, 9995, 1, 693200)
(AMETHYSTS, MARKET << US, 9995, 1, 693200)
(STARFRUIT, US << MARKET, 5062, 1, 693200)","{""AMETHYSTS"": -19, ""STARFRUIT"": 9}",5102,5065,9998
694200,-5059,144420,"(STARFRUIT, US << MARKET, 5059, 1, 694200)","{""AMETHYSTS"": -19, ""STARFRUIT"": 10}",5040,5062,10000
694800,5064,149484,"(STARFRUIT, MARKET << US, 5064, 1, 694800)","{""AMETHYSTS"": -19, ""STARFRUIT"": 9}",5062,5060,9998
694900,-5059,144425,"(STARFRUIT, US << MARKET, 5059, 1, 694900)","{""AMETHYSTS"": -19, ""STARFRUIT"": 10}",5035,5061,10000
695200,-60024,84401,"(AMETHYSTS, US << MARKET, 10004, 1, 695200)
(AMETHYSTS, US << MARKET, 10004, 1, 695200)
(AMETHYSTS, US << MARKET, 10004, 1, 695200)
(AMETHYSTS, US << MARKET, 10004, 1, 695200)
(AMETHYSTS, US << MARKET, 10004, 1, 695200)
(AMETHYSTS, US << MARKET, 10004, 1, 695200)","{""AMETHYSTS"": -13, ""STARFRUIT"": 10}",5021,5062,10000
695300,-5059,79342,"(STARFRUIT, US << MARKET, 5059, 1, 695300)","{""AMETHYSTS"": -13, ""STARFRUIT"": 11}",5061,5063,9998
695600,-10004,69338,"(AMETHYSTS, US << MARKET, 10004, 1, 695600)","{""AMETHYSTS"": -12, ""STARFRUIT"": 11}",5009,5061,10000
696100,20004,89342,"(AMETHYSTS, MARKET << US, 10002, 1, 696100)
(AMETHYSTS, MARKET << US, 10002, 1, 696100)","{""AMETHYSTS"": -14, ""STARFRUIT"": 11}",4982,5062,10003
696600,35413,124755,"(STARFRUIT, MARKET << US, 5059, 1, 696600)
(STARFRUIT, MARKET << US, 5059, 1, 696600)
(STARFRUIT, MARKET << US, 5059, 1, 696600)
(STARFRUIT, MARKET << US, 5059, 1, 696600)
(STARFRUIT, MARKET << US, 5059, 1, 696600)
(STARFRUIT, MARKET << US, 5059, 1, 696600)
(STARFRUIT, MARKET << US, 5059, 1, 696600)","{""AMETHYSTS"": -14, ""STARFRUIT"": 4}",5003,5062,10000
697100,-20264,104491,"(STARFRUIT, US << MARKET, 5066, 1, 697100)
(STARFRUIT, US << MARKET, 5066, 1, 697100)
(STARFRUIT, US << MARKET, 5066, 1, 697100)
(STARFRUIT, US << MARKET, 5066, 1, 697100)","{""AMETHYSTS"": -14, ""STARFRUIT"": 8}",5017,5064,9999
697400,-19996,84495,"(AMETHYSTS, US << MARKET, 9998, 1, 697400)
(AMETHYSTS, US << MARKET, 9998, 1, 697400)","{""AMETHYSTS"": -12, ""STARFRUIT"": 8}",4971,5061,10001
697600,30366,114861,"(STARFRUIT, MARKET << US, 5061, 1, 697600)
(STARFRUIT, MARKET << US, 5061, 1, 697600)
(STARFRUIT, MARKET << US, 5061, 1, 697600)
(STARFRUIT, MARKET << US, 5061, 1, 697600)
(STARFRUIT, MARKET << US, 5061, 1, 697600)
(STARFRUIT, MARKET << US, 5061, 1, 697600)","{""AMETHYSTS"": -12, ""STARFRUIT"": 2}",4981,5060,10000
697700,-10002,104859,"(AMETHYSTS, US << MARKET, 10002, 1, 697700)","{""AMETHYSTS"": -11, ""STARFRUIT"": 2}",4950,5062,10003
697800,-19996,84863,"(AMETHYSTS, US << MARKET, 9998, 1, 697800)
(AMETHYSTS, US << MARKET, 9998, 1, 697800)","{""AMETHYSTS"": -9, ""STARFRUIT"": 2}",4978,5062,10001
698300,25073,109936,"(AMETHYSTS, MARKET << US, 10004, 1, 698300)
(AMETHYSTS, MARKET << US, 10004, 1, 698300)
(STARFRUIT, MARKET << US, 5065, 1, 698300)","{""AMETHYSTS"": -11, ""STARFRUIT"": 1}",5000,5064,10000
698400,-40124,69812,"(AMETHYSTS, US << MARKET, 10002, 1, 698400)
(AMETHYSTS, US << MARKET, 10002, 1, 698400)
(AMETHYSTS, US << MARKET, 10002, 1, 698400)
(STARFRUIT, US << MARKET, 5059, 1, 698400)
(STARFRUIT, US << MARKET, 5059, 1, 698400)","{""AMETHYSTS"": -8, ""STARFRUIT"": 3}",4974,5062,10003
698500,-79984,-10172,"(AMETHYSTS, US << MARKET, 9998, 1, 698500)
(AMETHYSTS, US << MARKET, 9998, 1, 698500)
(AMETHYSTS, US << MARKET, 9998, 1, 698500)
(AMETHYSTS, US << MARKET, 9998, 1, 698500)
(AMETHYSTS, US << MARKET, 9998, 1, 698500)
(AMETHYSTS, US << MARKET, 9998, 1, 698500)
(AMETHYSTS, US << MARKET, 9998, 1, 698500)
(AMETHYSTS, US << MARKET, 9998, 1, 698500)","{""AMETHYSTS"": 0, ""STARFRUIT"": 3}",5020,5064,9997
698700,-50010,-60182,"(AMETHYSTS, US << MARKET, 10002, 1, 698700)
(AMETHYSTS, US << MARKET, 10002, 1, 698700)
(AMETHYSTS, US << MARKET, 10002, 1, 698700)
(AMETHYSTS, US << MARKET, 10002, 1, 698700)
(AMETHYSTS, US << MARKET, 10002, 1, 698700)","{""AMETHYSTS"": 5, ""STARFRUIT"": 3}",5015,5064,10001
698900,85032,24850,"(AMETHYSTS, MARKET << US, 9996, 1, 698900)
(AMETHYSTS, MARKET << US, 9996, 1, 698900)
(AMETHYSTS, MARKET << US, 9996, 1, 698900)
(AMETHYSTS, MARKET << US, 9996, 1, 698900)
(AMETHYSTS, MARKET << US, 9996, 1, 698900)
(AMETHYSTS, MARKET << US, 9996, 1, 698900)
(AMETHYSTS, MARKET << US, 9996, 1, 698900)
(AMETHYSTS, MARKET << US, 9996, 1, 698900)
(STARFRUIT, MARKET << US, 5064, 1, 698900)","{""AMETHYSTS"": -3, ""STARFRUIT"": 2}",4978,5064,10000
699100,-25290,-440,"(STARFRUIT, US << MARKET, 5058, 1, 699100)
(STARFRUIT, US << MARKET, 5058, 1, 699100)
(STARFRUIT, US << MARKET, 5058, 1, 699100)
(STARFRUIT, US << MARKET, 5058, 1, 699100)
(STARFRUIT, US << MARKET, 5058, 1, 699100)","{""AMETHYSTS"": -3, ""STARFRUIT"": 7}",4966,5058,10000
699300,-10002,-10442,"(AMETHYSTS, US << MARKET, 10002, 1, 699300)","{""AMETHYSTS"": -2, ""STARFRUIT"": 7}",4985,5061,10000
699800,5062,-5380,"(STARFRUIT, US << MARKET, 5062, 1, 699800)
(STARFRUIT, MARKET << US, 5062, 1, 699800)
(STARFRUIT, MARKET << US, 5062, 1, 699800)","{""AMETHYSTS"": -2, ""STARFRUIT"": 6}",4998,5063,10000
700500,25071,19691,"(AMETHYSTS, MARKET << US, 10004, 1, 700500)
(AMETHYSTS, MARKET << US, 10004, 1, 700500)
(STARFRUIT, MARKET << US, 5063, 1, 700500)","{""AMETHYSTS"": -4, ""STARFRUIT"": 5}",4991,5060,10000
700700,20126,39817,"(AMETHYSTS, US << MARKET, 10000, 1, 700700)
(AMETHYSTS, MARKET << US, 10002, 1, 700700)
(AMETHYSTS, MARKET << US, 10002, 1, 700700)
(STARFRUIT, MARKET << US, 5061, 1, 700700)
(STARFRUIT, MARKET << US, 5061, 1, 700700)","{""AMETHYSTS"": -5, ""STARFRUIT"": 3}",5012,5060,9997
700900,-25315,14502,"(STARFRUIT, US << MARKET, 5063, 1, 700900)
(STARFRUIT, US << MARKET, 5063, 1, 700900)
(STARFRUIT, US << MARKET, 5063, 1, 700900)
(STARFRUIT, US << MARKET, 5063, 1, 700900)
(STARFRUIT, US << MARKET, 5063, 1, 700900)","{""AMETHYSTS"": -5, ""STARFRUIT"": 8}",5024,5064,9998
701100,-110040,-95538,"(AMETHYSTS, US << MARKET, 10002, 1, 701100)
(AMETHYSTS, US << MARKET, 10002, 1, 701100)
(AMETHYSTS, US << MARKET, 10002, 1, 701100)
(AMETHYSTS, US << MARKET, 10002, 1, 701100)
(AMETHYSTS, US << MARKET, 10002, 1, 701100)
(AMETHYSTS, US << MARKET, 10005, 1, 701100)
(AMETHYSTS, US << MARKET, 10005, 1, 701100)
(AMETHYSTS, US << MARKET, 10005, 1, 701100)
(AMETHYSTS, US << MARKET, 10005, 1, 701100)
(AMETHYSTS, US << MARKET, 10005, 1, 701100)
(AMETHYSTS, US << MARKET, 10005, 1, 701100)","{""AMETHYSTS"": 6, ""STARFRUIT"": 8}",4968,5061,10003
701500,-45040,-140578,"(AMETHYSTS, US << MARKET, 9995, 1, 701500)
(AMETHYSTS, US << MARKET, 9995, 1, 701500)
(AMETHYSTS, US << MARKET, 9995, 1, 701500)
(AMETHYSTS, US << MARKET, 9995, 1, 701500)
(STARFRUIT, US << MARKET, 5059, 1, 701500)
(STARFRUIT, US << MARKET, 5059, 1, 701500)
(STARFRUIT, MARKET << US, 5058, 1, 701500)","{""AMETHYSTS"": 10, ""STARFRUIT"": 9}",4980,5062,10000
701700,-5059,-145637,"(STARFRUIT, US << MARKET, 5059, 1, 701700)","{""AMETHYSTS"": 10, ""STARFRUIT"": 10}",4943,5058,10000
701900,14943,-130694,"(AMETHYSTS, MARKET << US, 10004, 1, 701900)
(AMETHYSTS, MARKET << US, 10004, 1, 701900)
(STARFRUIT, US << MARKET, 5065, 1, 701900)","{""AMETHYSTS"": 8, ""STARFRUIT"": 11}",4988,5062,10000
702000,-5064,-135758,"(STARFRUIT, US << MARKET, 5064, 1, 702000)","{""AMETHYSTS"": 8, ""STARFRUIT"": 12}",5010,5064,10000
702100,5058,-130700,"(STARFRUIT, MARKET << US, 5058, 1, 702100)","{""AMETHYSTS"": 8, ""STARFRUIT"": 11}",4955,5061,9998
702200,19784,-110916,"(AMETHYSTS, MARKET << US, 10004, 1, 702200)
(AMETHYSTS, MARKET << US, 10004, 1, 702200)
(AMETHYSTS, MARKET << US, 10004, 1, 702200)
(AMETHYSTS, MARKET << US, 10004, 1, 702200)
(STARFRUIT, US << MARKET, 5058, 1, 702200)
(STARFRUIT, US << MARKET, 5058, 1, 702200)
(STARFRUIT, US << MARKET, 5058, 1, 702200)
(STARFRUIT, US << MARKET, 5058, 1, 702200)","{""AMETHYSTS"": 4, ""STARFRUIT"": 15}",5003,5061,10001
702300,160080,49164,"(AMETHYSTS, MARKET << US, 10005, 1, 702300)
(AMETHYSTS, MARKET << US, 10005, 1, 702300)
(AMETHYSTS, MARKET << US, 10005, 1, 702300)
(AMETHYSTS, MARKET << US, 10005, 1, 702300)
(AMETHYSTS, MARKET << US, 10005, 1, 702300)
(AMETHYSTS, MARKET << US, 10005, 1, 702300)
(AMETHYSTS, MARKET << US, 10005, 1, 702300)
(AMETHYSTS, MARKET << US, 10005, 1, 702300)
(AMETHYSTS, MARKET << US, 10005, 1, 702300)
(AMETHYSTS, MARKET << US, 10005, 1, 702300)
(AMETHYSTS, MARKET << US, 10005, 1, 702300)
(AMETHYSTS, MARKET << US, 10005, 1, 702300)
(AMETHYSTS, MARKET << US, 10005, 1, 702300)
(AMETHYSTS, MARKET << US, 10005, 1, 702300)
(AMETHYSTS, MARKET << US, 10005, 1, 702300)
(AMETHYSTS, MARKET << US, 10005, 1, 702300)","{""AMETHYSTS"": -12, ""STARFRUIT"": 15}",5028,5060,10003
702900,-5059,44105,"(STARFRUIT, US << MARKET, 5059, 1, 702900)","{""AMETHYSTS"": -12, ""STARFRUIT"": 16}",5061,5062,10003
703000,-20256,23849,"(STARFRUIT, US << MARKET, 5064, 1, 703000)
(STARFRUIT, US << MARKET, 5064, 1, 703000)
(STARFRUIT, US << MARKET, 5064, 1, 703000)
(STARFRUIT, US << MARKET, 5064, 1, 703000)","{""AMETHYSTS"": -12, ""STARFRUIT"": 20}",5137,5065,10001
703300,-29994,-6145,"(AMETHYSTS, US << MARKET, 9996, 1, 703300)
(AMETHYSTS, US << MARKET, 9996, 1, 703300)
(AMETHYSTS, US << MARKET, 10002, 1, 703300)","{""AMETHYSTS"": -9, ""STARFRUIT"": 20}",5084,5061,9999
703400,5063,-1082,"(STARFRUIT, MARKET << US, 5063, 1, 703400)","{""AMETHYSTS"": -9, ""STARFRUIT"": 19}",5143,5064,9999
703500,19996,18914,"(AMETHYSTS, MARKET << US, 9998, 1, 703500)
(AMETHYSTS, MARKET << US, 9998, 1, 703500)","{""AMETHYSTS"": -11, ""STARFRUIT"": 19}",5163,5064,9997
703600,-5058,13856,"(STARFRUIT, US << MARKET, 5058, 1, 703600)","{""AMETHYSTS"": -11, ""STARFRUIT"": 20}",5076,5061,10000
704100,-74919,-61063,"(AMETHYSTS, US << MARKET, 9998, 1, 704100)
(AMETHYSTS, US << MARKET, 9998, 1, 704100)
(AMETHYSTS, US << MARKET, 9998, 1, 704100)
(AMETHYSTS, US << MARKET, 9998, 1, 704100)
(AMETHYSTS, US << MARKET, 9998, 1, 704100)
(AMETHYSTS, US << MARKET, 9998, 1, 704100)
(AMETHYSTS, US << MARKET, 9998, 1, 704100)
(AMETHYSTS, US << MARKET, 9998, 1, 704100)
(STARFRUIT, MARKET << US, 5065, 1, 704100)","{""AMETHYSTS"": -3, ""STARFRUIT"": 19}",5181,5065,9997
704500,-5060,-66123,"(STARFRUIT, US << MARKET, 5060, 1, 704500)","{""AMETHYSTS"": -3, ""STARFRUIT"": 20}",5134,5063,10001
704600,49980,-16143,"(AMETHYSTS, MARKET << US, 9996, 1, 704600)
(AMETHYSTS, MARKET << US, 9996, 1, 704600)
(AMETHYSTS, MARKET << US, 9996, 1, 704600)
(AMETHYSTS, MARKET << US, 9996, 1, 704600)
(AMETHYSTS, MARKET << US, 9996, 1, 704600)","{""AMETHYSTS"": -8, ""STARFRUIT"": 20}",5125,5063,9999
705100,0,-16143,,"{""AMETHYSTS"": -8, ""STARFRUIT"": 20}",5057,5060,10000
705200,0,-16143,,"{""AMETHYSTS"": -8, ""STARFRUIT"": 20}",5113,5062,9998
705300,-99980,-116123,"(AMETHYSTS, US << MARKET, 9998, 1, 705300)
(AMETHYSTS, US << MARKET, 9998, 1, 705300)
(AMETHYSTS, US << MARKET, 9998, 1, 705300)
(AMETHYSTS, US << MARKET, 9998, 1, 705300)
(AMETHYSTS, US << MARKET, 9998, 1, 705300)
(AMETHYSTS, US << MARKET, 9998, 1, 705300)
(AMETHYSTS, US << MARKET, 9998, 1, 705300)
(AMETHYSTS, US << MARKET, 9998, 1, 705300)
(AMETHYSTS, US << MARKET, 9998, 1, 705300)
(AMETHYSTS, US << MARKET, 9998, 1, 705300)","{""AMETHYSTS"": 2, ""STARFRUIT"": 20}",5109,5062,9996
705600,45085,-71038,"(AMETHYSTS, MARKET << US, 10005, 1, 705600)
(AMETHYSTS, MARKET << US, 10005, 1, 705600)
(AMETHYSTS, MARKET << US, 10005, 1, 705600)
(AMETHYSTS, MARKET << US, 10004, 1, 705600)
(STARFRUIT, MARKET << US, 5066, 1, 705600)","{""AMETHYSTS"": -2, ""STARFRUIT"": 19}",5157,5063,10001
706100,50152,-20886,"(AMETHYSTS, MARKET << US, 10005, 1, 706100)
(AMETHYSTS, MARKET << US, 10005, 1, 706100)
(AMETHYSTS, MARKET << US, 10005, 1, 706100)
(AMETHYSTS, MARKET << US, 10005, 1, 706100)
(STARFRUIT, MARKET << US, 5066, 1, 706100)
(STARFRUIT, MARKET << US, 5066, 1, 706100)","{""AMETHYSTS"": -6, ""STARFRUIT"": 17}",5168,5062,10000
706200,-10125,-31011,"(STARFRUIT, US << MARKET, 5063, 1, 706200)
(STARFRUIT, US << MARKET, 5063, 1, 706200)
(STARFRUIT, US << MARKET, 5063, 1, 706200)
(STARFRUIT, MARKET << US, 5064, 1, 706200)","{""AMETHYSTS"": -6, ""STARFRUIT"": 19}",5230,5065,9999
706300,-9876,-40887,"(AMETHYSTS, US << MARKET, 9998, 1, 706300)
(AMETHYSTS, US << MARKET, 9998, 1, 706300)
(STARFRUIT, MARKET << US, 5060, 1, 706300)
(STARFRUIT, MARKET << US, 5060, 1, 706300)","{""AMETHYSTS"": -4, ""STARFRUIT"": 17}",5163,5062,10001
706900,-15183,-56070,"(STARFRUIT, US << MARKET, 5061, 1, 706900)
(STARFRUIT, US << MARKET, 5061, 1, 706900)
(STARFRUIT, US << MARKET, 5061, 1, 706900)","{""AMETHYSTS"": -4, ""STARFRUIT"": 20}",5114,5059,9999
707300,9998,-46072,"(AMETHYSTS, MARKET << US, 9998, 1, 707300)","{""AMETHYSTS"": -5, ""STARFRUIT"": 20}",5143,5060,9997
707800,0,-46072,,"{""AMETHYSTS"": -5, ""STARFRUIT"": 20}",5148,5061,10000
708200,40020,-6052,"(AMETHYSTS, MARKET << US, 10005, 1, 708200)
(AMETHYSTS, MARKET << US, 10005, 1, 708200)
(AMETHYSTS, MARKET << US, 10005, 1, 708200)
(AMETHYSTS, MARKET << US, 10005, 1, 708200)","{""AMETHYSTS"": -9, ""STARFRUIT"": 20}",5148,5060,10000
708300,0,-6052,,"{""AMETHYSTS"": -9, ""STARFRUIT"": 20}",5148,5060,10000
708400,0,-6052,,"{""AMETHYSTS"": -9, ""STARFRUIT"": 20}",5128,5059,10000
708600,-20004,-26056,"(AMETHYSTS, US << MARKET, 10002, 1, 708600)
(AMETHYSTS, US << MARKET, 10002, 1, 708600)
(AMETHYSTS, US << MARKET, 10002, 1, 708600)
(AMETHYSTS, US << MARKET, 10002, 1, 708600)
(AMETHYSTS, MARKET << US, 10002, 1, 708600)
(AMETHYSTS, MARKET << US, 10002, 1, 708600)","{""AMETHYSTS"": -7, ""STARFRUIT"": 20}",5145,5059,9997
708900,-10004,-36060,"(AMETHYSTS, US << MARKET, 10004, 1, 708900)","{""AMETHYSTS"": -6, ""STARFRUIT"": 20}",5200,5063,10000
709100,20004,-16056,"(AMETHYSTS, MARKET << US, 10002, 1, 709100)
(AMETHYSTS, MARKET << US, 10002, 1, 709100)","{""AMETHYSTS"": -8, ""STARFRUIT"": 20}",5172,5061,9999
709300,0,-16056,,"{""AMETHYSTS"": -8, ""STARFRUIT"": 20}",5184,5062,10000
710300,40008,23952,"(AMETHYSTS, MARKET << US, 10002, 1, 710300)
(AMETHYSTS, MARKET << US, 10002, 1, 710300)
(AMETHYSTS, MARKET << US, 10002, 1, 710300)
(AMETHYSTS, MARKET << US, 10002, 1, 710300)","{""AMETHYSTS"": -12, ""STARFRUIT"": 20}",5196,5064,10003
710400,5062,29014,"(STARFRUIT, MARKET << US, 5062, 1, 710400)","{""AMETHYSTS"": -12, ""STARFRUIT"": 19}",5218,5064,10001
710900,-25076,3938,"(AMETHYSTS, US << MARKET, 10004, 1, 710900)
(AMETHYSTS, US << MARKET, 10004, 1, 710900)
(STARFRUIT, US << MARKET, 5068, 1, 710900)","{""AMETHYSTS"": -10, ""STARFRUIT"": 20}",5228,5065,10001
711900,35202,39140,"(AMETHYSTS, MARKET << US, 10002, 1, 711900)
(AMETHYSTS, MARKET << US, 10002, 1, 711900)
(STARFRUIT, MARKET << US, 5066, 1, 711900)
(STARFRUIT, MARKET << US, 5066, 1, 711900)
(STARFRUIT, MARKET << US, 5066, 1, 711900)","{""AMETHYSTS"": -12, ""STARFRUIT"": 17}",5252,5064,9998
712000,132,39272,"(AMETHYSTS, US << MARKET, 9996, 1, 712000)
(AMETHYSTS, US << MARKET, 9996, 1, 712000)
(AMETHYSTS, MARKET << US, 9996, 1, 712000)
(STARFRUIT, MARKET << US, 5064, 1, 712000)
(STARFRUIT, MARKET << US, 5064, 1, 712000)","{""AMETHYSTS"": -11, ""STARFRUIT"": 15}",5262,5066,10000
712100,-5068,34204,"(STARFRUIT, US << MARKET, 5068, 1, 712100)","{""AMETHYSTS"": -11, ""STARFRUIT"": 16}",5308,5069,10000
712300,5065,39269,"(STARFRUIT, MARKET << US, 5065, 1, 712300)","{""AMETHYSTS"": -11, ""STARFRUIT"": 15}",5274,5067,10000
712400,9998,49267,"(AMETHYSTS, MARKET << US, 9998, 1, 712400)","{""AMETHYSTS"": -12, ""STARFRUIT"": 15}",5308,5067,9997
712700,-59988,-10721,"(AMETHYSTS, US << MARKET, 9998, 1, 712700)
(AMETHYSTS, US << MARKET, 9998, 1, 712700)
(AMETHYSTS, US << MARKET, 9998, 1, 712700)
(AMETHYSTS, US << MARKET, 9998, 1, 712700)
(AMETHYSTS, US << MARKET, 9998, 1, 712700)
(AMETHYSTS, US << MARKET, 9998, 1, 712700)","{""AMETHYSTS"": -6, ""STARFRUIT"": 15}",5317,5068,9997
713000,5065,-5656,"(STARFRUIT, MARKET << US, 5065, 1, 713000)","{""AMETHYSTS"": -6, ""STARFRUIT"": 14}",5252,5064,9998
713100,-20264,-25920,"(STARFRUIT, US << MARKET, 5066, 1, 713100)
(STARFRUIT, US << MARKET, 5066, 1, 713100)
(STARFRUIT, US << MARKET, 5066, 1, 713100)
(STARFRUIT, US << MARKET, 5066, 1, 713100)","{""AMETHYSTS"": -6, ""STARFRUIT"": 18}",5250,5065,10000
713300,138,-25782,"(AMETHYSTS, US << MARKET, 10004, 1, 713300)
(STARFRUIT, MARKET << US, 5071, 1, 713300)
(STARFRUIT, MARKET << US, 5071, 1, 713300)","{""AMETHYSTS"": -5, ""STARFRUIT"": 16}",5291,5068,10003
713400,-10002,-35784,"(AMETHYSTS, US << MARKET, 10002, 1, 713400)","{""AMETHYSTS"": -4, ""STARFRUIT"": 16}",5292,5068,10003
713500,-5066,-40850,"(STARFRUIT, US << MARKET, 5066, 1, 713500)","{""AMETHYSTS"": -4, ""STARFRUIT"": 17}",5306,5068,10000
713600,5071,-35779,"(STARFRUIT, MARKET << US, 5071, 1, 713600)","{""AMETHYSTS"": -4, ""STARFRUIT"": 16}",5357,5071,10000
713900,10130,-25649,"(STARFRUIT, MARKET << US, 5065, 1, 713900)
(STARFRUIT, MARKET << US, 5065, 1, 713900)","{""AMETHYSTS"": -4, ""STARFRUIT"": 14}",5235,5064,10003
714000,-10002,-35651,"(AMETHYSTS, US << MARKET, 10002, 1, 714000)","{""AMETHYSTS"": -3, ""STARFRUIT"": 14}",5278,5067,10003
714300,-5065,-40716,"(STARFRUIT, US << MARKET, 5065, 1, 714300)","{""AMETHYSTS"": -3, ""STARFRUIT"": 15}",5295,5067,9998
714400,5065,-35651,"(STARFRUIT, MARKET << US, 5065, 1, 714400)","{""AMETHYSTS"": -3, ""STARFRUIT"": 14}",5304,5068,9999
714800,-5070,-40721,"(STARFRUIT, US << MARKET, 5070, 1, 714800)","{""AMETHYSTS"": -3, ""STARFRUIT"": 15}",5329,5070,10000
714900,-60012,-100733,"(AMETHYSTS, US << MARKET, 10002, 1, 714900)
(AMETHYSTS, US << MARKET, 10002, 1, 714900)
(AMETHYSTS, US << MARKET, 10002, 1, 714900)
(AMETHYSTS, US << MARKET, 10002, 1, 714900)
(AMETHYSTS, US << MARKET, 10002, 1, 714900)
(AMETHYSTS, US << MARKET, 10002, 1, 714900)","{""AMETHYSTS"": 3, ""STARFRUIT"": 15}",5284,5068,9999
715600,70028,-30705,"(AMETHYSTS, MARKET << US, 10005, 1, 715600)
(AMETHYSTS, MARKET << US, 10005, 1, 715600)
(AMETHYSTS, MARKET << US, 10005, 1, 715600)
(AMETHYSTS, MARKET << US, 10005, 1, 715600)
(AMETHYSTS, MARKET << US, 10005, 1, 715600)
(AMETHYSTS, MARKET << US, 10005, 1, 715600)
(AMETHYSTS, MARKET << US, 9998, 1, 715600)","{""AMETHYSTS"": -4, ""STARFRUIT"": 15}",5296,5067,10001
715800,10136,-20569,"(STARFRUIT, MARKET << US, 5068, 1, 715800)
(STARFRUIT, MARKET << US, 5068, 1, 715800)","{""AMETHYSTS"": -4, ""STARFRUIT"": 13}",5298,5067,10001
716100,5069,-15500,"(STARFRUIT, MARKET << US, 5069, 1, 716100)","{""AMETHYSTS"": -4, ""STARFRUIT"": 12}",5292,5066,10000
716400,39992,24492,"(AMETHYSTS, MARKET << US, 9998, 1, 716400)
(AMETHYSTS, MARKET << US, 9998, 1, 716400)
(AMETHYSTS, MARKET << US, 9998, 1, 716400)
(AMETHYSTS, MARKET << US, 9998, 1, 716400)","{""AMETHYSTS"": -8, ""STARFRUIT"": 12}",5320,5067,9997
716700,5065,29557,"(STARFRUIT, MARKET << US, 5065, 1, 716700)","{""AMETHYSTS"": -8, ""STARFRUIT"": 11}",5302,5067,9999
716900,-30015,-458,"(AMETHYSTS, US << MARKET, 10005, 1, 716900)
(AMETHYSTS, US << MARKET, 10005, 1, 716900)
(AMETHYSTS, US << MARKET, 10005, 1, 716900)","{""AMETHYSTS"": -5, ""STARFRUIT"": 11}",5279,5067,10000
717100,-5070,-5528,"(STARFRUIT, US << MARKET, 5070, 1, 717100)","{""AMETHYSTS"": -5, ""STARFRUIT"": 12}",5312,5070,10000
717300,130022,124494,"(AMETHYSTS, MARKET << US, 10002, 1, 717300)
(AMETHYSTS, MARKET << US, 10002, 1, 717300)
(AMETHYSTS, MARKET << US, 10002, 1, 717300)
(AMETHYSTS, MARKET << US, 10002, 1, 717300)
(AMETHYSTS, MARKET << US, 10002, 1, 717300)
(AMETHYSTS, MARKET << US, 10002, 1, 717300)
(AMETHYSTS, MARKET << US, 10002, 1, 717300)
(AMETHYSTS, MARKET << US, 10002, 1, 717300)
(AMETHYSTS, MARKET << US, 10002, 1, 717300)
(AMETHYSTS, MARKET << US, 10002, 1, 717300)
(AMETHYSTS, MARKET << US, 10002, 1, 717300)
(AMETHYSTS, MARKET << US, 10002, 1, 717300)
(AMETHYSTS, MARKET << US, 9998, 1, 717300)","{""AMETHYSTS"": -18, ""STARFRUIT"": 12}",5256,5068,10003
717500,5070,129564,"(STARFRUIT, MARKET << US, 5070, 1, 717500)","{""AMETHYSTS"": -18, ""STARFRUIT"": 11}",5316,5070,10001
717600,-20276,109288,"(STARFRUIT, US << MARKET, 5069, 1, 717600)
(STARFRUIT, US << MARKET, 5069, 1, 717600)
(STARFRUIT, US << MARKET, 5069, 1, 717600)
(STARFRUIT, US << MARKET, 5069, 1, 717600)","{""AMETHYSTS"": -18, ""STARFRUIT"": 15}",5338,5070,10000
718400,-50112,59176,"(AMETHYSTS, US << MARKET, 9996, 1, 718400)
(AMETHYSTS, US << MARKET, 9996, 1, 718400)
(AMETHYSTS, US << MARKET, 9996, 1, 718400)
(AMETHYSTS, US << MARKET, 9996, 1, 718400)
(STARFRUIT, US << MARKET, 5064, 1, 718400)
(STARFRUIT, US << MARKET, 5064, 1, 718400)","{""AMETHYSTS"": -14, ""STARFRUIT"": 17}",5315,5067,10000
718700,-15213,43963,"(STARFRUIT, US << MARKET, 5071, 1, 718700)
(STARFRUIT, US << MARKET, 5071, 1, 718700)
(STARFRUIT, US << MARKET, 5071, 1, 718700)","{""AMETHYSTS"": -14, ""STARFRUIT"": 20}",5303,5067,10000
718800,0,43963,,"{""AMETHYSTS"": -14, ""STARFRUIT"": 20}",5283,5066,10000
719000,5063,49026,"(STARFRUIT, MARKET << US, 5063, 1, 719000)","{""AMETHYSTS"": -14, ""STARFRUIT"": 19}",5204,5062,10000
719400,20008,69034,"(AMETHYSTS, MARKET << US, 10004, 1, 719400)
(AMETHYSTS, MARKET << US, 10004, 1, 719400)","{""AMETHYSTS"": -16, ""STARFRUIT"": 19}",5234,5064,10001
719700,5062,74096,"(STARFRUIT, MARKET << US, 5062, 1, 719700)","{""AMETHYSTS"": -16, ""STARFRUIT"": 18}",5266,5065,10000
720500,9998,84094,"(AMETHYSTS, MARKET << US, 9998, 1, 720500)","{""AMETHYSTS"": -17, ""STARFRUIT"": 18}",5332,5065,9996
720600,-5067,79027,"(STARFRUIT, US << MARKET, 5067, 1, 720600)","{""AMETHYSTS"": -17, ""STARFRUIT"": 19}",5319,5068,10000
721000,5067,84094,"(STARFRUIT, MARKET << US, 5067, 1, 721000)","{""AMETHYSTS"": -17, ""STARFRUIT"": 18}",5318,5068,10000
721200,-10002,74092,"(AMETHYSTS, US << MARKET, 10002, 1, 721200)","{""AMETHYSTS"": -16, ""STARFRUIT"": 18}",5214,5065,10003
721600,-10002,64090,"(AMETHYSTS, US << MARKET, 10002, 1, 721600)","{""AMETHYSTS"": -15, ""STARFRUIT"": 18}",5197,5064,10003
721800,20004,84094,"(AMETHYSTS, MARKET << US, 10002, 1, 721800)
(AMETHYSTS, MARKET << US, 10002, 1, 721800)","{""AMETHYSTS"": -17, ""STARFRUIT"": 18}",5213,5065,10003
721900,-5067,79027,"(STARFRUIT, US << MARKET, 5067, 1, 721900)","{""AMETHYSTS"": -17, ""STARFRUIT"": 19}",5351,5067,9997
722400,-29856,49171,"(AMETHYSTS, US << MARKET, 9996, 1, 722400)
(AMETHYSTS, US << MARKET, 9996, 1, 722400)
(AMETHYSTS, US << MARKET, 9996, 1, 722400)
(AMETHYSTS, US << MARKET, 9996, 1, 722400)
(STARFRUIT, MARKET << US, 5064, 1, 722400)
(STARFRUIT, MARKET << US, 5064, 1, 722400)","{""AMETHYSTS"": -13, ""STARFRUIT"": 17}",5272,5064,9999
722700,130,49301,"(AMETHYSTS, US << MARKET, 10004, 1, 722700)
(STARFRUIT, US << MARKET, 5070, 1, 722700)
(STARFRUIT, MARKET << US, 5068, 1, 722700)
(STARFRUIT, MARKET << US, 5068, 1, 722700)
(STARFRUIT, MARKET << US, 5068, 1, 722700)","{""AMETHYSTS"": -12, ""STARFRUIT"": 15}",5276,5065,10000
722800,-10130,39171,"(STARFRUIT, US << MARKET, 5065, 1, 722800)
(STARFRUIT, US << MARKET, 5065, 1, 722800)","{""AMETHYSTS"": -12, ""STARFRUIT"": 17}",5259,5064,10000
723300,20004,59175,"(AMETHYSTS, MARKET << US, 10002, 1, 723300)
(AMETHYSTS, MARKET << US, 10002, 1, 723300)","{""AMETHYSTS"": -14, ""STARFRUIT"": 17}",5255,5066,10003
723400,5068,64243,"(STARFRUIT, MARKET << US, 5068, 1, 723400)","{""AMETHYSTS"": -14, ""STARFRUIT"": 16}",5331,5068,10000
723500,5062,69305,"(STARFRUIT, MARKET << US, 5062, 1, 723500)","{""AMETHYSTS"": -14, ""STARFRUIT"": 15}",5280,5065,10000
723600,-10002,59303,"(AMETHYSTS, US << MARKET, 10002, 1, 723600)","{""AMETHYSTS"": -13, ""STARFRUIT"": 15}",5269,5067,10003
724000,9866,69169,"(AMETHYSTS, MARKET << US, 9995, 1, 724000)
(AMETHYSTS, MARKET << US, 9995, 1, 724000)
(STARFRUIT, US << MARKET, 5062, 1, 724000)
(STARFRUIT, US << MARKET, 5062, 1, 724000)","{""AMETHYSTS"": -15, ""STARFRUIT"": 17}",5274,5065,10000
724100,35441,104610,"(STARFRUIT, US << MARKET, 5063, 1, 724100)
(STARFRUIT, MARKET << US, 5063, 1, 724100)
(STARFRUIT, MARKET << US, 5063, 1, 724100)
(STARFRUIT, MARKET << US, 5063, 1, 724100)
(STARFRUIT, MARKET << US, 5063, 1, 724100)
(STARFRUIT, MARKET << US, 5063, 1, 724100)
(STARFRUIT, MARKET << US, 5063, 1, 724100)
(STARFRUIT, MARKET << US, 5063, 1, 724100)
(STARFRUIT, MARKET << US, 5063, 1, 724100)","{""AMETHYSTS"": -15, ""STARFRUIT"": 10}",5260,5065,10000
724400,20264,124874,"(STARFRUIT, MARKET << US, 5066, 1, 724400)
(STARFRUIT, MARKET << US, 5066, 1, 724400)
(STARFRUIT, MARKET << US, 5066, 1, 724400)
(STARFRUIT, MARKET << US, 5066, 1, 724400)","{""AMETHYSTS"": -15, ""STARFRUIT"": 6}",5282,5063,9998
724700,5061,129935,"(STARFRUIT, MARKET << US, 5061, 1, 724700)","{""AMETHYSTS"": -15, ""STARFRUIT"": 5}",5255,5064,10000
725100,-30116,99819,"(AMETHYSTS, US << MARKET, 9998, 1, 725100)
(AMETHYSTS, US << MARKET, 9998, 1, 725100)
(STARFRUIT, US << MARKET, 5060, 1, 725100)
(STARFRUIT, US << MARKET, 5060, 1, 725100)","{""AMETHYSTS"": -13, ""STARFRUIT"": 7}",5247,5063,10001
725300,-5061,94758,"(STARFRUIT, US << MARKET, 5061, 1, 725300)","{""AMETHYSTS"": -13, ""STARFRUIT"": 8}",5270,5064,10000
725400,-99950,-5192,"(AMETHYSTS, US << MARKET, 9995, 1, 725400)
(AMETHYSTS, US << MARKET, 9995, 1, 725400)
(AMETHYSTS, US << MARKET, 9995, 1, 725400)
(AMETHYSTS, US << MARKET, 9995, 1, 725400)
(AMETHYSTS, US << MARKET, 9995, 1, 725400)
(AMETHYSTS, US << MARKET, 9995, 1, 725400)
(AMETHYSTS, US << MARKET, 9995, 1, 725400)
(AMETHYSTS, US << MARKET, 9995, 1, 725400)
(AMETHYSTS, US << MARKET, 9995, 1, 725400)
(AMETHYSTS, US << MARKET, 9995, 1, 725400)","{""AMETHYSTS"": -3, ""STARFRUIT"": 8}",5328,5065,10000
725800,30366,25174,"(STARFRUIT, MARKET << US, 5061, 1, 725800)
(STARFRUIT, MARKET << US, 5061, 1, 725800)
(STARFRUIT, MARKET << US, 5061, 1, 725800)
(STARFRUIT, MARKET << US, 5061, 1, 725800)
(STARFRUIT, MARKET << US, 5061, 1, 725800)
(STARFRUIT, MARKET << US, 5061, 1, 725800)","{""AMETHYSTS"": -3, ""STARFRUIT"": 2}",5302,5064,10000
726000,-10134,15040,"(STARFRUIT, US << MARKET, 5067, 1, 726000)
(STARFRUIT, US << MARKET, 5067, 1, 726000)","{""AMETHYSTS"": -3, ""STARFRUIT"": 4}",5298,5063,9998
726400,-2,15038,"(STARFRUIT, US << MARKET, 5066, 1, 726400)
(STARFRUIT, US << MARKET, 5066, 1, 726400)
(STARFRUIT, MARKET << US, 5065, 1, 726400)
(STARFRUIT, MARKET << US, 5065, 1, 726400)","{""AMETHYSTS"": -3, ""STARFRUIT"": 4}",5306,5067,10000
726600,-120024,-104986,"(AMETHYSTS, US << MARKET, 10002, 1, 726600)
(AMETHYSTS, US << MARKET, 10002, 1, 726600)
(AMETHYSTS, US << MARKET, 10002, 1, 726600)
(AMETHYSTS, US << MARKET, 10002, 1, 726600)
(AMETHYSTS, US << MARKET, 10002, 1, 726600)
(AMETHYSTS, US << MARKET, 10002, 1, 726600)
(AMETHYSTS, US << MARKET, 10002, 1, 726600)
(AMETHYSTS, US << MARKET, 10002, 1, 726600)
(AMETHYSTS, US << MARKET, 10002, 1, 726600)
(AMETHYSTS, US << MARKET, 10002, 1, 726600)
(AMETHYSTS, US << MARKET, 10002, 1, 726600)
(AMETHYSTS, US << MARKET, 10002, 1, 726600)","{""AMETHYSTS"": 9, ""STARFRUIT"": 4}",5297,5064,10003
727000,0,-104986,"(STARFRUIT, US << MARKET, 5063, 1, 727000)
(STARFRUIT, US << MARKET, 5063, 1, 727000)
(STARFRUIT, US << MARKET, 5063, 1, 727000)
(STARFRUIT, US << MARKET, 5063, 1, 727000)
(STARFRUIT, MARKET << US, 5063, 1, 727000)
(STARFRUIT, MARKET << US, 5063, 1, 727000)
(STARFRUIT, MARKET << US, 5063, 1, 727000)
(STARFRUIT, MARKET << US, 5063, 1, 727000)","{""AMETHYSTS"": 9, ""STARFRUIT"": 4}",5292,5065,10002
727100,-15183,-120169,"(STARFRUIT, US << MARKET, 5061, 1, 727100)
(STARFRUIT, US << MARKET, 5061, 1, 727100)
(STARFRUIT, US << MARKET, 5061, 1, 727100)","{""AMETHYSTS"": 9, ""STARFRUIT"": 7}",5251,5060,10000
727200,35054,-85115,"(AMETHYSTS, MARKET << US, 9998, 1, 727200)
(AMETHYSTS, MARKET << US, 9998, 1, 727200)
(AMETHYSTS, MARKET << US, 9998, 1, 727200)
(STARFRUIT, MARKET << US, 5060, 1, 727200)","{""AMETHYSTS"": 6, ""STARFRUIT"": 6}",5245,5063,9997
727300,4812,-80303,"(AMETHYSTS, MARKET << US, 10002, 1, 727300)
(AMETHYSTS, MARKET << US, 10002, 1, 727300)
(STARFRUIT, US << MARKET, 5064, 1, 727300)
(STARFRUIT, US << MARKET, 5064, 1, 727300)
(STARFRUIT, US << MARKET, 5064, 1, 727300)","{""AMETHYSTS"": 4, ""STARFRUIT"": 9}",5294,5065,10003
727400,-25049,-105352,"(AMETHYSTS, US << MARKET, 9995, 1, 727400)
(AMETHYSTS, US << MARKET, 9995, 1, 727400)
(STARFRUIT, US << MARKET, 5059, 1, 727400)","{""AMETHYSTS"": 6, ""STARFRUIT"": 10}",5268,5062,10000
727500,-5064,-110416,"(STARFRUIT, US << MARKET, 5064, 1, 727500)","{""AMETHYSTS"": 6, ""STARFRUIT"": 11}",5305,5065,10001
727700,-5065,-115481,"(STARFRUIT, US << MARKET, 5065, 1, 727700)","{""AMETHYSTS"": 6, ""STARFRUIT"": 12}",5311,5066,10000
727800,-10002,-125483,"(AMETHYSTS, US << MARKET, 10002, 1, 727800)","{""AMETHYSTS"": 7, ""STARFRUIT"": 12}",5294,5063,10003
727900,9876,-115607,"(AMETHYSTS, MARKET << US, 10002, 1, 727900)
(AMETHYSTS, MARKET << US, 10002, 1, 727900)
(STARFRUIT, US << MARKET, 5064, 1, 727900)
(STARFRUIT, US << MARKET, 5064, 1, 727900)","{""AMETHYSTS"": 5, ""STARFRUIT"": 14}",5318,5065,10003
728100,-5066,-120673,"(STARFRUIT, US << MARKET, 5066, 1, 728100)","{""AMETHYSTS"": 5, ""STARFRUIT"": 15}",5332,5067,10000
728200,-10004,-130677,"(AMETHYSTS, US << MARKET, 10004, 1, 728200)","{""AMETHYSTS"": 6, ""STARFRUIT"": 15}",5289,5064,10001
728700,-20248,-150925,"(STARFRUIT, US << MARKET, 5062, 1, 728700)
(STARFRUIT, US << MARKET, 5062, 1, 728700)
(STARFRUIT, US << MARKET, 5062, 1, 728700)
(STARFRUIT, US << MARKET, 5062, 1, 728700)","{""AMETHYSTS"": 6, ""STARFRUIT"": 19}",5228,5061,9999
728900,-10002,-160927,"(AMETHYSTS, US << MARKET, 10002, 1, 728900)","{""AMETHYSTS"": 7, ""STARFRUIT"": 19}",5310,5064,10003
729000,19992,-140935,"(AMETHYSTS, MARKET << US, 9996, 1, 729000)
(AMETHYSTS, MARKET << US, 9996, 1, 729000)","{""AMETHYSTS"": 5, ""STARFRUIT"": 19}",5276,5064,9999
729500,-15071,-156006,"(AMETHYSTS, US << MARKET, 10004, 1, 729500)
(STARFRUIT, US << MARKET, 5067, 1, 729500)","{""AMETHYSTS"": 6, ""STARFRUIT"": 20}",5254,5063,10000
729700,0,-156006,,"{""AMETHYSTS"": 6, ""STARFRUIT"": 20}",5254,5063,10000
730000,-4937,-160943,"(AMETHYSTS, US << MARKET, 10002, 1, 730000)
(STARFRUIT, MARKET << US, 5065, 1, 730000)","{""AMETHYSTS"": 7, ""STARFRUIT"": 19}",5294,5064,10003
730200,-29995,-190938,"(AMETHYSTS, US << MARKET, 9996, 1, 730200)
(AMETHYSTS, US << MARKET, 9996, 1, 730200)
(AMETHYSTS, US << MARKET, 9996, 1, 730200)
(AMETHYSTS, US << MARKET, 9996, 1, 730200)
(AMETHYSTS, US << MARKET, 9996, 1, 730200)
(AMETHYSTS, US << MARKET, 9996, 1, 730200)
(AMETHYSTS, US << MARKET, 9996, 1, 730200)
(AMETHYSTS, US << MARKET, 9996, 1, 730200)
(AMETHYSTS, US << MARKET, 9996, 1, 730200)
(AMETHYSTS, US << MARKET, 9996, 1, 730200)
(AMETHYSTS, US << MARKET, 9996, 1, 730200)
(AMETHYSTS, US << MARKET, 9996, 1, 730200)
(AMETHYSTS, MARKET << US, 9996, 1, 730200)
(AMETHYSTS, MARKET << US, 9996, 1, 730200)
(AMETHYSTS, MARKET << US, 9995, 1, 730200)
(AMETHYSTS, MARKET << US, 9995, 1, 730200)
(AMETHYSTS, MARKET << US, 9995, 1, 730200)
(AMETHYSTS, MARKET << US, 9995, 1, 730200)
(AMETHYSTS, MARKET << US, 9995, 1, 730200)
(AMETHYSTS, MARKET << US, 9995, 1, 730200)
(AMETHYSTS, MARKET << US, 9995, 1, 730200)","{""AMETHYSTS"": 10, ""STARFRUIT"": 19}",5240,5062,10000
730400,104895,-86043,"(AMETHYSTS, MARKET << US, 9996, 1, 730400)
(AMETHYSTS, MARKET << US, 9996, 1, 730400)
(AMETHYSTS, MARKET << US, 9996, 1, 730400)
(AMETHYSTS, MARKET << US, 9996, 1, 730400)
(AMETHYSTS, MARKET << US, 9996, 1, 730400)
(AMETHYSTS, MARKET << US, 9996, 1, 730400)
(AMETHYSTS, MARKET << US, 9996, 1, 730400)
(AMETHYSTS, MARKET << US, 9996, 1, 730400)
(AMETHYSTS, MARKET << US, 9996, 1, 730400)
(AMETHYSTS, MARKET << US, 9996, 1, 730400)
(AMETHYSTS, MARKET << US, 9996, 1, 730400)
(STARFRUIT, US << MARKET, 5061, 1, 730400)","{""AMETHYSTS"": -1, ""STARFRUIT"": 20}",5139,5059,9998
730800,85079,-964,"(AMETHYSTS, MARKET << US, 10002, 1, 730800)
(AMETHYSTS, MARKET << US, 10002, 1, 730800)
(AMETHYSTS, MARKET << US, 10002, 1, 730800)
(AMETHYSTS, MARKET << US, 10002, 1, 730800)
(AMETHYSTS, MARKET << US, 10002, 1, 730800)
(AMETHYSTS, MARKET << US, 10002, 1, 730800)
(AMETHYSTS, MARKET << US, 10002, 1, 730800)
(AMETHYSTS, MARKET << US, 10002, 1, 730800)
(STARFRUIT, MARKET << US, 5063, 1, 730800)","{""AMETHYSTS"": -9, ""STARFRUIT"": 19}",5206,5063,10003
730900,5063,4099,"(STARFRUIT, MARKET << US, 5063, 1, 730900)","{""AMETHYSTS"": -9, ""STARFRUIT"": 18}",5197,5062,10002
731300,-10002,-5903,"(AMETHYSTS, US << MARKET, 10002, 1, 731300)","{""AMETHYSTS"": -8, ""STARFRUIT"": 18}",5153,5060,10003
731500,2,-5901,"(AMETHYSTS, US << MARKET, 10002, 1, 731500)
(AMETHYSTS, US << MARKET, 10004, 1, 731500)
(AMETHYSTS, US << MARKET, 10004, 1, 731500)
(AMETHYSTS, US << MARKET, 10004, 1, 731500)
(AMETHYSTS, MARKET << US, 10004, 1, 731500)
(AMETHYSTS, MARKET << US, 10004, 1, 731500)
(AMETHYSTS, MARKET << US, 10004, 1, 731500)
(AMETHYSTS, MARKET << US, 10004, 1, 731500)","{""AMETHYSTS"": -8, ""STARFRUIT"": 18}",5137,5059,10003
731600,14945,9044,"(AMETHYSTS, MARKET << US, 10004, 1, 731600)
(AMETHYSTS, MARKET << US, 10004, 1, 731600)
(STARFRUIT, US << MARKET, 5063, 1, 731600)","{""AMETHYSTS"": -10, ""STARFRUIT"": 19}",5165,5059,10000
731700,5061,14105,"(STARFRUIT, MARKET << US, 5061, 1, 731700)","{""AMETHYSTS"": -10, ""STARFRUIT"": 18}",5221,5062,10000
732200,-60030,-45925,"(AMETHYSTS, US << MARKET, 10005, 1, 732200)
(AMETHYSTS, US << MARKET, 10005, 1, 732200)
(AMETHYSTS, US << MARKET, 10005, 1, 732200)
(AMETHYSTS, US << MARKET, 10005, 1, 732200)
(AMETHYSTS, US << MARKET, 10005, 1, 732200)
(AMETHYSTS, US << MARKET, 10005, 1, 732200)","{""AMETHYSTS"": -4, ""STARFRUIT"": 18}",5137,5059,10000
732700,-5058,-50983,"(STARFRUIT, US << MARKET, 5058, 1, 732700)","{""AMETHYSTS"": -4, ""STARFRUIT"": 19}",5176,5061,10000
732800,-10002,-60985,"(AMETHYSTS, US << MARKET, 10002, 1, 732800)","{""AMETHYSTS"": -3, ""STARFRUIT"": 19}",5184,5062,10003
733000,-5063,-66048,"(STARFRUIT, US << MARKET, 5063, 1, 733000)","{""AMETHYSTS"": -3, ""STARFRUIT"": 20}",5212,5063,10000
733500,-19996,-86044,"(AMETHYSTS, US << MARKET, 9998, 1, 733500)
(AMETHYSTS, US << MARKET, 9998, 1, 733500)","{""AMETHYSTS"": -1, ""STARFRUIT"": 20}",5160,5060,9996
733800,20004,-66040,"(AMETHYSTS, MARKET << US, 10002, 1, 733800)
(AMETHYSTS, MARKET << US, 10002, 1, 733800)","{""AMETHYSTS"": -3, ""STARFRUIT"": 20}",5151,5060,10003
734200,-39992,-106032,"(AMETHYSTS, US << MARKET, 9998, 1, 734200)
(AMETHYSTS, US << MARKET, 9998, 1, 734200)
(AMETHYSTS, US << MARKET, 9998, 1, 734200)
(AMETHYSTS, US << MARKET, 9998, 1, 734200)","{""AMETHYSTS"": 1, ""STARFRUIT"": 20}",5149,5059,10001
734400,-9876,-115908,"(AMETHYSTS, US << MARKET, 9996, 1, 734400)
(AMETHYSTS, US << MARKET, 9996, 1, 734400)
(STARFRUIT, MARKET << US, 5058, 1, 734400)
(STARFRUIT, MARKET << US, 5058, 1, 734400)","{""AMETHYSTS"": 3, ""STARFRUIT"": 18}",5118,5057,10000
734500,4938,-110970,"(AMETHYSTS, MARKET << US, 9995, 1, 734500)
(STARFRUIT, US << MARKET, 5057, 1, 734500)","{""AMETHYSTS"": 2, ""STARFRUIT"": 19}",5170,5060,10000
734700,-24954,-135924,"(AMETHYSTS, US << MARKET, 10004, 1, 734700)
(AMETHYSTS, US << MARKET, 10004, 1, 734700)
(AMETHYSTS, US << MARKET, 10004, 1, 734700)
(STARFRUIT, MARKET << US, 5058, 1, 734700)","{""AMETHYSTS"": 5, ""STARFRUIT"": 18}",5156,5060,10000
734900,4940,-130984,"(AMETHYSTS, MARKET << US, 9998, 1, 734900)
(STARFRUIT, US << MARKET, 5058, 1, 734900)","{""AMETHYSTS"": 4, ""STARFRUIT"": 19}",5160,5060,10001
735000,-39984,-170968,"(AMETHYSTS, US << MARKET, 9996, 1, 735000)
(AMETHYSTS, US << MARKET, 9996, 1, 735000)
(AMETHYSTS, US << MARKET, 9996, 1, 735000)
(AMETHYSTS, US << MARKET, 9996, 1, 735000)","{""AMETHYSTS"": 8, ""STARFRUIT"": 19}",5191,5061,10000
735700,5064,-165904,"(STARFRUIT, MARKET << US, 5064, 1, 735700)","{""AMETHYSTS"": 8, ""STARFRUIT"": 18}",5176,5060,10000
736100,50370,-115534,"(AMETHYSTS, MARKET << US, 10002, 1, 736100)
(AMETHYSTS, MARKET << US, 10002, 1, 736100)
(STARFRUIT, MARKET << US, 5061, 1, 736100)
(STARFRUIT, MARKET << US, 5061, 1, 736100)
(STARFRUIT, MARKET << US, 5061, 1, 736100)
(STARFRUIT, MARKET << US, 5061, 1, 736100)
(STARFRUIT, MARKET << US, 5061, 1, 736100)
(STARFRUIT, MARKET << US, 5061, 1, 736100)","{""AMETHYSTS"": 6, ""STARFRUIT"": 12}",5174,5060,9998
736300,20004,-95530,"(AMETHYSTS, MARKET << US, 10002, 1, 736300)
(AMETHYSTS, MARKET << US, 10002, 1, 736300)","{""AMETHYSTS"": 4, ""STARFRUIT"": 12}",5214,5061,10003
736400,-40008,-135538,"(AMETHYSTS, US << MARKET, 10002, 1, 736400)
(AMETHYSTS, US << MARKET, 10002, 1, 736400)
(AMETHYSTS, US << MARKET, 10002, 1, 736400)
(AMETHYSTS, US << MARKET, 10002, 1, 736400)","{""AMETHYSTS"": 8, ""STARFRUIT"": 12}",5214,5062,10001
736500,-30254,-165792,"(AMETHYSTS, US << MARKET, 10002, 1, 736500)
(STARFRUIT, US << MARKET, 5063, 1, 736500)
(STARFRUIT, US << MARKET, 5063, 1, 736500)
(STARFRUIT, US << MARKET, 5063, 1, 736500)
(STARFRUIT, US << MARKET, 5063, 1, 736500)","{""AMETHYSTS"": 9, ""STARFRUIT"": 16}",5223,5064,9999
736900,-15069,-180861,"(AMETHYSTS, US << MARKET, 10004, 1, 736900)
(STARFRUIT, US << MARKET, 5065, 1, 736900)","{""AMETHYSTS"": 10, ""STARFRUIT"": 17}",5186,5061,10001
737200,5062,-175799,"(STARFRUIT, MARKET << US, 5062, 1, 737200)","{""AMETHYSTS"": 10, ""STARFRUIT"": 16}",5199,5063,9999
737500,-15189,-190988,"(STARFRUIT, US << MARKET, 5063, 1, 737500)
(STARFRUIT, US << MARKET, 5063, 1, 737500)
(STARFRUIT, US << MARKET, 5063, 1, 737500)","{""AMETHYSTS"": 10, ""STARFRUIT"": 19}",5152,5060,10000
738000,20004,-170984,"(AMETHYSTS, MARKET << US, 10002, 1, 738000)
(AMETHYSTS, MARKET << US, 10002, 1, 738000)","{""AMETHYSTS"": 8, ""STARFRUIT"": 19}",5148,5060,9999
738300,-34935,-205919,"(AMETHYSTS, US << MARKET, 9998, 1, 738300)
(AMETHYSTS, US << MARKET, 9998, 1, 738300)
(AMETHYSTS, US << MARKET, 9998, 1, 738300)
(AMETHYSTS, US << MARKET, 9998, 1, 738300)
(STARFRUIT, MARKET << US, 5057, 1, 738300)","{""AMETHYSTS"": 12, ""STARFRUIT"": 18}",5053,5056,9997
738900,9998,-195921,"(AMETHYSTS, US << MARKET, 9998, 1, 738900)
(AMETHYSTS, US << MARKET, 9998, 1, 738900)
(AMETHYSTS, MARKET << US, 9998, 1, 738900)
(AMETHYSTS, MARKET << US, 9998, 1, 738900)
(AMETHYSTS, MARKET << US, 9998, 1, 738900)","{""AMETHYSTS"": 11, ""STARFRUIT"": 18}",5097,5059,9996
739600,49990,-145931,"(AMETHYSTS, MARKET << US, 9998, 1, 739600)
(AMETHYSTS, MARKET << US, 9998, 1, 739600)
(AMETHYSTS, MARKET << US, 9998, 1, 739600)
(AMETHYSTS, MARKET << US, 9998, 1, 739600)
(AMETHYSTS, MARKET << US, 9998, 1, 739600)","{""AMETHYSTS"": 6, ""STARFRUIT"": 18}",5131,5059,10000
740100,5062,-140869,"(STARFRUIT, MARKET << US, 5062, 1, 740100)","{""AMETHYSTS"": 6, ""STARFRUIT"": 17}",5185,5062,10000
740300,-5062,-145931,"(STARFRUIT, US << MARKET, 5062, 1, 740300)","{""AMETHYSTS"": 6, ""STARFRUIT"": 18}",5185,5062,10000
740600,14953,-130978,"(AMETHYSTS, MARKET << US, 10005, 1, 740600)
(AMETHYSTS, MARKET << US, 10005, 1, 740600)
(STARFRUIT, US << MARKET, 5057, 1, 740600)","{""AMETHYSTS"": 4, ""STARFRUIT"": 19}",5086,5056,10000
740800,-15061,-146039,"(AMETHYSTS, US << MARKET, 10004, 1, 740800)
(STARFRUIT, US << MARKET, 5057, 1, 740800)","{""AMETHYSTS"": 5, ""STARFRUIT"": 20}",5081,5056,10000
740900,0,-146039,,"{""AMETHYSTS"": 5, ""STARFRUIT"": 20}",5141,5059,10000
741700,120024,-26015,"(AMETHYSTS, MARKET << US, 10002, 1, 741700)
(AMETHYSTS, MARKET << US, 10002, 1, 741700)
(AMETHYSTS, MARKET << US, 10002, 1, 741700)
(AMETHYSTS, MARKET << US, 10002, 1, 741700)
(AMETHYSTS, MARKET << US, 10002, 1, 741700)
(AMETHYSTS, MARKET << US, 10002, 1, 741700)
(AMETHYSTS, MARKET << US, 10002, 1, 741700)
(AMETHYSTS, MARKET << US, 10002, 1, 741700)
(AMETHYSTS, MARKET << US, 10002, 1, 741700)
(AMETHYSTS, MARKET << US, 10002, 1, 741700)
(AMETHYSTS, MARKET << US, 10002, 1, 741700)
(AMETHYSTS, MARKET << US, 10002, 1, 741700)","{""AMETHYSTS"": -7, ""STARFRUIT"": 20}",5204,5062,10003
741900,5056,-20959,"(STARFRUIT, MARKET << US, 5056, 1, 741900)","{""AMETHYSTS"": -7, ""STARFRUIT"": 19}",5181,5060,10000
742200,20108,-851,"(AMETHYSTS, MARKET << US, 9996, 1, 742200)
(STARFRUIT, MARKET << US, 5056, 1, 742200)
(STARFRUIT, MARKET << US, 5056, 1, 742200)","{""AMETHYSTS"": -8, ""STARFRUIT"": 17}",5152,5059,10000
742400,-19996,-20847,"(AMETHYSTS, US << MARKET, 9998, 1, 742400)
(AMETHYSTS, US << MARKET, 9998, 1, 742400)","{""AMETHYSTS"": -6, ""STARFRUIT"": 17}",5150,5059,10001
742500,-35167,-56014,"(AMETHYSTS, US << MARKET, 9998, 1, 742500)
(AMETHYSTS, US << MARKET, 9998, 1, 742500)
(STARFRUIT, US << MARKET, 5057, 1, 742500)
(STARFRUIT, US << MARKET, 5057, 1, 742500)
(STARFRUIT, US << MARKET, 5057, 1, 742500)","{""AMETHYSTS"": -4, ""STARFRUIT"": 20}",5198,5060,9997
742700,-79984,-135998,"(AMETHYSTS, US << MARKET, 9998, 1, 742700)
(AMETHYSTS, US << MARKET, 9998, 1, 742700)
(AMETHYSTS, US << MARKET, 9998, 1, 742700)
(AMETHYSTS, US << MARKET, 9998, 1, 742700)
(AMETHYSTS, US << MARKET, 9998, 1, 742700)
(AMETHYSTS, US << MARKET, 9998, 1, 742700)
(AMETHYSTS, US << MARKET, 9998, 1, 742700)
(AMETHYSTS, US << MARKET, 9998, 1, 742700)","{""AMETHYSTS"": 4, ""STARFRUIT"": 20}",5210,5061,9997
743100,-19996,-155994,"(AMETHYSTS, US << MARKET, 9998, 1, 743100)
(AMETHYSTS, US << MARKET, 9998, 1, 743100)","{""AMETHYSTS"": 6, ""STARFRUIT"": 20}",5212,5060,10001
743200,5057,-150937,"(STARFRUIT, MARKET << US, 5057, 1, 743200)","{""AMETHYSTS"": 6, ""STARFRUIT"": 19}",5203,5060,10000
743600,-5055,-155992,"(STARFRUIT, US << MARKET, 5055, 1, 743600)","{""AMETHYSTS"": 6, ""STARFRUIT"": 20}",5168,5058,10000
743700,55436,-100556,"(AMETHYSTS, MARKET << US, 10002, 1, 743700)
(AMETHYSTS, MARKET << US, 10002, 1, 743700)
(STARFRUIT, MARKET << US, 5062, 1, 743700)
(STARFRUIT, MARKET << US, 5062, 1, 743700)
(STARFRUIT, MARKET << US, 5062, 1, 743700)
(STARFRUIT, MARKET << US, 5062, 1, 743700)
(STARFRUIT, MARKET << US, 5062, 1, 743700)
(STARFRUIT, MARKET << US, 5062, 1, 743700)
(STARFRUIT, MARKET << US, 5060, 1, 743700)","{""AMETHYSTS"": 4, ""STARFRUIT"": 13}",5249,5061,10003
743900,180036,79480,"(AMETHYSTS, MARKET << US, 10002, 1, 743900)
(AMETHYSTS, MARKET << US, 10002, 1, 743900)
(AMETHYSTS, MARKET << US, 10002, 1, 743900)
(AMETHYSTS, MARKET << US, 10002, 1, 743900)
(AMETHYSTS, MARKET << US, 10002, 1, 743900)
(AMETHYSTS, MARKET << US, 10002, 1, 743900)
(AMETHYSTS, MARKET << US, 10002, 1, 743900)
(AMETHYSTS, MARKET << US, 10002, 1, 743900)
(AMETHYSTS, MARKET << US, 10002, 1, 743900)
(AMETHYSTS, MARKET << US, 10002, 1, 743900)
(AMETHYSTS, MARKET << US, 10002, 1, 743900)
(AMETHYSTS, MARKET << US, 10002, 1, 743900)
(AMETHYSTS, MARKET << US, 10002, 1, 743900)
(AMETHYSTS, MARKET << US, 10002, 1, 743900)
(AMETHYSTS, MARKET << US, 10002, 1, 743900)
(AMETHYSTS, MARKET << US, 10002, 1, 743900)
(AMETHYSTS, MARKET << US, 10002, 1, 743900)
(AMETHYSTS, MARKET << US, 10002, 1, 743900)","{""AMETHYSTS"": -14, ""STARFRUIT"": 13}",5248,5058,9999
744000,-10003,69477,"(AMETHYSTS, US << MARKET, 10004, 1, 744000)
(STARFRUIT, US << MARKET, 5060, 1, 744000)
(STARFRUIT, MARKET << US, 5061, 1, 744000)","{""AMETHYSTS"": -13, ""STARFRUIT"": 13}",5231,5058,10000
744200,-5061,64416,"(STARFRUIT, US << MARKET, 5061, 1, 744200)","{""AMETHYSTS"": -13, ""STARFRUIT"": 14}",5284,5062,10000
744400,-30122,34294,"(AMETHYSTS, US << MARKET, 9998, 1, 744400)
(AMETHYSTS, US << MARKET, 9998, 1, 744400)
(STARFRUIT, US << MARKET, 5063, 1, 744400)
(STARFRUIT, US << MARKET, 5063, 1, 744400)","{""AMETHYSTS"": -11, ""STARFRUIT"": 16}",5287,5060,9997
745000,-5056,29238,"(STARFRUIT, US << MARKET, 5056, 1, 745000)","{""AMETHYSTS"": -11, ""STARFRUIT"": 17}",5257,5058,9997
745100,-5057,24181,"(STARFRUIT, US << MARKET, 5057, 1, 745100)","{""AMETHYSTS"": -11, ""STARFRUIT"": 18}",5257,5061,10002
745400,-5057,19124,"(STARFRUIT, US << MARKET, 5057, 1, 745400)","{""AMETHYSTS"": -11, ""STARFRUIT"": 19}",5294,5061,9999
745600,80465,99589,"(AMETHYSTS, MARKET << US, 10004, 1, 745600)
(AMETHYSTS, MARKET << US, 10004, 1, 745600)
(AMETHYSTS, MARKET << US, 10004, 1, 745600)
(AMETHYSTS, MARKET << US, 10004, 1, 745600)
(STARFRUIT, US << MARKET, 5064, 1, 745600)
(STARFRUIT, MARKET << US, 5057, 1, 745600)
(STARFRUIT, MARKET << US, 5057, 1, 745600)
(STARFRUIT, MARKET << US, 5057, 1, 745600)
(STARFRUIT, MARKET << US, 5057, 1, 745600)
(STARFRUIT, MARKET << US, 5057, 1, 745600)
(STARFRUIT, MARKET << US, 5057, 1, 745600)
(STARFRUIT, MARKET << US, 5057, 1, 745600)
(STARFRUIT, MARKET << US, 5057, 1, 745600)
(STARFRUIT, MARKET << US, 5057, 1, 745600)","{""AMETHYSTS"": -15, ""STARFRUIT"": 11}",5249,5060,10000
745800,-4,99585,"(AMETHYSTS, US << MARKET, 10002, 1, 745800)
(AMETHYSTS, US << MARKET, 10002, 1, 745800)
(AMETHYSTS, MARKET << US, 10002, 1, 745800)
(AMETHYSTS, MARKET << US, 10002, 1, 745800)
(STARFRUIT, US << MARKET, 5064, 1, 745800)
(STARFRUIT, US << MARKET, 5064, 1, 745800)
(STARFRUIT, MARKET << US, 5062, 1, 745800)
(STARFRUIT, MARKET << US, 5062, 1, 745800)","{""AMETHYSTS"": -15, ""STARFRUIT"": 11}",5293,5063,9999
746300,-15171,84414,"(STARFRUIT, US << MARKET, 5057, 1, 746300)
(STARFRUIT, US << MARKET, 5057, 1, 746300)
(STARFRUIT, US << MARKET, 5057, 1, 746300)","{""AMETHYSTS"": -15, ""STARFRUIT"": 14}",5198,5056,10000
746800,15058,99472,"(AMETHYSTS, MARKET << US, 10000, 1, 746800)
(STARFRUIT, MARKET << US, 5058, 1, 746800)","{""AMETHYSTS"": -16, ""STARFRUIT"": 13}",5248,5056,9997
747100,-19992,79480,"(AMETHYSTS, US << MARKET, 9996, 1, 747100)
(AMETHYSTS, US << MARKET, 9996, 1, 747100)","{""AMETHYSTS"": -14, ""STARFRUIT"": 13}",5234,5058,10000
747200,-5060,74420,"(STARFRUIT, US << MARKET, 5060, 1, 747200)","{""AMETHYSTS"": -14, ""STARFRUIT"": 14}",5260,5060,10000
747300,40440,114860,"(STARFRUIT, MARKET << US, 5055, 1, 747300)
(STARFRUIT, MARKET << US, 5055, 1, 747300)
(STARFRUIT, MARKET << US, 5055, 1, 747300)
(STARFRUIT, MARKET << US, 5055, 1, 747300)
(STARFRUIT, MARKET << US, 5055, 1, 747300)
(STARFRUIT, MARKET << US, 5055, 1, 747300)
(STARFRUIT, MARKET << US, 5055, 1, 747300)
(STARFRUIT, MARKET << US, 5055, 1, 747300)","{""AMETHYSTS"": -14, ""STARFRUIT"": 6}",5208,5058,10000
747600,-15174,99686,"(STARFRUIT, US << MARKET, 5058, 1, 747600)
(STARFRUIT, US << MARKET, 5058, 1, 747600)
(STARFRUIT, US << MARKET, 5058, 1, 747600)","{""AMETHYSTS"": -14, ""STARFRUIT"": 9}",5194,5058,10001
747700,49990,149676,"(AMETHYSTS, MARKET << US, 9998, 1, 747700)
(AMETHYSTS, MARKET << US, 9998, 1, 747700)
(AMETHYSTS, MARKET << US, 9998, 1, 747700)
(AMETHYSTS, MARKET << US, 9998, 1, 747700)
(AMETHYSTS, MARKET << US, 9998, 1, 747700)","{""AMETHYSTS"": -19, ""STARFRUIT"": 9}",5255,5058,9997
748800,9998,159674,"(AMETHYSTS, MARKET << US, 9998, 1, 748800)","{""AMETHYSTS"": -20, ""STARFRUIT"": 9}",5167,5057,10001
749100,0,159674,,"{""AMETHYSTS"": -20, ""STARFRUIT"": 9}",5216,5058,9999
749200,25285,184959,"(STARFRUIT, MARKET << US, 5057, 1, 749200)
(STARFRUIT, MARKET << US, 5057, 1, 749200)
(STARFRUIT, MARKET << US, 5057, 1, 749200)
(STARFRUIT, MARKET << US, 5057, 1, 749200)
(STARFRUIT, MARKET << US, 5057, 1, 749200)","{""AMETHYSTS"": -20, ""STARFRUIT"": 4}",5223,5056,9998
749300,20216,205175,"(STARFRUIT, MARKET << US, 5054, 1, 749300)
(STARFRUIT, MARKET << US, 5054, 1, 749300)
(STARFRUIT, MARKET << US, 5054, 1, 749300)
(STARFRUIT, MARKET << US, 5054, 1, 749300)","{""AMETHYSTS"": -20, ""STARFRUIT"": 0}",5215,5057,9998
749400,-19992,185183,"(AMETHYSTS, US << MARKET, 9996, 1, 749400)
(AMETHYSTS, US << MARKET, 9996, 1, 749400)","{""AMETHYSTS"": -18, ""STARFRUIT"": 0}",5183,5057,10000
749600,20004,205187,"(AMETHYSTS, MARKET << US, 10002, 1, 749600)
(AMETHYSTS, MARKET << US, 10002, 1, 749600)","{""AMETHYSTS"": -20, ""STARFRUIT"": 0}",5127,5058,10003
750400,5060,210247,"(STARFRUIT, MARKET << US, 5060, 1, 750400)","{""AMETHYSTS"": -20, ""STARFRUIT"": -1}",5226,5061,9998
751000,-134882,75365,"(AMETHYSTS, US << MARKET, 9996, 1, 751000)
(AMETHYSTS, US << MARKET, 9996, 1, 751000)
(AMETHYSTS, US << MARKET, 9996, 1, 751000)
(AMETHYSTS, US << MARKET, 9996, 1, 751000)
(AMETHYSTS, US << MARKET, 9996, 1, 751000)
(AMETHYSTS, US << MARKET, 9996, 1, 751000)
(AMETHYSTS, US << MARKET, 9996, 1, 751000)
(AMETHYSTS, US << MARKET, 9996, 1, 751000)
(AMETHYSTS, US << MARKET, 9996, 1, 751000)
(AMETHYSTS, US << MARKET, 9996, 1, 751000)
(AMETHYSTS, US << MARKET, 9996, 1, 751000)
(AMETHYSTS, US << MARKET, 9996, 1, 751000)
(AMETHYSTS, US << MARKET, 9996, 1, 751000)
(AMETHYSTS, US << MARKET, 9996, 1, 751000)
(STARFRUIT, MARKET << US, 5062, 1, 751000)","{""AMETHYSTS"": -6, ""STARFRUIT"": -2}",5247,5059,10000
751400,-30120,45245,"(AMETHYSTS, US << MARKET, 10004, 1, 751400)
(AMETHYSTS, US << MARKET, 10004, 1, 751400)
(STARFRUIT, US << MARKET, 5056, 1, 751400)
(STARFRUIT, US << MARKET, 5056, 1, 751400)","{""AMETHYSTS"": -4, ""STARFRUIT"": 0}",5245,5059,10000
751800,-60204,-14959,"(AMETHYSTS, US << MARKET, 9996, 1, 751800)
(AMETHYSTS, US << MARKET, 9996, 1, 751800)
(AMETHYSTS, US << MARKET, 9996, 1, 751800)
(AMETHYSTS, US << MARKET, 9996, 1, 751800)
(STARFRUIT, US << MARKET, 5055, 1, 751800)
(STARFRUIT, US << MARKET, 5055, 1, 751800)
(STARFRUIT, US << MARKET, 5055, 1, 751800)
(STARFRUIT, US << MARKET, 5055, 1, 751800)","{""AMETHYSTS"": 0, ""STARFRUIT"": 4}",5273,5058,10000
752300,-10002,-24961,"(AMETHYSTS, US << MARKET, 10002, 1, 752300)","{""AMETHYSTS"": 1, ""STARFRUIT"": 4}",5274,5058,10003
752400,-20004,-44965,"(AMETHYSTS, US << MARKET, 10002, 1, 752400)
(AMETHYSTS, US << MARKET, 10002, 1, 752400)","{""AMETHYSTS"": 3, ""STARFRUIT"": 4}",5276,5058,10003
752700,20232,-24733,"(STARFRUIT, MARKET << US, 5058, 1, 752700)
(STARFRUIT, MARKET << US, 5058, 1, 752700)
(STARFRUIT, MARKET << US, 5058, 1, 752700)
(STARFRUIT, MARKET << US, 5058, 1, 752700)","{""AMETHYSTS"": 3, ""STARFRUIT"": 0}",5264,5056,9999
752900,-40240,-64973,"(AMETHYSTS, US << MARKET, 10002, 1, 752900)
(AMETHYSTS, US << MARKET, 10002, 1, 752900)
(STARFRUIT, US << MARKET, 5059, 1, 752900)
(STARFRUIT, US << MARKET, 5059, 1, 752900)
(STARFRUIT, US << MARKET, 5059, 1, 752900)
(STARFRUIT, US << MARKET, 5059, 1, 752900)","{""AMETHYSTS"": 5, ""STARFRUIT"": 4}",5250,5057,9999
753600,-20228,-85201,"(STARFRUIT, US << MARKET, 5057, 1, 753600)
(STARFRUIT, US << MARKET, 5057, 1, 753600)
(STARFRUIT, US << MARKET, 5057, 1, 753600)
(STARFRUIT, US << MARKET, 5057, 1, 753600)","{""AMETHYSTS"": 5, ""STARFRUIT"": 8}",5229,5055,9998
753700,79984,-5217,"(AMETHYSTS, MARKET << US, 9998, 1, 753700)
(AMETHYSTS, MARKET << US, 9998, 1, 753700)
(AMETHYSTS, MARKET << US, 9998, 1, 753700)
(AMETHYSTS, MARKET << US, 9998, 1, 753700)
(AMETHYSTS, MARKET << US, 9998, 1, 753700)
(AMETHYSTS, MARKET << US, 9998, 1, 753700)
(AMETHYSTS, MARKET << US, 9998, 1, 753700)
(AMETHYSTS, MARKET << US, 9998, 1, 753700)","{""AMETHYSTS"": -3, ""STARFRUIT"": 8}",5244,5058,10001
754000,5055,-162,"(STARFRUIT, MARKET << US, 5055, 1, 754000)","{""AMETHYSTS"": -3, ""STARFRUIT"": 7}",5244,5058,10000
754100,14955,14793,"(AMETHYSTS, MARKET << US, 10005, 1, 754100)
(AMETHYSTS, MARKET << US, 10005, 1, 754100)
(STARFRUIT, US << MARKET, 5055, 1, 754100)","{""AMETHYSTS"": -5, ""STARFRUIT"": 8}",5225,5054,10000
754300,-4942,9851,"(AMETHYSTS, US << MARKET, 10004, 1, 754300)
(STARFRUIT, MARKET << US, 5062, 1, 754300)","{""AMETHYSTS"": -4, ""STARFRUIT"": 7}",5278,5061,10000
754500,-19996,-10145,"(AMETHYSTS, US << MARKET, 9998, 1, 754500)
(AMETHYSTS, US << MARKET, 9998, 1, 754500)","{""AMETHYSTS"": -2, ""STARFRUIT"": 7}",5260,5057,9997
756100,35057,24912,"(AMETHYSTS, MARKET << US, 9998, 1, 756100)
(AMETHYSTS, MARKET << US, 9998, 1, 756100)
(AMETHYSTS, MARKET << US, 9998, 1, 756100)
(STARFRUIT, MARKET << US, 5063, 1, 756100)","{""AMETHYSTS"": -5, ""STARFRUIT"": 6}",5310,5063,9996
756300,20004,44916,"(AMETHYSTS, MARKET << US, 10002, 1, 756300)
(AMETHYSTS, MARKET << US, 10002, 1, 756300)","{""AMETHYSTS"": -7, ""STARFRUIT"": 6}",5289,5061,9999
756900,25315,70231,"(STARFRUIT, MARKET << US, 5063, 1, 756900)
(STARFRUIT, MARKET << US, 5063, 1, 756900)
(STARFRUIT, MARKET << US, 5063, 1, 756900)
(STARFRUIT, MARKET << US, 5063, 1, 756900)
(STARFRUIT, MARKET << US, 5063, 1, 756900)","{""AMETHYSTS"": -7, ""STARFRUIT"": 1}",5294,5063,10000
757100,-130,70101,"(AMETHYSTS, MARKET << US, 9996, 1, 757100)
(STARFRUIT, US << MARKET, 5063, 1, 757100)
(STARFRUIT, US << MARKET, 5063, 1, 757100)","{""AMETHYSTS"": -8, ""STARFRUIT"": 3}",5290,5063,10000
757300,20252,90353,"(STARFRUIT, MARKET << US, 5063, 1, 757300)
(STARFRUIT, MARKET << US, 5063, 1, 757300)
(STARFRUIT, MARKET << US, 5063, 1, 757300)
(STARFRUIT, MARKET << US, 5063, 1, 757300)","{""AMETHYSTS"": -8, ""STARFRUIT"": -1}",5305,5064,9998
757400,5064,95417,"(STARFRUIT, MARKET << US, 5064, 1, 757400)","{""AMETHYSTS"": -8, ""STARFRUIT"": -2}",5281,5064,10001
757500,60112,155529,"(AMETHYSTS, MARKET << US, 9998, 1, 757500)
(AMETHYSTS, MARKET << US, 9998, 1, 757500)
(AMETHYSTS, MARKET << US, 9998, 1, 757500)
(AMETHYSTS, MARKET << US, 9998, 1, 757500)
(AMETHYSTS, MARKET << US, 9998, 1, 757500)
(STARFRUIT, MARKET << US, 5061, 1, 757500)
(STARFRUIT, MARKET << US, 5061, 1, 757500)","{""AMETHYSTS"": -13, ""STARFRUIT"": -4}",5345,5059,9996
758000,-10006,145523,"(AMETHYSTS, US << MARKET, 10004, 1, 758000)
(STARFRUIT, US << MARKET, 5065, 1, 758000)
(STARFRUIT, US << MARKET, 5065, 1, 758000)
(STARFRUIT, MARKET << US, 5064, 1, 758000)
(STARFRUIT, MARKET << US, 5064, 1, 758000)","{""AMETHYSTS"": -12, ""STARFRUIT"": -4}",5279,5061,10000
758100,-10126,135397,"(STARFRUIT, US << MARKET, 5063, 1, 758100)
(STARFRUIT, US << MARKET, 5063, 1, 758100)","{""AMETHYSTS"": -12, ""STARFRUIT"": -2}",5289,5060,9999
758200,-10126,125271,"(STARFRUIT, US << MARKET, 5063, 1, 758200)
(STARFRUIT, US << MARKET, 5063, 1, 758200)","{""AMETHYSTS"": -12, ""STARFRUIT"": 0}",5283,5064,9999
758500,5063,130334,"(STARFRUIT, MARKET << US, 5063, 1, 758500)","{""AMETHYSTS"": -12, ""STARFRUIT"": -1}",5275,5059,10000
758700,-70035,60299,"(AMETHYSTS, US << MARKET, 10005, 1, 758700)
(AMETHYSTS, US << MARKET, 10005, 1, 758700)
(AMETHYSTS, US << MARKET, 10005, 1, 758700)
(AMETHYSTS, US << MARKET, 10005, 1, 758700)
(AMETHYSTS, US << MARKET, 10005, 1, 758700)
(AMETHYSTS, US << MARKET, 10005, 1, 758700)
(AMETHYSTS, US << MARKET, 10005, 1, 758700)","{""AMETHYSTS"": -5, ""STARFRUIT"": -1}",5234,5060,10001
758900,20004,80303,"(AMETHYSTS, MARKET << US, 10002, 1, 758900)
(AMETHYSTS, MARKET << US, 10002, 1, 758900)","{""AMETHYSTS"": -7, ""STARFRUIT"": -1}",5222,5060,10003
759100,-10116,70187,"(STARFRUIT, US << MARKET, 5058, 1, 759100)
(STARFRUIT, US << MARKET, 5058, 1, 759100)","{""AMETHYSTS"": -7, ""STARFRUIT"": 1}",5245,5058,10000
759200,19760,89947,"(AMETHYSTS, MARKET << US, 10005, 1, 759200)
(AMETHYSTS, MARKET << US, 10005, 1, 759200)
(AMETHYSTS, MARKET << US, 10005, 1, 759200)
(AMETHYSTS, MARKET << US, 10005, 1, 759200)
(STARFRUIT, US << MARKET, 5065, 1, 759200)
(STARFRUIT, US << MARKET, 5065, 1, 759200)
(STARFRUIT, US << MARKET, 5065, 1, 759200)
(STARFRUIT, US << MARKET, 5065, 1, 759200)","{""AMETHYSTS"": -11, ""STARFRUIT"": 5}",5252,5061,10000
759300,-10126,79821,"(STARFRUIT, US << MARKET, 5063, 1, 759300)
(STARFRUIT, US << MARKET, 5063, 1, 759300)","{""AMETHYSTS"": -11, ""STARFRUIT"": 7}",5269,5064,10000
759500,10126,89947,"(STARFRUIT, US << MARKET, 5063, 1, 759500)
(STARFRUIT, MARKET << US, 5063, 1, 759500)
(STARFRUIT, MARKET << US, 5063, 1, 759500)
(STARFRUIT, MARKET << US, 5063, 1, 759500)","{""AMETHYSTS"": -11, ""STARFRUIT"": 5}",5278,5064,9999
759700,-30112,59835,"(AMETHYSTS, US << MARKET, 9998, 1, 759700)
(AMETHYSTS, US << MARKET, 9998, 1, 759700)
(STARFRUIT, US << MARKET, 5058, 1, 759700)
(STARFRUIT, US << MARKET, 5058, 1, 759700)","{""AMETHYSTS"": -9, ""STARFRUIT"": 7}",5253,5061,10001
759800,-20004,39831,"(AMETHYSTS, US << MARKET, 10002, 1, 759800)
(AMETHYSTS, US << MARKET, 10002, 1, 759800)","{""AMETHYSTS"": -7, ""STARFRUIT"": 7}",5265,5060,9998
760100,4937,44768,"(AMETHYSTS, MARKET << US, 9996, 1, 760100)
(STARFRUIT, US << MARKET, 5059, 1, 760100)","{""AMETHYSTS"": -8, ""STARFRUIT"": 8}",5272,5062,9999
760500,-4939,39829,"(AMETHYSTS, US << MARKET, 10004, 1, 760500)
(STARFRUIT, MARKET << US, 5065, 1, 760500)","{""AMETHYSTS"": -7, ""STARFRUIT"": 7}",5263,5062,10000
760900,-100040,-60211,"(AMETHYSTS, US << MARKET, 10004, 1, 760900)
(AMETHYSTS, US << MARKET, 10004, 1, 760900)
(AMETHYSTS, US << MARKET, 10004, 1, 760900)
(AMETHYSTS, US << MARKET, 10004, 1, 760900)
(AMETHYSTS, US << MARKET, 10004, 1, 760900)
(AMETHYSTS, US << MARKET, 10004, 1, 760900)
(AMETHYSTS, US << MARKET, 10004, 1, 760900)
(AMETHYSTS, US << MARKET, 10004, 1, 760900)
(AMETHYSTS, US << MARKET, 10004, 1, 760900)
(AMETHYSTS, US << MARKET, 10004, 1, 760900)","{""AMETHYSTS"": 3, ""STARFRUIT"": 7}",5223,5062,10000
761200,25315,-34896,"(STARFRUIT, MARKET << US, 5063, 1, 761200)
(STARFRUIT, MARKET << US, 5063, 1, 761200)
(STARFRUIT, MARKET << US, 5063, 1, 761200)
(STARFRUIT, MARKET << US, 5063, 1, 761200)
(STARFRUIT, MARKET << US, 5063, 1, 761200)","{""AMETHYSTS"": 3, ""STARFRUIT"": 2}",5224,5060,10000
761600,-10116,-45012,"(STARFRUIT, US << MARKET, 5058, 1, 761600)
(STARFRUIT, US << MARKET, 5058, 1, 761600)","{""AMETHYSTS"": 3, ""STARFRUIT"": 4}",5235,5061,10001
761700,5058,-39954,"(STARFRUIT, MARKET << US, 5058, 1, 761700)","{""AMETHYSTS"": 3, ""STARFRUIT"": 3}",5232,5061,10001
762000,59976,20022,"(AMETHYSTS, MARKET << US, 9996, 1, 762000)
(AMETHYSTS, MARKET << US, 9996, 1, 762000)
(AMETHYSTS, MARKET << US, 9996, 1, 762000)
(AMETHYSTS, MARKET << US, 9996, 1, 762000)
(AMETHYSTS, MARKET << US, 9996, 1, 762000)
(AMETHYSTS, MARKET << US, 9996, 1, 762000)","{""AMETHYSTS"": -3, ""STARFRUIT"": 3}",5205,5060,9999
762200,-25295,-5273,"(STARFRUIT, US << MARKET, 5059, 1, 762200)
(STARFRUIT, US << MARKET, 5059, 1, 762200)
(STARFRUIT, US << MARKET, 5059, 1, 762200)
(STARFRUIT, US << MARKET, 5059, 1, 762200)
(STARFRUIT, US << MARKET, 5059, 1, 762200)","{""AMETHYSTS"": -3, ""STARFRUIT"": 8}",5194,5058,9999
762300,79960,74687,"(AMETHYSTS, MARKET << US, 9995, 1, 762300)
(AMETHYSTS, MARKET << US, 9995, 1, 762300)
(AMETHYSTS, MARKET << US, 9995, 1, 762300)
(AMETHYSTS, MARKET << US, 9995, 1, 762300)
(AMETHYSTS, MARKET << US, 9995, 1, 762300)
(AMETHYSTS, MARKET << US, 9995, 1, 762300)
(AMETHYSTS, MARKET << US, 9995, 1, 762300)
(AMETHYSTS, MARKET << US, 9995, 1, 762300)","{""AMETHYSTS"": -11, ""STARFRUIT"": 8}",5175,5061,10000
762400,5058,79745,"(STARFRUIT, MARKET << US, 5058, 1, 762400)","{""AMETHYSTS"": -11, ""STARFRUIT"": 7}",5151,5058,10000
762500,20004,99749,"(AMETHYSTS, MARKET << US, 10002, 1, 762500)
(AMETHYSTS, MARKET << US, 10002, 1, 762500)","{""AMETHYSTS"": -13, ""STARFRUIT"": 7}",5144,5062,10003
762700,10118,109867,"(STARFRUIT, MARKET << US, 5059, 1, 762700)
(STARFRUIT, MARKET << US, 5059, 1, 762700)","{""AMETHYSTS"": -13, ""STARFRUIT"": 5}",5144,5058,10001
762800,-15174,94693,"(STARFRUIT, US << MARKET, 5058, 1, 762800)
(STARFRUIT, US << MARKET, 5058, 1, 762800)
(STARFRUIT, US << MARKET, 5058, 1, 762800)
(STARFRUIT, US << MARKET, 5058, 1, 762800)
(STARFRUIT, MARKET << US, 5058, 1, 762800)","{""AMETHYSTS"": -13, ""STARFRUIT"": 8}",5181,5061,10000
762900,-19996,74697,"(AMETHYSTS, US << MARKET, 9998, 1, 762900)
(AMETHYSTS, US << MARKET, 9998, 1, 762900)","{""AMETHYSTS"": -11, ""STARFRUIT"": 8}",5182,5062,10001
763000,-20256,54441,"(STARFRUIT, US << MARKET, 5064, 1, 763000)
(STARFRUIT, US << MARKET, 5064, 1, 763000)
(STARFRUIT, US << MARKET, 5064, 1, 763000)
(STARFRUIT, US << MARKET, 5064, 1, 763000)","{""AMETHYSTS"": -11, ""STARFRUIT"": 12}",5173,5061,10000
763500,15180,69621,"(STARFRUIT, MARKET << US, 5060, 1, 763500)
(STARFRUIT, MARKET << US, 5060, 1, 763500)
(STARFRUIT, MARKET << US, 5060, 1, 763500)","{""AMETHYSTS"": -11, ""STARFRUIT"": 9}",5155,5063,10003
764200,65046,134667,"(AMETHYSTS, MARKET << US, 9998, 1, 764200)
(AMETHYSTS, MARKET << US, 9998, 1, 764200)
(AMETHYSTS, MARKET << US, 9998, 1, 764200)
(AMETHYSTS, MARKET << US, 9998, 1, 764200)
(AMETHYSTS, MARKET << US, 9998, 1, 764200)
(AMETHYSTS, MARKET << US, 9998, 1, 764200)
(STARFRUIT, MARKET << US, 5058, 1, 764200)","{""AMETHYSTS"": -17, ""STARFRUIT"": 8}",5138,5061,10001
764300,-30006,104661,"(AMETHYSTS, US << MARKET, 10002, 1, 764300)
(AMETHYSTS, US << MARKET, 10002, 1, 764300)
(AMETHYSTS, US << MARKET, 10002, 1, 764300)","{""AMETHYSTS"": -14, ""STARFRUIT"": 8}",5099,5060,10003
764500,-34925,69736,"(AMETHYSTS, US << MARKET, 9996, 1, 764500)
(AMETHYSTS, US << MARKET, 9996, 1, 764500)
(AMETHYSTS, US << MARKET, 9996, 1, 764500)
(AMETHYSTS, US << MARKET, 9996, 1, 764500)
(STARFRUIT, MARKET << US, 5059, 1, 764500)","{""AMETHYSTS"": -10, ""STARFRUIT"": 7}",5163,5061,10000
765600,-5060,64676,"(STARFRUIT, US << MARKET, 5060, 1, 765600)","{""AMETHYSTS"": -10, ""STARFRUIT"": 8}",5190,5063,9999
765700,49864,114540,"(AMETHYSTS, US << MARKET, 9996, 1, 765700)
(AMETHYSTS, US << MARKET, 9996, 1, 765700)
(AMETHYSTS, MARKET << US, 10002, 1, 765700)
(AMETHYSTS, MARKET << US, 10002, 1, 765700)
(AMETHYSTS, MARKET << US, 9996, 1, 765700)
(AMETHYSTS, MARKET << US, 9996, 1, 765700)
(AMETHYSTS, MARKET << US, 9996, 1, 765700)
(AMETHYSTS, MARKET << US, 9996, 1, 765700)
(AMETHYSTS, MARKET << US, 9996, 1, 765700)
(AMETHYSTS, MARKET << US, 9996, 1, 765700)
(STARFRUIT, US << MARKET, 5062, 1, 765700)
(STARFRUIT, US << MARKET, 5062, 1, 765700)","{""AMETHYSTS"": -16, ""STARFRUIT"": 10}",5182,5061,9998
766000,30360,144900,"(STARFRUIT, MARKET << US, 5060, 1, 766000)
(STARFRUIT, MARKET << US, 5060, 1, 766000)
(STARFRUIT, MARKET << US, 5060, 1, 766000)
(STARFRUIT, MARKET << US, 5060, 1, 766000)
(STARFRUIT, MARKET << US, 5060, 1, 766000)
(STARFRUIT, MARKET << US, 5060, 1, 766000)","{""AMETHYSTS"": -16, ""STARFRUIT"": 4}",5180,5062,9998
766300,-10002,134898,"(AMETHYSTS, US << MARKET, 10002, 1, 766300)","{""AMETHYSTS"": -15, ""STARFRUIT"": 4}",5180,5063,9998
766500,-10134,124764,"(STARFRUIT, US << MARKET, 5067, 1, 766500)
(STARFRUIT, US << MARKET, 5067, 1, 766500)
(STARFRUIT, US << MARKET, 5067, 1, 766500)
(STARFRUIT, US << MARKET, 5067, 1, 766500)
(STARFRUIT, MARKET << US, 5067, 1, 766500)
(STARFRUIT, MARKET << US, 5067, 1, 766500)","{""AMETHYSTS"": -15, ""STARFRUIT"": 6}",5148,5064,10000
766700,9868,134632,"(AMETHYSTS, MARKET << US, 9995, 1, 766700)
(AMETHYSTS, MARKET << US, 9995, 1, 766700)
(STARFRUIT, US << MARKET, 5061, 1, 766700)
(STARFRUIT, US << MARKET, 5061, 1, 766700)","{""AMETHYSTS"": -17, ""STARFRUIT"": 8}",5178,5064,9998
766800,20004,154636,"(AMETHYSTS, MARKET << US, 10002, 1, 766800)
(AMETHYSTS, MARKET << US, 10002, 1, 766800)","{""AMETHYSTS"": -19, ""STARFRUIT"": 8}",5091,5064,10003
767300,-5062,149574,"(STARFRUIT, US << MARKET, 5062, 1, 767300)","{""AMETHYSTS"": -19, ""STARFRUIT"": 9}",5159,5065,10000
767500,10002,159576,"(AMETHYSTS, MARKET << US, 10002, 1, 767500)","{""AMETHYSTS"": -20, ""STARFRUIT"": 9}",5210,5066,9998
767700,10126,169702,"(STARFRUIT, MARKET << US, 5063, 1, 767700)
(STARFRUIT, MARKET << US, 5063, 1, 767700)","{""AMETHYSTS"": -20, ""STARFRUIT"": 7}",5164,5066,10000
767800,5063,174765,"(STARFRUIT, MARKET << US, 5063, 1, 767800)","{""AMETHYSTS"": -20, ""STARFRUIT"": 6}",5161,5066,10000
768200,5063,179828,"(STARFRUIT, MARKET << US, 5063, 1, 768200)","{""AMETHYSTS"": -20, ""STARFRUIT"": 5}",5178,5066,9999
768500,10140,189968,"(STARFRUIT, MARKET << US, 5070, 1, 768500)
(STARFRUIT, MARKET << US, 5070, 1, 768500)","{""AMETHYSTS"": -20, ""STARFRUIT"": 3}",5226,5066,9997
768700,20272,210240,"(STARFRUIT, MARKET << US, 5068, 1, 768700)
(STARFRUIT, MARKET << US, 5068, 1, 768700)
(STARFRUIT, MARKET << US, 5068, 1, 768700)
(STARFRUIT, MARKET << US, 5068, 1, 768700)","{""AMETHYSTS"": -20, ""STARFRUIT"": -1}",5192,5068,9999
769300,-10140,200100,"(STARFRUIT, US << MARKET, 5070, 1, 769300)
(STARFRUIT, US << MARKET, 5070, 1, 769300)","{""AMETHYSTS"": -20, ""STARFRUIT"": 1}",5170,5070,10000
769500,-59988,140112,"(AMETHYSTS, US << MARKET, 9998, 1, 769500)
(AMETHYSTS, US << MARKET, 9998, 1, 769500)
(AMETHYSTS, US << MARKET, 9998, 1, 769500)
(AMETHYSTS, US << MARKET, 9998, 1, 769500)
(AMETHYSTS, US << MARKET, 9998, 1, 769500)
(AMETHYSTS, US << MARKET, 9998, 1, 769500)","{""AMETHYSTS"": -14, ""STARFRUIT"": 1}",5221,5067,9997
769800,-10136,129976,"(STARFRUIT, US << MARKET, 5068, 1, 769800)
(STARFRUIT, US << MARKET, 5068, 1, 769800)","{""AMETHYSTS"": -14, ""STARFRUIT"": 3}",5166,5068,10001
770200,-25340,104636,"(STARFRUIT, US << MARKET, 5068, 1, 770200)
(STARFRUIT, US << MARKET, 5068, 1, 770200)
(STARFRUIT, US << MARKET, 5068, 1, 770200)
(STARFRUIT, US << MARKET, 5068, 1, 770200)
(STARFRUIT, US << MARKET, 5068, 1, 770200)","{""AMETHYSTS"": -14, ""STARFRUIT"": 8}",5156,5065,10000
770300,-10002,94634,"(AMETHYSTS, US << MARKET, 10002, 1, 770300)","{""AMETHYSTS"": -13, ""STARFRUIT"": 8}",5123,5066,10003
770500,25319,119953,"(STARFRUIT, US << MARKET, 5065, 1, 770500)
(STARFRUIT, MARKET << US, 5064, 1, 770500)
(STARFRUIT, MARKET << US, 5064, 1, 770500)
(STARFRUIT, MARKET << US, 5064, 1, 770500)
(STARFRUIT, MARKET << US, 5064, 1, 770500)
(STARFRUIT, MARKET << US, 5064, 1, 770500)
(STARFRUIT, MARKET << US, 5064, 1, 770500)","{""AMETHYSTS"": -13, ""STARFRUIT"": 3}",5154,5067,10000
770700,-35187,84766,"(AMETHYSTS, US << MARKET, 9996, 1, 770700)
(AMETHYSTS, US << MARKET, 9996, 1, 770700)
(STARFRUIT, US << MARKET, 5065, 1, 770700)
(STARFRUIT, US << MARKET, 5065, 1, 770700)
(STARFRUIT, US << MARKET, 5065, 1, 770700)","{""AMETHYSTS"": -11, ""STARFRUIT"": 6}",5174,5068,10000
770800,-10142,74624,"(STARFRUIT, US << MARKET, 5071, 1, 770800)
(STARFRUIT, US << MARKET, 5071, 1, 770800)","{""AMETHYSTS"": -11, ""STARFRUIT"": 8}",5193,5067,9997
771000,5065,79689,"(STARFRUIT, MARKET << US, 5065, 1, 771000)","{""AMETHYSTS"": -11, ""STARFRUIT"": 7}",5198,5068,9997
771500,-5070,74619,"(STARFRUIT, US << MARKET, 5070, 1, 771500)","{""AMETHYSTS"": -11, ""STARFRUIT"": 8}",5179,5070,10000
771600,30414,105033,"(STARFRUIT, MARKET << US, 5069, 1, 771600)
(STARFRUIT, MARKET << US, 5069, 1, 771600)
(STARFRUIT, MARKET << US, 5069, 1, 771600)
(STARFRUIT, MARKET << US, 5069, 1, 771600)
(STARFRUIT, MARKET << US, 5069, 1, 771600)
(STARFRUIT, MARKET << US, 5069, 1, 771600)","{""AMETHYSTS"": -11, ""STARFRUIT"": 2}",5206,5070,9997
772200,-39984,65049,"(AMETHYSTS, US << MARKET, 9996, 1, 772200)
(AMETHYSTS, US << MARKET, 9996, 1, 772200)
(AMETHYSTS, US << MARKET, 9996, 1, 772200)
(AMETHYSTS, US << MARKET, 9996, 1, 772200)","{""AMETHYSTS"": -7, ""STARFRUIT"": 2}",5185,5068,10000
772800,-10002,55047,"(AMETHYSTS, US << MARKET, 10002, 1, 772800)","{""AMETHYSTS"": -6, ""STARFRUIT"": 2}",5169,5070,10003
773200,-94914,-39867,"(AMETHYSTS, US << MARKET, 9998, 1, 773200)
(AMETHYSTS, US << MARKET, 9998, 1, 773200)
(AMETHYSTS, US << MARKET, 9998, 1, 773200)
(AMETHYSTS, US << MARKET, 9998, 1, 773200)
(AMETHYSTS, US << MARKET, 9998, 1, 773200)
(AMETHYSTS, US << MARKET, 9998, 1, 773200)
(AMETHYSTS, US << MARKET, 9998, 1, 773200)
(AMETHYSTS, US << MARKET, 9998, 1, 773200)
(AMETHYSTS, US << MARKET, 9998, 1, 773200)
(AMETHYSTS, US << MARKET, 9998, 1, 773200)
(STARFRUIT, MARKET << US, 5066, 1, 773200)","{""AMETHYSTS"": 4, ""STARFRUIT"": 1}",5206,5069,10001
773500,-10142,-50009,"(STARFRUIT, US << MARKET, 5071, 1, 773500)
(STARFRUIT, US << MARKET, 5071, 1, 773500)","{""AMETHYSTS"": 4, ""STARFRUIT"": 3}",5204,5071,10000
773600,-9862,-59871,"(AMETHYSTS, US << MARKET, 10004, 1, 773600)
(AMETHYSTS, US << MARKET, 10004, 1, 773600)
(STARFRUIT, MARKET << US, 5073, 1, 773600)
(STARFRUIT, MARKET << US, 5073, 1, 773600)","{""AMETHYSTS"": 6, ""STARFRUIT"": 1}",5204,5069,10001
773900,100020,40149,"(AMETHYSTS, MARKET << US, 10002, 1, 773900)
(AMETHYSTS, MARKET << US, 10002, 1, 773900)
(AMETHYSTS, MARKET << US, 10002, 1, 773900)
(AMETHYSTS, MARKET << US, 10002, 1, 773900)
(AMETHYSTS, MARKET << US, 10002, 1, 773900)
(AMETHYSTS, MARKET << US, 10002, 1, 773900)
(AMETHYSTS, MARKET << US, 10002, 1, 773900)
(AMETHYSTS, MARKET << US, 10002, 1, 773900)
(AMETHYSTS, MARKET << US, 10002, 1, 773900)
(AMETHYSTS, MARKET << US, 10002, 1, 773900)","{""AMETHYSTS"": -4, ""STARFRUIT"": 1}",5207,5070,10003
774000,-19996,20153,"(AMETHYSTS, US << MARKET, 9998, 1, 774000)
(AMETHYSTS, US << MARKET, 9998, 1, 774000)","{""AMETHYSTS"": -2, ""STARFRUIT"": 1}",5221,5070,10001
774300,-20004,149,"(AMETHYSTS, US << MARKET, 10002, 1, 774300)
(AMETHYSTS, US << MARKET, 10002, 1, 774300)","{""AMETHYSTS"": 0, ""STARFRUIT"": 1}",5217,5068,10003
774800,5065,5214,"(AMETHYSTS, US << MARKET, 10002, 1, 774800)
(AMETHYSTS, US << MARKET, 10002, 1, 774800)
(AMETHYSTS, MARKET << US, 10002, 1, 774800)
(AMETHYSTS, MARKET << US, 10002, 1, 774800)
(STARFRUIT, MARKET << US, 5065, 1, 774800)","{""AMETHYSTS"": 0, ""STARFRUIT"": 0}",5214,5068,10003
774900,-14943,-9729,"(AMETHYSTS, US << MARKET, 10004, 1, 774900)
(AMETHYSTS, US << MARKET, 10004, 1, 774900)
(STARFRUIT, MARKET << US, 5065, 1, 774900)","{""AMETHYSTS"": 2, ""STARFRUIT"": -1}",5209,5068,10003
775500,-20272,-30001,"(STARFRUIT, US << MARKET, 5068, 1, 775500)
(STARFRUIT, US << MARKET, 5068, 1, 775500)
(STARFRUIT, US << MARKET, 5068, 1, 775500)
(STARFRUIT, US << MARKET, 5068, 1, 775500)","{""AMETHYSTS"": 2, ""STARFRUIT"": 3}",5194,5067,9997
776000,-35337,-65338,"(AMETHYSTS, US << MARKET, 10002, 1, 776000)
(STARFRUIT, US << MARKET, 5067, 1, 776000)
(STARFRUIT, US << MARKET, 5067, 1, 776000)
(STARFRUIT, US << MARKET, 5067, 1, 776000)
(STARFRUIT, US << MARKET, 5067, 1, 776000)
(STARFRUIT, US << MARKET, 5067, 1, 776000)","{""AMETHYSTS"": 3, ""STARFRUIT"": 8}",5199,5066,10003
776100,40400,-24938,"(AMETHYSTS, MARKET << US, 9998, 1, 776100)
(STARFRUIT, MARKET << US, 5067, 1, 776100)
(STARFRUIT, MARKET << US, 5067, 1, 776100)
(STARFRUIT, MARKET << US, 5067, 1, 776100)
(STARFRUIT, MARKET << US, 5067, 1, 776100)
(STARFRUIT, MARKET << US, 5067, 1, 776100)
(STARFRUIT, MARKET << US, 5067, 1, 776100)","{""AMETHYSTS"": 2, ""STARFRUIT"": 2}",5188,5066,9997
776200,9848,-15090,"(AMETHYSTS, MARKET << US, 9995, 1, 776200)
(AMETHYSTS, MARKET << US, 9995, 1, 776200)
(STARFRUIT, US << MARKET, 5071, 1, 776200)
(STARFRUIT, US << MARKET, 5071, 1, 776200)","{""AMETHYSTS"": 0, ""STARFRUIT"": 4}",5198,5072,10000
776500,-5050,-20140,"(STARFRUIT, US << MARKET, 5065, 1, 776500)
(STARFRUIT, US << MARKET, 5065, 1, 776500)
(STARFRUIT, US << MARKET, 5065, 1, 776500)
(STARFRUIT, US << MARKET, 5065, 1, 776500)
(STARFRUIT, MARKET << US, 5070, 1, 776500)
(STARFRUIT, MARKET << US, 5070, 1, 776500)
(STARFRUIT, MARKET << US, 5070, 1, 776500)","{""AMETHYSTS"": 0, ""STARFRUIT"": 5}",5195,5067,9999
776800,24804,4664,"(AMETHYSTS, MARKET << US, 10005, 1, 776800)
(AMETHYSTS, MARKET << US, 10005, 1, 776800)
(AMETHYSTS, MARKET << US, 10005, 1, 776800)
(AMETHYSTS, MARKET << US, 10005, 1, 776800)
(STARFRUIT, US << MARKET, 5072, 1, 776800)
(STARFRUIT, US << MARKET, 5072, 1, 776800)
(STARFRUIT, US << MARKET, 5072, 1, 776800)","{""AMETHYSTS"": -4, ""STARFRUIT"": 8}",5208,5068,10000
777100,14937,19601,"(AMETHYSTS, MARKET << US, 10004, 1, 777100)
(AMETHYSTS, MARKET << US, 10004, 1, 777100)
(STARFRUIT, US << MARKET, 5071, 1, 777100)","{""AMETHYSTS"": -6, ""STARFRUIT"": 9}",5213,5068,10000
777200,-144,19457,"(AMETHYSTS, MARKET << US, 9998, 1, 777200)
(STARFRUIT, US << MARKET, 5071, 1, 777200)
(STARFRUIT, US << MARKET, 5071, 1, 777200)","{""AMETHYSTS"": -7, ""STARFRUIT"": 11}",5233,5068,9996
777300,9998,29455,"(AMETHYSTS, MARKET << US, 9998, 1, 777300)","{""AMETHYSTS"": -8, ""STARFRUIT"": 11}",5184,5067,10001
777800,20256,49711,"(STARFRUIT, MARKET << US, 5064, 1, 777800)
(STARFRUIT, MARKET << US, 5064, 1, 777800)
(STARFRUIT, MARKET << US, 5064, 1, 777800)
(STARFRUIT, MARKET << US, 5064, 1, 777800)","{""AMETHYSTS"": -8, ""STARFRUIT"": 7}",5156,5067,10003
777900,-5069,44642,"(STARFRUIT, US << MARKET, 5069, 1, 777900)","{""AMETHYSTS"": -8, ""STARFRUIT"": 8}",5202,5070,10000
778200,90036,134678,"(AMETHYSTS, US << MARKET, 10004, 1, 778200)
(AMETHYSTS, MARKET << US, 10004, 1, 778200)
(AMETHYSTS, MARKET << US, 10004, 1, 778200)
(AMETHYSTS, MARKET << US, 10004, 1, 778200)
(AMETHYSTS, MARKET << US, 10004, 1, 778200)
(AMETHYSTS, MARKET << US, 10004, 1, 778200)
(AMETHYSTS, MARKET << US, 10004, 1, 778200)
(AMETHYSTS, MARKET << US, 10004, 1, 778200)
(AMETHYSTS, MARKET << US, 10004, 1, 778200)
(AMETHYSTS, MARKET << US, 10004, 1, 778200)
(AMETHYSTS, MARKET << US, 10004, 1, 778200)","{""AMETHYSTS"": -17, ""STARFRUIT"": 8}",5206,5066,10000
778400,25310,159988,"(STARFRUIT, US << MARKET, 5062, 1, 778400)
(STARFRUIT, MARKET << US, 5062, 1, 778400)
(STARFRUIT, MARKET << US, 5062, 1, 778400)
(STARFRUIT, MARKET << US, 5062, 1, 778400)
(STARFRUIT, MARKET << US, 5062, 1, 778400)
(STARFRUIT, MARKET << US, 5062, 1, 778400)
(STARFRUIT, MARKET << US, 5062, 1, 778400)","{""AMETHYSTS"": -17, ""STARFRUIT"": 3}",5132,5065,10003
778600,-25200,134788,"(AMETHYSTS, US << MARKET, 9996, 1, 778600)
(AMETHYSTS, US << MARKET, 9996, 1, 778600)
(AMETHYSTS, MARKET << US, 9996, 1, 778600)
(STARFRUIT, US << MARKET, 5068, 1, 778600)
(STARFRUIT, US << MARKET, 5068, 1, 778600)
(STARFRUIT, US << MARKET, 5068, 1, 778600)
(STARFRUIT, US << MARKET, 5068, 1, 778600)
(STARFRUIT, MARKET << US, 5068, 1, 778600)","{""AMETHYSTS"": -16, ""STARFRUIT"": 6}",5194,5065,9999
778800,-30116,104672,"(AMETHYSTS, US << MARKET, 9996, 1, 778800)
(AMETHYSTS, US << MARKET, 9996, 1, 778800)
(STARFRUIT, US << MARKET, 5062, 1, 778800)
(STARFRUIT, US << MARKET, 5062, 1, 778800)","{""AMETHYSTS"": -14, ""STARFRUIT"": 8}",5206,5065,9999
779100,-5063,99609,"(STARFRUIT, US << MARKET, 5063, 1, 779100)","{""AMETHYSTS"": -14, ""STARFRUIT"": 9}",5176,5063,10000
779600,14937,114546,"(AMETHYSTS, MARKET << US, 10002, 1, 779600)
(AMETHYSTS, MARKET << US, 10002, 1, 779600)
(STARFRUIT, US << MARKET, 5067, 1, 779600)","{""AMETHYSTS"": -16, ""STARFRUIT"": 10}",5178,5068,10003
779800,9872,124418,"(AMETHYSTS, MARKET << US, 10004, 1, 779800)
(AMETHYSTS, MARKET << US, 10004, 1, 779800)
(STARFRUIT, US << MARKET, 5068, 1, 779800)
(STARFRUIT, US << MARKET, 5068, 1, 779800)","{""AMETHYSTS"": -18, ""STARFRUIT"": 12}",5186,5064,10000
779900,20004,144422,"(AMETHYSTS, MARKET << US, 10002, 1, 779900)
(AMETHYSTS, MARKET << US, 10002, 1, 779900)","{""AMETHYSTS"": -20, ""STARFRUIT"": 12}",5142,5065,10003
780300,5061,149483,"(STARFRUIT, MARKET << US, 5061, 1, 780300)","{""AMETHYSTS"": -20, ""STARFRUIT"": 11}",5205,5062,9998
780400,0,149483,,"{""AMETHYSTS"": -20, ""STARFRUIT"": 11}",5116,5063,10003
780600,5061,154544,"(STARFRUIT, MARKET << US, 5061, 1, 780600)","{""AMETHYSTS"": -20, ""STARFRUIT"": 10}",5224,5064,9998
780700,-5067,149477,"(STARFRUIT, US << MARKET, 5067, 1, 780700)","{""AMETHYSTS"": -20, ""STARFRUIT"": 11}",5254,5067,9998
780800,0,149477,,"{""AMETHYSTS"": -20, ""STARFRUIT"": 11}",5212,5065,9999
781000,-70028,79449,"(AMETHYSTS, US << MARKET, 10004, 1, 781000)
(AMETHYSTS, US << MARKET, 10004, 1, 781000)
(AMETHYSTS, US << MARKET, 10004, 1, 781000)
(AMETHYSTS, US << MARKET, 10004, 1, 781000)
(AMETHYSTS, US << MARKET, 10004, 1, 781000)
(AMETHYSTS, US << MARKET, 10004, 1, 781000)
(AMETHYSTS, US << MARKET, 10004, 1, 781000)","{""AMETHYSTS"": -13, ""STARFRUIT"": 11}",5114,5064,10003
781200,9998,89447,"(AMETHYSTS, MARKET << US, 9998, 1, 781200)","{""AMETHYSTS"": -14, ""STARFRUIT"": 11}",5159,5066,10001
781500,55078,144525,"(AMETHYSTS, MARKET << US, 10002, 1, 781500)
(AMETHYSTS, MARKET << US, 10002, 1, 781500)
(AMETHYSTS, MARKET << US, 10002, 1, 781500)
(AMETHYSTS, MARKET << US, 10002, 1, 781500)
(AMETHYSTS, MARKET << US, 10002, 1, 781500)
(STARFRUIT, MARKET << US, 5068, 1, 781500)","{""AMETHYSTS"": -19, ""STARFRUIT"": 10}",5148,5068,10003
781700,-5063,139462,"(STARFRUIT, US << MARKET, 5063, 1, 781700)","{""AMETHYSTS"": -19, ""STARFRUIT"": 11}",5131,5066,10003
782100,10002,149464,"(AMETHYSTS, MARKET << US, 10002, 1, 782100)","{""AMETHYSTS"": -20, ""STARFRUIT"": 11}",5217,5063,9997
783000,35490,184954,"(STARFRUIT, MARKET << US, 5070, 1, 783000)
(STARFRUIT, MARKET << US, 5070, 1, 783000)
(STARFRUIT, MARKET << US, 5070, 1, 783000)
(STARFRUIT, MARKET << US, 5070, 1, 783000)
(STARFRUIT, MARKET << US, 5070, 1, 783000)
(STARFRUIT, MARKET << US, 5070, 1, 783000)
(STARFRUIT, MARKET << US, 5070, 1, 783000)","{""AMETHYSTS"": -20, ""STARFRUIT"": 4}",5222,5067,10000
783200,20260,205214,"(STARFRUIT, MARKET << US, 5065, 1, 783200)
(STARFRUIT, MARKET << US, 5065, 1, 783200)
(STARFRUIT, MARKET << US, 5065, 1, 783200)
(STARFRUIT, MARKET << US, 5065, 1, 783200)","{""AMETHYSTS"": -20, ""STARFRUIT"": 0}",5154,5068,10003
783300,5070,210284,"(STARFRUIT, MARKET << US, 5070, 1, 783300)","{""AMETHYSTS"": -20, ""STARFRUIT"": -1}",5213,5071,10000
783400,0,210284,,"{""AMETHYSTS"": -20, ""STARFRUIT"": -1}",5275,5069,9997
783600,5073,215357,"(STARFRUIT, US << MARKET, 5073, 1, 783600)
(STARFRUIT, US << MARKET, 5073, 1, 783600)
(STARFRUIT, MARKET << US, 5073, 1, 783600)
(STARFRUIT, MARKET << US, 5073, 1, 783600)
(STARFRUIT, MARKET << US, 5073, 1, 783600)","{""AMETHYSTS"": -20, ""STARFRUIT"": -2}",5217,5070,10000
783700,-10146,205211,"(STARFRUIT, US << MARKET, 5073, 1, 783700)
(STARFRUIT, US << MARKET, 5073, 1, 783700)","{""AMETHYSTS"": -20, ""STARFRUIT"": 0}",5211,5069,10000
783800,-10002,195209,"(AMETHYSTS, US << MARKET, 10002, 1, 783800)","{""AMETHYSTS"": -19, ""STARFRUIT"": 0}",5152,5070,10003
784200,9998,205207,"(AMETHYSTS, MARKET << US, 9998, 1, 784200)","{""AMETHYSTS"": -20, ""STARFRUIT"": 0}",5287,5069,9996
784300,0,205207,,"{""AMETHYSTS"": -20, ""STARFRUIT"": 0}",5207,5069,10000
784500,-10140,195067,"(STARFRUIT, US << MARKET, 5070, 1, 784500)
(STARFRUIT, US << MARKET, 5070, 1, 784500)","{""AMETHYSTS"": -20, ""STARFRUIT"": 2}",5227,5070,9999
784600,-34916,160151,"(AMETHYSTS, US << MARKET, 9995, 1, 784600)
(AMETHYSTS, US << MARKET, 9995, 1, 784600)
(AMETHYSTS, US << MARKET, 9995, 1, 784600)
(AMETHYSTS, US << MARKET, 9996, 1, 784600)
(STARFRUIT, MARKET << US, 5065, 1, 784600)","{""AMETHYSTS"": -16, ""STARFRUIT"": 1}",5235,5068,9999
785200,-10132,150019,"(STARFRUIT, US << MARKET, 5066, 1, 785200)
(STARFRUIT, US << MARKET, 5066, 1, 785200)","{""AMETHYSTS"": -16, ""STARFRUIT"": 3}",5226,5069,10000
785400,20292,170311,"(STARFRUIT, MARKET << US, 5073, 1, 785400)
(STARFRUIT, MARKET << US, 5073, 1, 785400)
(STARFRUIT, MARKET << US, 5073, 1, 785400)
(STARFRUIT, MARKET << US, 5073, 1, 785400)","{""AMETHYSTS"": -16, ""STARFRUIT"": -1}",5257,5070,9999
785600,-10002,160309,"(AMETHYSTS, US << MARKET, 10002, 1, 785600)","{""AMETHYSTS"": -15, ""STARFRUIT"": -1}",5254,5070,9999
785900,-29852,130457,"(AMETHYSTS, US << MARKET, 9998, 1, 785900)
(AMETHYSTS, US << MARKET, 9998, 1, 785900)
(AMETHYSTS, US << MARKET, 9998, 1, 785900)
(AMETHYSTS, US << MARKET, 9998, 1, 785900)
(STARFRUIT, MARKET << US, 5070, 1, 785900)
(STARFRUIT, MARKET << US, 5070, 1, 785900)","{""AMETHYSTS"": -11, ""STARFRUIT"": -3}",5297,5068,9996
786200,-10138,120319,"(STARFRUIT, US << MARKET, 5069, 1, 786200)
(STARFRUIT, US << MARKET, 5069, 1, 786200)","{""AMETHYSTS"": -11, ""STARFRUIT"": -1}",5259,5071,9999
786800,-10002,110317,"(AMETHYSTS, US << MARKET, 10002, 1, 786800)","{""AMETHYSTS"": -10, ""STARFRUIT"": -1}",5218,5069,10003
787100,30126,140443,"(AMETHYSTS, MARKET << US, 9996, 1, 787100)
(AMETHYSTS, MARKET << US, 9996, 1, 787100)
(STARFRUIT, MARKET << US, 5067, 1, 787100)
(STARFRUIT, MARKET << US, 5067, 1, 787100)","{""AMETHYSTS"": -12, ""STARFRUIT"": -3}",5233,5070,10000
787500,-35483,104960,"(STARFRUIT, US << MARKET, 5069, 1, 787500)
(STARFRUIT, US << MARKET, 5069, 1, 787500)
(STARFRUIT, US << MARKET, 5069, 1, 787500)
(STARFRUIT, US << MARKET, 5069, 1, 787500)
(STARFRUIT, US << MARKET, 5069, 1, 787500)
(STARFRUIT, US << MARKET, 5069, 1, 787500)
(STARFRUIT, US << MARKET, 5069, 1, 787500)","{""AMETHYSTS"": -12, ""STARFRUIT"": 4}",5264,5070,9998
787600,-149940,-44980,"(AMETHYSTS, US << MARKET, 9996, 1, 787600)
(AMETHYSTS, US << MARKET, 9996, 1, 787600)
(AMETHYSTS, US << MARKET, 9996, 1, 787600)
(AMETHYSTS, US << MARKET, 9996, 1, 787600)
(AMETHYSTS, US << MARKET, 9996, 1, 787600)
(AMETHYSTS, US << MARKET, 9996, 1, 787600)
(AMETHYSTS, US << MARKET, 9996, 1, 787600)
(AMETHYSTS, US << MARKET, 9996, 1, 787600)
(AMETHYSTS, US << MARKET, 9996, 1, 787600)
(AMETHYSTS, US << MARKET, 9996, 1, 787600)
(AMETHYSTS, US << MARKET, 9996, 1, 787600)
(AMETHYSTS, US << MARKET, 9996, 1, 787600)
(AMETHYSTS, US << MARKET, 9996, 1, 787600)
(AMETHYSTS, US << MARKET, 9996, 1, 787600)
(AMETHYSTS, US << MARKET, 9996, 1, 787600)
(AMETHYSTS, US << MARKET, 9996, 1, 787600)
(AMETHYSTS, MARKET << US, 9996, 1, 787600)","{""AMETHYSTS"": 3, ""STARFRUIT"": 4}",5304,5071,10000
787900,5073,-39907,"(STARFRUIT, MARKET << US, 5073, 1, 787900)","{""AMETHYSTS"": 3, ""STARFRUIT"": 3}",5321,5074,10002
788500,40016,109,"(AMETHYSTS, MARKET << US, 10004, 1, 788500)
(AMETHYSTS, MARKET << US, 10004, 1, 788500)
(AMETHYSTS, MARKET << US, 10004, 1, 788500)
(AMETHYSTS, MARKET << US, 10004, 1, 788500)","{""AMETHYSTS"": -1, ""STARFRUIT"": 3}",5325,5072,10000
788900,-29840,-29731,"(AMETHYSTS, US << MARKET, 9995, 1, 788900)
(AMETHYSTS, US << MARKET, 9995, 1, 788900)
(AMETHYSTS, US << MARKET, 9995, 1, 788900)
(AMETHYSTS, US << MARKET, 9995, 1, 788900)
(STARFRUIT, MARKET << US, 5070, 1, 788900)
(STARFRUIT, MARKET << US, 5070, 1, 788900)","{""AMETHYSTS"": 3, ""STARFRUIT"": 1}",5336,5073,9998
789100,-10152,-39883,"(STARFRUIT, US << MARKET, 5076, 1, 789100)
(STARFRUIT, US << MARKET, 5076, 1, 789100)","{""AMETHYSTS"": 3, ""STARFRUIT"": 3}",5336,5073,10000
789900,-10002,-49885,"(AMETHYSTS, US << MARKET, 10002, 1, 789900)","{""AMETHYSTS"": 4, ""STARFRUIT"": 3}",5352,5075,10003
790300,-25365,-75250,"(STARFRUIT, US << MARKET, 5073, 1, 790300)
(STARFRUIT, US << MARKET, 5073, 1, 790300)
(STARFRUIT, US << MARKET, 5073, 1, 790300)
(STARFRUIT, US << MARKET, 5073, 1, 790300)
(STARFRUIT, US << MARKET, 5073, 1, 790300)","{""AMETHYSTS"": 4, ""STARFRUIT"": 8}",5358,5076,10000
790600,5078,-70172,"(STARFRUIT, MARKET << US, 5078, 1, 790600)","{""AMETHYSTS"": 4, ""STARFRUIT"": 7}",5346,5074,10000
791000,25370,-44802,"(STARFRUIT, MARKET << US, 5074, 1, 791000)
(STARFRUIT, MARKET << US, 5074, 1, 791000)
(STARFRUIT, MARKET << US, 5074, 1, 791000)
(STARFRUIT, MARKET << US, 5074, 1, 791000)
(STARFRUIT, MARKET << US, 5074, 1, 791000)","{""AMETHYSTS"": 4, ""STARFRUIT"": 2}",5356,5077,10001
792100,-25365,-70167,"(STARFRUIT, US << MARKET, 5073, 1, 792100)
(STARFRUIT, US << MARKET, 5073, 1, 792100)
(STARFRUIT, US << MARKET, 5073, 1, 792100)
(STARFRUIT, US << MARKET, 5073, 1, 792100)
(STARFRUIT, US << MARKET, 5073, 1, 792100)","{""AMETHYSTS"": 4, ""STARFRUIT"": 7}",5333,5072,9999
792200,19996,-50171,"(AMETHYSTS, US << MARKET, 9998, 1, 792200)
(AMETHYSTS, US << MARKET, 9998, 1, 792200)
(AMETHYSTS, US << MARKET, 9998, 1, 792200)
(AMETHYSTS, US << MARKET, 9998, 1, 792200)
(AMETHYSTS, US << MARKET, 9998, 1, 792200)
(AMETHYSTS, US << MARKET, 9998, 1, 792200)
(AMETHYSTS, MARKET << US, 9998, 1, 792200)
(AMETHYSTS, MARKET << US, 9998, 1, 792200)
(AMETHYSTS, MARKET << US, 9998, 1, 792200)
(AMETHYSTS, MARKET << US, 9998, 1, 792200)
(AMETHYSTS, MARKET << US, 9998, 1, 792200)
(AMETHYSTS, MARKET << US, 9998, 1, 792200)
(AMETHYSTS, MARKET << US, 9998, 1, 792200)
(AMETHYSTS, MARKET << US, 9998, 1, 792200)","{""AMETHYSTS"": 2, ""STARFRUIT"": 7}",5355,5076,9997
792400,25089,-25082,"(AMETHYSTS, MARKET << US, 10005, 1, 792400)
(AMETHYSTS, MARKET << US, 10005, 1, 792400)
(STARFRUIT, MARKET << US, 5079, 1, 792400)","{""AMETHYSTS"": 0, ""STARFRUIT"": 6}",5368,5075,10000
792500,-149,-25231,"(AMETHYSTS, MARKET << US, 9995, 1, 792500)
(STARFRUIT, US << MARKET, 5072, 1, 792500)
(STARFRUIT, US << MARKET, 5072, 1, 792500)","{""AMETHYSTS"": -1, ""STARFRUIT"": 8}",5361,5074,10000
792700,-20296,-45527,"(STARFRUIT, US << MARKET, 5074, 1, 792700)
(STARFRUIT, US << MARKET, 5074, 1, 792700)
(STARFRUIT, US << MARKET, 5074, 1, 792700)
(STARFRUIT, US << MARKET, 5074, 1, 792700)","{""AMETHYSTS"": -1, ""STARFRUIT"": 12}",5350,5073,9999
792900,49980,4453,"(AMETHYSTS, US << MARKET, 9996, 1, 792900)
(AMETHYSTS, US << MARKET, 9996, 1, 792900)
(AMETHYSTS, MARKET << US, 9996, 1, 792900)
(AMETHYSTS, MARKET << US, 9996, 1, 792900)
(AMETHYSTS, MARKET << US, 9996, 1, 792900)
(AMETHYSTS, MARKET << US, 9996, 1, 792900)
(AMETHYSTS, MARKET << US, 9996, 1, 792900)
(AMETHYSTS, MARKET << US, 9996, 1, 792900)
(AMETHYSTS, MARKET << US, 9996, 1, 792900)","{""AMETHYSTS"": -6, ""STARFRUIT"": 12}",5353,5075,10000
793000,29858,34311,"(AMETHYSTS, MARKET << US, 10004, 1, 793000)
(AMETHYSTS, MARKET << US, 10004, 1, 793000)
(AMETHYSTS, MARKET << US, 10004, 1, 793000)
(AMETHYSTS, MARKET << US, 10004, 1, 793000)
(STARFRUIT, US << MARKET, 5079, 1, 793000)
(STARFRUIT, US << MARKET, 5079, 1, 793000)","{""AMETHYSTS"": -10, ""STARFRUIT"": 14}",5351,5075,10001
793100,10156,44467,"(STARFRUIT, MARKET << US, 5078, 1, 793100)
(STARFRUIT, MARKET << US, 5078, 1, 793100)","{""AMETHYSTS"": -10, ""STARFRUIT"": 12}",5415,5079,10000
793600,-15076,29391,"(AMETHYSTS, US << MARKET, 10000, 1, 793600)
(STARFRUIT, US << MARKET, 5076, 1, 793600)","{""AMETHYSTS"": -9, ""STARFRUIT"": 13}",5396,5078,10001
793800,5079,34470,"(STARFRUIT, MARKET << US, 5079, 1, 793800)","{""AMETHYSTS"": -9, ""STARFRUIT"": 12}",5430,5080,10000
794100,5074,39544,"(STARFRUIT, MARKET << US, 5074, 1, 794100)","{""AMETHYSTS"": -9, ""STARFRUIT"": 11}",5391,5077,10000
794300,-10326,29218,"(AMETHYSTS, MARKET << US, 9998, 1, 794300)
(STARFRUIT, US << MARKET, 5081, 1, 794300)
(STARFRUIT, US << MARKET, 5081, 1, 794300)
(STARFRUIT, US << MARKET, 5081, 1, 794300)
(STARFRUIT, US << MARKET, 5081, 1, 794300)","{""AMETHYSTS"": -10, ""STARFRUIT"": 15}",5413,5077,9996
794500,-10002,19216,"(AMETHYSTS, US << MARKET, 10002, 1, 794500)","{""AMETHYSTS"": -9, ""STARFRUIT"": 15}",5329,5076,10003
794900,-5073,14143,"(STARFRUIT, US << MARKET, 5073, 1, 794900)","{""AMETHYSTS"": -9, ""STARFRUIT"": 16}",5359,5076,10000
796000,-25078,-10935,"(AMETHYSTS, US << MARKET, 9998, 1, 796000)
(AMETHYSTS, US << MARKET, 9998, 1, 796000)
(STARFRUIT, US << MARKET, 5082, 1, 796000)","{""AMETHYSTS"": -7, ""STARFRUIT"": 17}",5436,5079,9996
796100,1,-10934,"(STARFRUIT, US << MARKET, 5081, 1, 796100)
(STARFRUIT, MARKET << US, 5082, 1, 796100)","{""AMETHYSTS"": -7, ""STARFRUIT"": 17}",5460,5082,10000
796300,-9842,-20776,"(AMETHYSTS, US << MARKET, 10004, 1, 796300)
(AMETHYSTS, US << MARKET, 10004, 1, 796300)
(STARFRUIT, MARKET << US, 5083, 1, 796300)
(STARFRUIT, MARKET << US, 5083, 1, 796300)","{""AMETHYSTS"": -5, ""STARFRUIT"": 15}",5424,5080,10000
796400,-4919,-25695,"(AMETHYSTS, US << MARKET, 10002, 1, 796400)
(STARFRUIT, MARKET << US, 5083, 1, 796400)","{""AMETHYSTS"": -4, ""STARFRUIT"": 14}",5429,5080,9999
796600,19992,-5703,"(AMETHYSTS, MARKET << US, 9996, 1, 796600)
(AMETHYSTS, MARKET << US, 9996, 1, 796600)","{""AMETHYSTS"": -6, ""STARFRUIT"": 14}",5417,5080,10000
796900,45070,39367,"(AMETHYSTS, MARKET << US, 9998, 1, 796900)
(AMETHYSTS, MARKET << US, 9998, 1, 796900)
(AMETHYSTS, MARKET << US, 9998, 1, 796900)
(AMETHYSTS, MARKET << US, 9998, 1, 796900)
(STARFRUIT, MARKET << US, 5078, 1, 796900)","{""AMETHYSTS"": -10, ""STARFRUIT"": 13}",5437,5080,9997
797000,35546,74913,"(STARFRUIT, MARKET << US, 5078, 1, 797000)
(STARFRUIT, MARKET << US, 5078, 1, 797000)
(STARFRUIT, MARKET << US, 5078, 1, 797000)
(STARFRUIT, MARKET << US, 5078, 1, 797000)
(STARFRUIT, MARKET << US, 5078, 1, 797000)
(STARFRUIT, MARKET << US, 5078, 1, 797000)
(STARFRUIT, MARKET << US, 5078, 1, 797000)","{""AMETHYSTS"": -10, ""STARFRUIT"": 6}",5371,5078,10001
797100,-20320,54593,"(STARFRUIT, US << MARKET, 5080, 1, 797100)
(STARFRUIT, US << MARKET, 5080, 1, 797100)
(STARFRUIT, US << MARKET, 5080, 1, 797100)
(STARFRUIT, US << MARKET, 5080, 1, 797100)","{""AMETHYSTS"": -10, ""STARFRUIT"": 10}",5393,5078,9998
797500,40016,94609,"(AMETHYSTS, MARKET << US, 10004, 1, 797500)
(AMETHYSTS, MARKET << US, 10004, 1, 797500)
(AMETHYSTS, MARKET << US, 10004, 1, 797500)
(AMETHYSTS, MARKET << US, 10004, 1, 797500)","{""AMETHYSTS"": -14, ""STARFRUIT"": 10}",5409,5080,10000
797800,-20320,74289,"(STARFRUIT, US << MARKET, 5080, 1, 797800)
(STARFRUIT, US << MARKET, 5080, 1, 797800)
(STARFRUIT, US << MARKET, 5080, 1, 797800)
(STARFRUIT, US << MARKET, 5080, 1, 797800)","{""AMETHYSTS"": -14, ""STARFRUIT"": 14}",5409,5081,10001
798000,5082,79371,"(STARFRUIT, MARKET << US, 5082, 1, 798000)","{""AMETHYSTS"": -14, ""STARFRUIT"": 13}",5423,5082,10001
798100,4919,84290,"(AMETHYSTS, MARKET << US, 9995, 1, 798100)
(STARFRUIT, US << MARKET, 5076, 1, 798100)","{""AMETHYSTS"": -15, ""STARFRUIT"": 14}",5426,5079,9998
798400,-10002,74288,"(AMETHYSTS, US << MARKET, 10002, 1, 798400)","{""AMETHYSTS"": -14, ""STARFRUIT"": 14}",5380,5081,10003
798500,65540,139828,"(AMETHYSTS, MARKET << US, 9998, 1, 798500)
(AMETHYSTS, MARKET << US, 9998, 1, 798500)
(AMETHYSTS, MARKET << US, 9998, 1, 798500)
(STARFRUIT, MARKET << US, 5078, 1, 798500)
(STARFRUIT, MARKET << US, 5078, 1, 798500)
(STARFRUIT, MARKET << US, 5078, 1, 798500)
(STARFRUIT, MARKET << US, 5078, 1, 798500)
(STARFRUIT, MARKET << US, 5078, 1, 798500)
(STARFRUIT, MARKET << US, 5078, 1, 798500)
(STARFRUIT, MARKET << US, 5078, 1, 798500)","{""AMETHYSTS"": -17, ""STARFRUIT"": 7}",5435,5077,9996
798600,-19996,119832,"(AMETHYSTS, US << MARKET, 9998, 1, 798600)
(AMETHYSTS, US << MARKET, 9998, 1, 798600)","{""AMETHYSTS"": -15, ""STARFRUIT"": 7}",5444,5081,9997
798700,-20336,99496,"(STARFRUIT, US << MARKET, 5084, 1, 798700)
(STARFRUIT, US << MARKET, 5084, 1, 798700)
(STARFRUIT, US << MARKET, 5084, 1, 798700)
(STARFRUIT, US << MARKET, 5084, 1, 798700)","{""AMETHYSTS"": -15, ""STARFRUIT"": 11}",5368,5082,10002
798900,20328,119824,"(STARFRUIT, MARKET << US, 5082, 1, 798900)
(STARFRUIT, MARKET << US, 5082, 1, 798900)
(STARFRUIT, MARKET << US, 5082, 1, 798900)
(STARFRUIT, MARKET << US, 5082, 1, 798900)","{""AMETHYSTS"": -15, ""STARFRUIT"": 7}",5390,5083,10001
799000,19990,139814,"(AMETHYSTS, MARKET << US, 9995, 1, 799000)
(AMETHYSTS, MARKET << US, 9995, 1, 799000)","{""AMETHYSTS"": -17, ""STARFRUIT"": 7}",5367,5079,10000
799500,-20160,119654,"(AMETHYSTS, US << MARKET, 10002, 1, 799500)
(STARFRUIT, US << MARKET, 5079, 1, 799500)
(STARFRUIT, US << MARKET, 5079, 1, 799500)","{""AMETHYSTS"": -16, ""STARFRUIT"": 9}",5358,5080,10001
799900,-5078,114576,"(STARFRUIT, US << MARKET, 5078, 1, 799900)","{""AMETHYSTS"": -16, ""STARFRUIT"": 10}",5362,5077,9999
800000,15246,129822,"(STARFRUIT, MARKET << US, 5082, 1, 800000)
(STARFRUIT, MARKET << US, 5082, 1, 800000)
(STARFRUIT, MARKET << US, 5082, 1, 800000)","{""AMETHYSTS"": -16, ""STARFRUIT"": 7}",5355,5083,10003
800600,5077,134899,"(STARFRUIT, MARKET << US, 5077, 1, 800600)","{""AMETHYSTS"": -16, ""STARFRUIT"": 6}",5379,5080,10000
801000,-10166,124733,"(STARFRUIT, US << MARKET, 5083, 1, 801000)
(STARFRUIT, US << MARKET, 5083, 1, 801000)","{""AMETHYSTS"": -16, ""STARFRUIT"": 8}",5373,5080,10000
801600,-4921,119812,"(AMETHYSTS, US << MARKET, 10005, 1, 801600)
(STARFRUIT, MARKET << US, 5084, 1, 801600)","{""AMETHYSTS"": -15, ""STARFRUIT"": 7}",5364,5081,10001
801700,-19992,99820,"(AMETHYSTS, US << MARKET, 9996, 1, 801700)
(AMETHYSTS, US << MARKET, 9996, 1, 801700)","{""AMETHYSTS"": -13, ""STARFRUIT"": 7}",5387,5081,10000
802400,-19996,79824,"(AMETHYSTS, US << MARKET, 9998, 1, 802400)
(AMETHYSTS, US << MARKET, 9998, 1, 802400)","{""AMETHYSTS"": -11, ""STARFRUIT"": 7}",5438,5083,9997
802700,20332,100156,"(STARFRUIT, MARKET << US, 5083, 1, 802700)
(STARFRUIT, MARKET << US, 5083, 1, 802700)
(STARFRUIT, MARKET << US, 5083, 1, 802700)
(STARFRUIT, MARKET << US, 5083, 1, 802700)","{""AMETHYSTS"": -11, ""STARFRUIT"": 3}",5408,5084,10000
802800,5079,105235,"(STARFRUIT, MARKET << US, 5079, 1, 802800)","{""AMETHYSTS"": -11, ""STARFRUIT"": 2}",5388,5082,10001
802900,39984,145219,"(AMETHYSTS, US << MARKET, 9996, 1, 802900)
(AMETHYSTS, US << MARKET, 9996, 1, 802900)
(AMETHYSTS, MARKET << US, 9996, 1, 802900)
(AMETHYSTS, MARKET << US, 9996, 1, 802900)
(AMETHYSTS, MARKET << US, 9996, 1, 802900)
(AMETHYSTS, MARKET << US, 9996, 1, 802900)
(AMETHYSTS, MARKET << US, 9996, 1, 802900)
(AMETHYSTS, MARKET << US, 9996, 1, 802900)","{""AMETHYSTS"": -15, ""STARFRUIT"": 2}",5383,5082,10000
803100,-14916,130303,"(AMETHYSTS, US << MARKET, 9998, 1, 803100)
(AMETHYSTS, US << MARKET, 9998, 1, 803100)
(STARFRUIT, MARKET << US, 5080, 1, 803100)","{""AMETHYSTS"": -13, ""STARFRUIT"": 1}",5434,5079,9996
803400,15252,145555,"(STARFRUIT, MARKET << US, 5084, 1, 803400)
(STARFRUIT, MARKET << US, 5084, 1, 803400)
(STARFRUIT, MARKET << US, 5084, 1, 803400)","{""AMETHYSTS"": -13, ""STARFRUIT"": -2}",5432,5081,9997
803700,10162,155717,"(STARFRUIT, MARKET << US, 5081, 1, 803700)
(STARFRUIT, MARKET << US, 5081, 1, 803700)","{""AMETHYSTS"": -13, ""STARFRUIT"": -4}",5397,5080,10000
803900,-10164,145553,"(STARFRUIT, US << MARKET, 5082, 1, 803900)
(STARFRUIT, US << MARKET, 5082, 1, 803900)","{""AMETHYSTS"": -13, ""STARFRUIT"": -2}",5383,5085,10000
804100,-4914,140639,"(AMETHYSTS, US << MARKET, 10002, 1, 804100)
(STARFRUIT, MARKET << US, 5088, 1, 804100)","{""AMETHYSTS"": -12, ""STARFRUIT"": -3}",5399,5084,9999
804300,-10002,130637,"(AMETHYSTS, US << MARKET, 10002, 1, 804300)","{""AMETHYSTS"": -11, ""STARFRUIT"": -3}",5352,5084,10003
804500,-34910,95727,"(AMETHYSTS, US << MARKET, 9998, 1, 804500)
(AMETHYSTS, US << MARKET, 9998, 1, 804500)
(AMETHYSTS, US << MARKET, 9998, 1, 804500)
(AMETHYSTS, US << MARKET, 9998, 1, 804500)
(AMETHYSTS, US << MARKET, 9998, 1, 804500)
(AMETHYSTS, US << MARKET, 9998, 1, 804500)
(AMETHYSTS, MARKET << US, 9998, 1, 804500)
(AMETHYSTS, MARKET << US, 9998, 1, 804500)
(STARFRUIT, MARKET << US, 5082, 1, 804500)","{""AMETHYSTS"": -7, ""STARFRUIT"": -4}",5380,5085,10001
804600,15085,110812,"(AMETHYSTS, MARKET << US, 9998, 1, 804600)
(STARFRUIT, MARKET << US, 5087, 1, 804600)","{""AMETHYSTS"": -8, ""STARFRUIT"": -5}",5401,5087,9997
805000,-10166,100646,"(STARFRUIT, US << MARKET, 5083, 1, 805000)
(STARFRUIT, US << MARKET, 5083, 1, 805000)","{""AMETHYSTS"": -8, ""STARFRUIT"": -3}",5400,5082,10000
805100,-20176,80470,"(AMETHYSTS, US << MARKET, 10002, 1, 805100)
(STARFRUIT, US << MARKET, 5087, 1, 805100)
(STARFRUIT, US << MARKET, 5087, 1, 805100)","{""AMETHYSTS"": -7, ""STARFRUIT"": -1}",5400,5084,9998
805400,5084,85554,"(STARFRUIT, US << MARKET, 5087, 1, 805400)
(STARFRUIT, US << MARKET, 5087, 1, 805400)
(STARFRUIT, MARKET << US, 5086, 1, 805400)
(STARFRUIT, MARKET << US, 5086, 1, 805400)
(STARFRUIT, MARKET << US, 5086, 1, 805400)","{""AMETHYSTS"": -7, ""STARFRUIT"": -2}",5385,5088,9999
805600,-10002,75552,"(AMETHYSTS, US << MARKET, 10002, 1, 805600)","{""AMETHYSTS"": -6, ""STARFRUIT"": -2}",5400,5082,9998
805700,9998,85550,"(AMETHYSTS, MARKET << US, 9998, 1, 805700)","{""AMETHYSTS"": -7, ""STARFRUIT"": -2}",5408,5085,9996
805800,-10166,75384,"(STARFRUIT, US << MARKET, 5083, 1, 805800)
(STARFRUIT, US << MARKET, 5083, 1, 805800)","{""AMETHYSTS"": -7, ""STARFRUIT"": 0}",5384,5086,10000
806200,-10178,65206,"(STARFRUIT, US << MARKET, 5089, 1, 806200)
(STARFRUIT, US << MARKET, 5089, 1, 806200)","{""AMETHYSTS"": -7, ""STARFRUIT"": 2}",5379,5090,10001
806300,10170,75376,"(STARFRUIT, MARKET << US, 5085, 1, 806300)
(STARFRUIT, MARKET << US, 5085, 1, 806300)","{""AMETHYSTS"": -7, ""STARFRUIT"": 0}",5369,5084,10001
806600,-100223,-24847,"(AMETHYSTS, US << MARKET, 10005, 1, 806600)
(AMETHYSTS, US << MARKET, 10005, 1, 806600)
(AMETHYSTS, US << MARKET, 10005, 1, 806600)
(AMETHYSTS, US << MARKET, 10005, 1, 806600)
(AMETHYSTS, US << MARKET, 10005, 1, 806600)
(AMETHYSTS, US << MARKET, 10005, 1, 806600)
(AMETHYSTS, US << MARKET, 10005, 1, 806600)
(AMETHYSTS, US << MARKET, 10005, 1, 806600)
(AMETHYSTS, US << MARKET, 10005, 1, 806600)
(STARFRUIT, US << MARKET, 5089, 1, 806600)
(STARFRUIT, US << MARKET, 5089, 1, 806600)","{""AMETHYSTS"": 2, ""STARFRUIT"": 2}",5333,5090,10000
806900,115153,90306,"(AMETHYSTS, US << MARKET, 10002, 1, 806900)
(AMETHYSTS, US << MARKET, 10002, 1, 806900)
(AMETHYSTS, US << MARKET, 10002, 1, 806900)
(AMETHYSTS, MARKET << US, 10005, 1, 806900)
(AMETHYSTS, MARKET << US, 10005, 1, 806900)
(AMETHYSTS, MARKET << US, 10005, 1, 806900)
(AMETHYSTS, MARKET << US, 10005, 1, 806900)
(AMETHYSTS, MARKET << US, 10005, 1, 806900)
(AMETHYSTS, MARKET << US, 10005, 1, 806900)
(AMETHYSTS, MARKET << US, 10005, 1, 806900)
(AMETHYSTS, MARKET << US, 10005, 1, 806900)
(AMETHYSTS, MARKET << US, 10005, 1, 806900)
(AMETHYSTS, MARKET << US, 10005, 1, 806900)
(AMETHYSTS, MARKET << US, 10005, 1, 806900)
(AMETHYSTS, MARKET << US, 10005, 1, 806900)
(AMETHYSTS, MARKET << US, 10005, 1, 806900)
(AMETHYSTS, MARKET << US, 10005, 1, 806900)
(STARFRUIT, MARKET << US, 5089, 1, 806900)","{""AMETHYSTS"": -9, ""STARFRUIT"": 1}",5369,5090,10003
807100,-10002,80304,"(AMETHYSTS, US << MARKET, 10002, 1, 807100)","{""AMETHYSTS"": -8, ""STARFRUIT"": 1}",5367,5087,10003
807300,-25460,54844,"(STARFRUIT, US << MARKET, 5092, 1, 807300)
(STARFRUIT, US << MARKET, 5092, 1, 807300)
(STARFRUIT, US << MARKET, 5092, 1, 807300)
(STARFRUIT, US << MARKET, 5092, 1, 807300)
(STARFRUIT, US << MARKET, 5092, 1, 807300)","{""AMETHYSTS"": -8, ""STARFRUIT"": 6}",5378,5089,10000
807700,49990,104834,"(AMETHYSTS, MARKET << US, 9998, 1, 807700)
(AMETHYSTS, MARKET << US, 9998, 1, 807700)
(AMETHYSTS, MARKET << US, 9998, 1, 807700)
(AMETHYSTS, MARKET << US, 9998, 1, 807700)
(AMETHYSTS, MARKET << US, 9998, 1, 807700)","{""AMETHYSTS"": -13, ""STARFRUIT"": 6}",5401,5088,9997
807800,19992,124826,"(AMETHYSTS, MARKET << US, 9996, 1, 807800)
(AMETHYSTS, MARKET << US, 9996, 1, 807800)","{""AMETHYSTS"": -15, ""STARFRUIT"": 6}",5360,5089,10000
808500,-10172,114654,"(STARFRUIT, US << MARKET, 5086, 1, 808500)
(STARFRUIT, US << MARKET, 5086, 1, 808500)","{""AMETHYSTS"": -15, ""STARFRUIT"": 8}",5366,5089,10000
808700,-9824,104830,"(AMETHYSTS, US << MARKET, 10005, 1, 808700)
(AMETHYSTS, US << MARKET, 10005, 1, 808700)
(STARFRUIT, MARKET << US, 5093, 1, 808700)
(STARFRUIT, MARKET << US, 5093, 1, 808700)","{""AMETHYSTS"": -13, ""STARFRUIT"": 6}",5331,5090,10003
808800,-10182,94648,"(STARFRUIT, US << MARKET, 5091, 1, 808800)
(STARFRUIT, US << MARKET, 5091, 1, 808800)","{""AMETHYSTS"": -13, ""STARFRUIT"": 8}",5384,5092,10000
808900,-30170,64478,"(AMETHYSTS, US << MARKET, 9998, 1, 808900)
(AMETHYSTS, US << MARKET, 9998, 1, 808900)
(STARFRUIT, US << MARKET, 5087, 1, 808900)
(STARFRUIT, US << MARKET, 5087, 1, 808900)","{""AMETHYSTS"": -11, ""STARFRUIT"": 10}",5371,5086,9997
809000,-5092,59386,"(STARFRUIT, US << MARKET, 5092, 1, 809000)","{""AMETHYSTS"": -11, ""STARFRUIT"": 11}",5398,5092,10000
809100,-19996,39390,"(AMETHYSTS, US << MARKET, 9998, 1, 809100)
(AMETHYSTS, US << MARKET, 9998, 1, 809100)","{""AMETHYSTS"": -9, ""STARFRUIT"": 11}",5396,5089,9997
809400,-29988,9402,"(AMETHYSTS, US << MARKET, 9996, 1, 809400)
(AMETHYSTS, US << MARKET, 9996, 1, 809400)
(AMETHYSTS, US << MARKET, 9996, 1, 809400)
(AMETHYSTS, US << MARKET, 9996, 1, 809400)
(AMETHYSTS, MARKET << US, 9996, 1, 809400)","{""AMETHYSTS"": -6, ""STARFRUIT"": 11}",5392,5090,10000
809500,-19996,-10594,"(AMETHYSTS, US << MARKET, 9998, 1, 809500)
(AMETHYSTS, US << MARKET, 9998, 1, 809500)","{""AMETHYSTS"": -4, ""STARFRUIT"": 11}",5423,5091,9996
809600,-20356,-30950,"(STARFRUIT, US << MARKET, 5089, 1, 809600)
(STARFRUIT, US << MARKET, 5089, 1, 809600)
(STARFRUIT, US << MARKET, 5089, 1, 809600)
(STARFRUIT, US << MARKET, 5089, 1, 809600)","{""AMETHYSTS"": -4, ""STARFRUIT"": 15}",5419,5091,9999
809900,-15275,-46225,"(STARFRUIT, US << MARKET, 5092, 1, 809900)
(STARFRUIT, US << MARKET, 5092, 1, 809900)
(STARFRUIT, US << MARKET, 5092, 1, 809900)
(STARFRUIT, US << MARKET, 5092, 1, 809900)
(STARFRUIT, MARKET << US, 5093, 1, 809900)","{""AMETHYSTS"": -4, ""STARFRUIT"": 18}",5445,5093,10001
810300,10182,-36043,"(AMETHYSTS, US << MARKET, 10005, 1, 810300)
(AMETHYSTS, US << MARKET, 10005, 1, 810300)
(AMETHYSTS, MARKET << US, 10002, 1, 810300)
(AMETHYSTS, MARKET << US, 10002, 1, 810300)
(STARFRUIT, MARKET << US, 5094, 1, 810300)
(STARFRUIT, MARKET << US, 5094, 1, 810300)","{""AMETHYSTS"": -4, ""STARFRUIT"": 16}",5385,5090,10003
811200,9998,-26045,"(AMETHYSTS, MARKET << US, 9998, 1, 811200)","{""AMETHYSTS"": -5, ""STARFRUIT"": 16}",5342,5087,10001
811300,-15097,-41142,"(AMETHYSTS, US << MARKET, 10005, 1, 811300)
(STARFRUIT, US << MARKET, 5092, 1, 811300)","{""AMETHYSTS"": -4, ""STARFRUIT"": 17}",5405,5091,10000
811700,5090,-36052,"(STARFRUIT, MARKET << US, 5090, 1, 811700)","{""AMETHYSTS"": -4, ""STARFRUIT"": 16}",5404,5091,10000
812100,35623,-429,"(STARFRUIT, MARKET << US, 5089, 1, 812100)
(STARFRUIT, MARKET << US, 5089, 1, 812100)
(STARFRUIT, MARKET << US, 5089, 1, 812100)
(STARFRUIT, MARKET << US, 5089, 1, 812100)
(STARFRUIT, MARKET << US, 5089, 1, 812100)
(STARFRUIT, MARKET << US, 5089, 1, 812100)
(STARFRUIT, MARKET << US, 5089, 1, 812100)","{""AMETHYSTS"": -4, ""STARFRUIT"": 9}",5381,5090,10000
812300,-5089,-5518,"(STARFRUIT, US << MARKET, 5089, 1, 812300)","{""AMETHYSTS"": -4, ""STARFRUIT"": 10}",5372,5089,10000
813300,20004,14486,"(AMETHYSTS, MARKET << US, 10002, 1, 813300)
(AMETHYSTS, MARKET << US, 10002, 1, 813300)","{""AMETHYSTS"": -6, ""STARFRUIT"": 10}",5342,5085,9999
813400,5081,19567,"(STARFRUIT, MARKET << US, 5081, 1, 813400)","{""AMETHYSTS"": -6, ""STARFRUIT"": 9}",5323,5084,10000
813500,-20004,-437,"(AMETHYSTS, US << MARKET, 10002, 1, 813500)
(AMETHYSTS, US << MARKET, 10002, 1, 813500)","{""AMETHYSTS"": -4, ""STARFRUIT"": 9}",5316,5085,10003
814000,20004,19567,"(AMETHYSTS, MARKET << US, 10002, 1, 814000)
(AMETHYSTS, MARKET << US, 10002, 1, 814000)","{""AMETHYSTS"": -6, ""STARFRUIT"": 9}",5341,5086,10000
814100,49990,69557,"(AMETHYSTS, MARKET << US, 9998, 1, 814100)
(AMETHYSTS, MARKET << US, 9998, 1, 814100)
(AMETHYSTS, MARKET << US, 9998, 1, 814100)
(AMETHYSTS, MARKET << US, 9998, 1, 814100)
(AMETHYSTS, MARKET << US, 9998, 1, 814100)","{""AMETHYSTS"": -11, ""STARFRUIT"": 9}",5357,5084,9996
814300,15076,84633,"(AMETHYSTS, MARKET << US, 9995, 1, 814300)
(STARFRUIT, MARKET << US, 5081, 1, 814300)","{""AMETHYSTS"": -12, ""STARFRUIT"": 8}",5305,5084,10000
814500,-79942,4691,"(AMETHYSTS, US << MARKET, 9995, 1, 814500)
(AMETHYSTS, US << MARKET, 9995, 1, 814500)
(AMETHYSTS, US << MARKET, 9995, 1, 814500)
(AMETHYSTS, US << MARKET, 9995, 1, 814500)
(AMETHYSTS, US << MARKET, 9995, 1, 814500)
(AMETHYSTS, US << MARKET, 9995, 1, 814500)
(AMETHYSTS, US << MARKET, 9995, 1, 814500)
(AMETHYSTS, US << MARKET, 9995, 1, 814500)
(AMETHYSTS, US << MARKET, 9995, 1, 814500)
(AMETHYSTS, US << MARKET, 9995, 1, 814500)
(AMETHYSTS, US << MARKET, 9995, 1, 814500)
(AMETHYSTS, US << MARKET, 9995, 1, 814500)
(AMETHYSTS, US << MARKET, 9995, 1, 814500)
(AMETHYSTS, US << MARKET, 9995, 1, 814500)
(AMETHYSTS, MARKET << US, 9998, 1, 814500)
(AMETHYSTS, MARKET << US, 9998, 1, 814500)
(AMETHYSTS, MARKET << US, 9998, 1, 814500)
(AMETHYSTS, MARKET << US, 9998, 1, 814500)
(AMETHYSTS, MARKET << US, 9998, 1, 814500)
(AMETHYSTS, MARKET << US, 9998, 1, 814500)","{""AMETHYSTS"": -4, ""STARFRUIT"": 8}",5379,5084,9996
814600,-25074,-20383,"(AMETHYSTS, US << MARKET, 9996, 1, 814600)
(AMETHYSTS, US << MARKET, 9996, 1, 814600)
(STARFRUIT, US << MARKET, 5082, 1, 814600)","{""AMETHYSTS"": -2, ""STARFRUIT"": 9}",5355,5082,10000
814700,-19996,-40379,"(AMETHYSTS, US << MARKET, 9998, 1, 814700)
(AMETHYSTS, US << MARKET, 9998, 1, 814700)","{""AMETHYSTS"": 0, ""STARFRUIT"": 9}",5377,5084,9997
814800,-5081,-45460,"(STARFRUIT, US << MARKET, 5081, 1, 814800)","{""AMETHYSTS"": 0, ""STARFRUIT"": 10}",5370,5083,10000
814900,10160,-35300,"(STARFRUIT, US << MARKET, 5080, 1, 814900)
(STARFRUIT, US << MARKET, 5080, 1, 814900)
(STARFRUIT, US << MARKET, 5080, 1, 814900)
(STARFRUIT, US << MARKET, 5080, 1, 814900)
(STARFRUIT, MARKET << US, 5080, 1, 814900)
(STARFRUIT, MARKET << US, 5080, 1, 814900)
(STARFRUIT, MARKET << US, 5080, 1, 814900)
(STARFRUIT, MARKET << US, 5080, 1, 814900)
(STARFRUIT, MARKET << US, 5080, 1, 814900)
(STARFRUIT, MARKET << US, 5080, 1, 814900)","{""AMETHYSTS"": 0, ""STARFRUIT"": 8}",5340,5080,10000
816100,-5085,-40385,"(STARFRUIT, US << MARKET, 5085, 1, 816100)","{""AMETHYSTS"": 0, ""STARFRUIT"": 9}",5380,5085,10000
816500,5080,-35305,"(STARFRUIT, MARKET << US, 5080, 1, 816500)","{""AMETHYSTS"": 0, ""STARFRUIT"": 8}",5359,5083,10000
816800,-4918,-40223,"(AMETHYSTS, US << MARKET, 10004, 1, 816800)
(STARFRUIT, MARKET << US, 5086, 1, 816800)","{""AMETHYSTS"": 1, ""STARFRUIT"": 7}",5358,5083,10000
816900,15083,-25140,"(AMETHYSTS, MARKET << US, 10000, 1, 816900)
(STARFRUIT, MARKET << US, 5083, 1, 816900)","{""AMETHYSTS"": 0, ""STARFRUIT"": 6}",5370,5085,10002
817000,30486,5346,"(STARFRUIT, MARKET << US, 5081, 1, 817000)
(STARFRUIT, MARKET << US, 5081, 1, 817000)
(STARFRUIT, MARKET << US, 5081, 1, 817000)
(STARFRUIT, MARKET << US, 5081, 1, 817000)
(STARFRUIT, MARKET << US, 5081, 1, 817000)
(STARFRUIT, MARKET << US, 5081, 1, 817000)","{""AMETHYSTS"": 0, ""STARFRUIT"": 0}",5346,5080,10000
817100,-20008,-14662,"(AMETHYSTS, US << MARKET, 10004, 1, 817100)
(AMETHYSTS, US << MARKET, 10004, 1, 817100)","{""AMETHYSTS"": 2, ""STARFRUIT"": 0}",5338,5082,10000
817300,-40008,-54670,"(AMETHYSTS, US << MARKET, 10002, 1, 817300)
(AMETHYSTS, US << MARKET, 10002, 1, 817300)
(AMETHYSTS, US << MARKET, 10002, 1, 817300)
(AMETHYSTS, US << MARKET, 10002, 1, 817300)","{""AMETHYSTS"": 6, ""STARFRUIT"": 0}",5348,5085,10003
817700,5082,-49588,"(STARFRUIT, MARKET << US, 5082, 1, 817700)","{""AMETHYSTS"": 6, ""STARFRUIT"": -1}",5330,5082,10000
817800,-30534,-80122,"(STARFRUIT, US << MARKET, 5089, 1, 817800)
(STARFRUIT, US << MARKET, 5089, 1, 817800)
(STARFRUIT, US << MARKET, 5089, 1, 817800)
(STARFRUIT, US << MARKET, 5089, 1, 817800)
(STARFRUIT, US << MARKET, 5089, 1, 817800)
(STARFRUIT, US << MARKET, 5089, 1, 817800)","{""AMETHYSTS"": 6, ""STARFRUIT"": 5}",5308,5086,10000
817900,-20344,-100466,"(STARFRUIT, US << MARKET, 5086, 1, 817900)
(STARFRUIT, US << MARKET, 5086, 1, 817900)
(STARFRUIT, US << MARKET, 5086, 1, 817900)
(STARFRUIT, US << MARKET, 5086, 1, 817900)","{""AMETHYSTS"": 6, ""STARFRUIT"": 9}",5272,5082,10000
818000,14919,-85547,"(AMETHYSTS, MARKET << US, 10004, 1, 818000)
(AMETHYSTS, MARKET << US, 10004, 1, 818000)
(STARFRUIT, US << MARKET, 5089, 1, 818000)","{""AMETHYSTS"": 4, ""STARFRUIT"": 10}",5313,5086,10000
818200,-176,-85723,"(AMETHYSTS, US << MARKET, 10004, 1, 818200)
(AMETHYSTS, MARKET << US, 10004, 1, 818200)
(AMETHYSTS, MARKET << US, 10004, 1, 818200)
(STARFRUIT, US << MARKET, 5090, 1, 818200)
(STARFRUIT, US << MARKET, 5090, 1, 818200)","{""AMETHYSTS"": 3, ""STARFRUIT"": 12}",5309,5086,10000
818400,5089,-80634,"(STARFRUIT, MARKET << US, 5089, 1, 818400)","{""AMETHYSTS"": 3, ""STARFRUIT"": 11}",5345,5089,10000
818600,-4913,-85547,"(AMETHYSTS, US << MARKET, 10000, 1, 818600)
(STARFRUIT, MARKET << US, 5087, 1, 818600)","{""AMETHYSTS"": 4, ""STARFRUIT"": 10}",5305,5086,9998
818800,-10002,-95549,"(AMETHYSTS, US << MARKET, 10002, 1, 818800)","{""AMETHYSTS"": 5, ""STARFRUIT"": 10}",5346,5088,10003
819000,-20344,-115893,"(STARFRUIT, US << MARKET, 5086, 1, 819000)
(STARFRUIT, US << MARKET, 5086, 1, 819000)
(STARFRUIT, US << MARKET, 5086, 1, 819000)
(STARFRUIT, US << MARKET, 5086, 1, 819000)","{""AMETHYSTS"": 5, ""STARFRUIT"": 14}",5353,5089,10000
819900,9998,-105895,"(AMETHYSTS, MARKET << US, 9998, 1, 819900)","{""AMETHYSTS"": 4, ""STARFRUIT"": 14}",5325,5088,9997
820100,55279,-50616,"(AMETHYSTS, MARKET << US, 10004, 1, 820100)
(AMETHYSTS, MARKET << US, 10004, 1, 820100)
(AMETHYSTS, MARKET << US, 10004, 1, 820100)
(AMETHYSTS, MARKET << US, 10004, 1, 820100)
(STARFRUIT, US << MARKET, 5091, 1, 820100)
(STARFRUIT, US << MARKET, 5091, 1, 820100)
(STARFRUIT, MARKET << US, 5089, 1, 820100)
(STARFRUIT, MARKET << US, 5089, 1, 820100)
(STARFRUIT, MARKET << US, 5089, 1, 820100)
(STARFRUIT, MARKET << US, 5089, 1, 820100)
(STARFRUIT, MARKET << US, 5089, 1, 820100)","{""AMETHYSTS"": 0, ""STARFRUIT"": 11}",5374,5090,10000
820500,9998,-40618,"(AMETHYSTS, MARKET << US, 9998, 1, 820500)","{""AMETHYSTS"": -1, ""STARFRUIT"": 11}",5376,5090,9996
820600,-5087,-45705,"(STARFRUIT, US << MARKET, 5087, 1, 820600)","{""AMETHYSTS"": -1, ""STARFRUIT"": 12}",5375,5090,10000
820900,15264,-30441,"(STARFRUIT, US << MARKET, 5088, 1, 820900)
(STARFRUIT, US << MARKET, 5088, 1, 820900)
(STARFRUIT, US << MARKET, 5088, 1, 820900)
(STARFRUIT, US << MARKET, 5088, 1, 820900)
(STARFRUIT, MARKET << US, 5088, 1, 820900)
(STARFRUIT, MARKET << US, 5088, 1, 820900)
(STARFRUIT, MARKET << US, 5088, 1, 820900)
(STARFRUIT, MARKET << US, 5088, 1, 820900)
(STARFRUIT, MARKET << US, 5088, 1, 820900)
(STARFRUIT, MARKET << US, 5088, 1, 820900)
(STARFRUIT, MARKET << US, 5088, 1, 820900)","{""AMETHYSTS"": -1, ""STARFRUIT"": 9}",5378,5091,10000
821500,89964,59523,"(AMETHYSTS, US << MARKET, 9996, 1, 821500)
(AMETHYSTS, US << MARKET, 9996, 1, 821500)
(AMETHYSTS, MARKET << US, 9996, 1, 821500)
(AMETHYSTS, MARKET << US, 9996, 1, 821500)
(AMETHYSTS, MARKET << US, 9996, 1, 821500)
(AMETHYSTS, MARKET << US, 9996, 1, 821500)
(AMETHYSTS, MARKET << US, 9996, 1, 821500)
(AMETHYSTS, MARKET << US, 9996, 1, 821500)
(AMETHYSTS, MARKET << US, 9996, 1, 821500)
(AMETHYSTS, MARKET << US, 9996, 1, 821500)
(AMETHYSTS, MARKET << US, 9996, 1, 821500)
(AMETHYSTS, MARKET << US, 9996, 1, 821500)
(AMETHYSTS, MARKET << US, 9996, 1, 821500)","{""AMETHYSTS"": -10, ""STARFRUIT"": 9}",5324,5089,10000
822000,-19996,39527,"(AMETHYSTS, US << MARKET, 9998, 1, 822000)
(AMETHYSTS, US << MARKET, 9998, 1, 822000)","{""AMETHYSTS"": -8, ""STARFRUIT"": 9}",5284,5085,10001
822600,50010,89537,"(AMETHYSTS, US << MARKET, 10002, 1, 822600)
(AMETHYSTS, MARKET << US, 10002, 1, 822600)
(AMETHYSTS, MARKET << US, 10002, 1, 822600)
(AMETHYSTS, MARKET << US, 10002, 1, 822600)
(AMETHYSTS, MARKET << US, 10002, 1, 822600)
(AMETHYSTS, MARKET << US, 10002, 1, 822600)
(AMETHYSTS, MARKET << US, 10002, 1, 822600)","{""AMETHYSTS"": -13, ""STARFRUIT"": 9}",5290,5088,10003
822700,-20344,69193,"(STARFRUIT, US << MARKET, 5086, 1, 822700)
(STARFRUIT, US << MARKET, 5086, 1, 822700)
(STARFRUIT, US << MARKET, 5086, 1, 822700)
(STARFRUIT, US << MARKET, 5086, 1, 822700)","{""AMETHYSTS"": -13, ""STARFRUIT"": 13}",5324,5087,10000
822800,-15261,53932,"(STARFRUIT, US << MARKET, 5088, 1, 822800)
(STARFRUIT, US << MARKET, 5088, 1, 822800)
(STARFRUIT, US << MARKET, 5088, 1, 822800)
(STARFRUIT, US << MARKET, 5088, 1, 822800)
(STARFRUIT, MARKET << US, 5091, 1, 822800)","{""AMETHYSTS"": -13, ""STARFRUIT"": 16}",5334,5086,9998
823200,-5085,48847,"(STARFRUIT, US << MARKET, 5085, 1, 823200)","{""AMETHYSTS"": -13, ""STARFRUIT"": 17}",5343,5088,10000
824100,25429,74276,"(STARFRUIT, US << MARKET, 5086, 1, 824100)
(STARFRUIT, US << MARKET, 5086, 1, 824100)
(STARFRUIT, US << MARKET, 5086, 1, 824100)
(STARFRUIT, MARKET << US, 5086, 1, 824100)
(STARFRUIT, MARKET << US, 5086, 1, 824100)
(STARFRUIT, MARKET << US, 5086, 1, 824100)
(STARFRUIT, MARKET << US, 5086, 1, 824100)
(STARFRUIT, MARKET << US, 5086, 1, 824100)
(STARFRUIT, MARKET << US, 5086, 1, 824100)
(STARFRUIT, MARKET << US, 5086, 1, 824100)
(STARFRUIT, MARKET << US, 5085, 1, 824100)","{""AMETHYSTS"": -13, ""STARFRUIT"": 12}",5331,5089,10001
825500,-9824,64452,"(AMETHYSTS, US << MARKET, 9996, 1, 825500)
(AMETHYSTS, US << MARKET, 9996, 1, 825500)
(STARFRUIT, MARKET << US, 5084, 1, 825500)
(STARFRUIT, MARKET << US, 5084, 1, 825500)","{""AMETHYSTS"": -11, ""STARFRUIT"": 10}",5333,5087,9999
826200,-5085,59367,"(STARFRUIT, US << MARKET, 5085, 1, 826200)","{""AMETHYSTS"": -11, ""STARFRUIT"": 11}",5335,5088,10000
827000,-5091,54276,"(STARFRUIT, US << MARKET, 5091, 1, 827000)","{""AMETHYSTS"": -11, ""STARFRUIT"": 12}",5368,5091,10000
827100,0,54276,"(STARFRUIT, US << MARKET, 5090, 1, 827100)
(STARFRUIT, MARKET << US, 5090, 1, 827100)","{""AMETHYSTS"": -11, ""STARFRUIT"": 12}",5320,5087,10000
827400,-19996,34280,"(AMETHYSTS, US << MARKET, 9998, 1, 827400)
(AMETHYSTS, US << MARKET, 9998, 1, 827400)","{""AMETHYSTS"": -9, ""STARFRUIT"": 12}",5363,5088,9997
827600,-19996,14284,"(AMETHYSTS, US << MARKET, 9998, 1, 827600)
(AMETHYSTS, US << MARKET, 9998, 1, 827600)","{""AMETHYSTS"": -7, ""STARFRUIT"": 12}",5337,5086,9997
827800,45585,59869,"(AMETHYSTS, US << MARKET, 10004, 1, 827800)
(AMETHYSTS, MARKET << US, 10004, 1, 827800)
(AMETHYSTS, MARKET << US, 10004, 1, 827800)
(STARFRUIT, MARKET << US, 5083, 1, 827800)
(STARFRUIT, MARKET << US, 5083, 1, 827800)
(STARFRUIT, MARKET << US, 5083, 1, 827800)
(STARFRUIT, MARKET << US, 5083, 1, 827800)
(STARFRUIT, MARKET << US, 5083, 1, 827800)
(STARFRUIT, MARKET << US, 5083, 1, 827800)
(STARFRUIT, MARKET << US, 5083, 1, 827800)","{""AMETHYSTS"": -8, ""STARFRUIT"": 5}",5299,5086,10000
828200,-50144,9725,"(AMETHYSTS, US << MARKET, 9995, 1, 828200)
(AMETHYSTS, US << MARKET, 9995, 1, 828200)
(AMETHYSTS, US << MARKET, 9995, 1, 828200)
(AMETHYSTS, US << MARKET, 9995, 1, 828200)
(STARFRUIT, US << MARKET, 5082, 1, 828200)
(STARFRUIT, US << MARKET, 5082, 1, 828200)
(STARFRUIT, US << MARKET, 5082, 1, 828200)
(STARFRUIT, MARKET << US, 5082, 1, 828200)","{""AMETHYSTS"": -4, ""STARFRUIT"": 7}",5320,5085,10000
828700,-5087,4638,"(STARFRUIT, US << MARKET, 5087, 1, 828700)","{""AMETHYSTS"": -4, ""STARFRUIT"": 8}",5342,5088,10000
829300,-20360,-15722,"(STARFRUIT, US << MARKET, 5090, 1, 829300)
(STARFRUIT, US << MARKET, 5090, 1, 829300)
(STARFRUIT, US << MARKET, 5090, 1, 829300)
(STARFRUIT, US << MARKET, 5090, 1, 829300)","{""AMETHYSTS"": -4, ""STARFRUIT"": 12}",5310,5086,10000
829500,25091,9369,"(AMETHYSTS, MARKET << US, 10004, 1, 829500)
(AMETHYSTS, MARKET << US, 10004, 1, 829500)
(STARFRUIT, MARKET << US, 5083, 1, 829500)","{""AMETHYSTS"": -6, ""STARFRUIT"": 11}",5271,5082,10000
829600,-40008,-30639,"(AMETHYSTS, US << MARKET, 10002, 1, 829600)
(AMETHYSTS, US << MARKET, 10002, 1, 829600)
(AMETHYSTS, US << MARKET, 10002, 1, 829600)
(AMETHYSTS, US << MARKET, 10002, 1, 829600)","{""AMETHYSTS"": -2, ""STARFRUIT"": 11}",5290,5085,10003
830500,9998,-20641,"(AMETHYSTS, MARKET << US, 9998, 1, 830500)","{""AMETHYSTS"": -3, ""STARFRUIT"": 11}",5292,5084,9997
830600,-40008,-60649,"(AMETHYSTS, US << MARKET, 10002, 1, 830600)
(AMETHYSTS, US << MARKET, 10002, 1, 830600)
(AMETHYSTS, US << MARKET, 10002, 1, 830600)
(AMETHYSTS, US << MARKET, 10002, 1, 830600)","{""AMETHYSTS"": 1, ""STARFRUIT"": 11}",5278,5084,10003
830900,20004,-40645,"(AMETHYSTS, MARKET << US, 10002, 1, 830900)
(AMETHYSTS, MARKET << US, 10002, 1, 830900)","{""AMETHYSTS"": -1, ""STARFRUIT"": 11}",5276,5084,10003
831300,19992,-20653,"(AMETHYSTS, MARKET << US, 9996, 1, 831300)
(AMETHYSTS, MARKET << US, 9996, 1, 831300)","{""AMETHYSTS"": -3, ""STARFRUIT"": 11}",5285,5085,9999
831400,-19996,-40649,"(AMETHYSTS, US << MARKET, 9998, 1, 831400)
(AMETHYSTS, US << MARKET, 9998, 1, 831400)","{""AMETHYSTS"": -1, ""STARFRUIT"": 11}",5295,5086,10002
831800,9998,-30651,"(AMETHYSTS, MARKET << US, 9998, 1, 831800)","{""AMETHYSTS"": -2, ""STARFRUIT"": 11}",5303,5086,9996
832100,-5090,-35741,"(STARFRUIT, US << MARKET, 5090, 1, 832100)","{""AMETHYSTS"": -2, ""STARFRUIT"": 12}",5341,5090,9999
832300,15255,-20486,"(STARFRUIT, MARKET << US, 5085, 1, 832300)
(STARFRUIT, MARKET << US, 5085, 1, 832300)
(STARFRUIT, MARKET << US, 5085, 1, 832300)","{""AMETHYSTS"": -2, ""STARFRUIT"": 9}",5306,5088,10000
832500,-59988,-80474,"(AMETHYSTS, US << MARKET, 9998, 1, 832500)
(AMETHYSTS, US << MARKET, 9998, 1, 832500)
(AMETHYSTS, US << MARKET, 9998, 1, 832500)
(AMETHYSTS, US << MARKET, 9998, 1, 832500)
(AMETHYSTS, US << MARKET, 9998, 1, 832500)
(AMETHYSTS, US << MARKET, 9998, 1, 832500)","{""AMETHYSTS"": 4, ""STARFRUIT"": 9}",5293,5087,9996
833000,60012,-20462,"(AMETHYSTS, MARKET << US, 10002, 1, 833000)
(AMETHYSTS, MARKET << US, 10002, 1, 833000)
(AMETHYSTS, MARKET << US, 10002, 1, 833000)
(AMETHYSTS, MARKET << US, 10002, 1, 833000)
(AMETHYSTS, MARKET << US, 10002, 1, 833000)
(AMETHYSTS, MARKET << US, 10002, 1, 833000)","{""AMETHYSTS"": -2, ""STARFRUIT"": 9}",5314,5086,9999
833700,-5090,-25552,"(STARFRUIT, US << MARKET, 5090, 1, 833700)","{""AMETHYSTS"": -2, ""STARFRUIT"": 10}",5348,5090,10000
834200,-5090,-30642,"(STARFRUIT, US << MARKET, 5090, 1, 834200)","{""AMETHYSTS"": -2, ""STARFRUIT"": 11}",5357,5091,10001
834300,-25086,-55728,"(AMETHYSTS, US << MARKET, 9998, 1, 834300)
(AMETHYSTS, US << MARKET, 9998, 1, 834300)
(STARFRUIT, US << MARKET, 5090, 1, 834300)","{""AMETHYSTS"": 0, ""STARFRUIT"": 12}",5364,5091,10001
834400,-19816,-75544,"(AMETHYSTS, US << MARKET, 9996, 1, 834400)
(AMETHYSTS, US << MARKET, 9996, 1, 834400)
(AMETHYSTS, US << MARKET, 9996, 1, 834400)
(AMETHYSTS, US << MARKET, 9996, 1, 834400)
(AMETHYSTS, MARKET << US, 9998, 1, 834400)
(STARFRUIT, MARKET << US, 5085, 1, 834400)
(STARFRUIT, MARKET << US, 5085, 1, 834400)","{""AMETHYSTS"": 3, ""STARFRUIT"": 10}",5327,5088,9997
834500,5085,-70459,"(STARFRUIT, MARKET << US, 5085, 1, 834500)","{""AMETHYSTS"": 3, ""STARFRUIT"": 9}",5333,5088,10000
834600,5086,-65373,"(STARFRUIT, MARKET << US, 5086, 1, 834600)","{""AMETHYSTS"": 3, ""STARFRUIT"": 8}",5307,5085,10000
834700,-19992,-85365,"(AMETHYSTS, US << MARKET, 9996, 1, 834700)
(AMETHYSTS, US << MARKET, 9996, 1, 834700)","{""AMETHYSTS"": 5, ""STARFRUIT"": 8}",5334,5088,9999
834800,-10002,-95367,"(AMETHYSTS, US << MARKET, 10002, 1, 834800)","{""AMETHYSTS"": 6, ""STARFRUIT"": 8}",5355,5088,10003
834900,4911,-90456,"(AMETHYSTS, MARKET << US, 9996, 1, 834900)
(STARFRUIT, US << MARKET, 5085, 1, 834900)","{""AMETHYSTS"": 5, ""STARFRUIT"": 9}",5336,5088,10000
836100,5084,-85372,"(STARFRUIT, MARKET << US, 5084, 1, 836100)","{""AMETHYSTS"": 5, ""STARFRUIT"": 8}",5301,5086,9997
836300,25420,-59952,"(STARFRUIT, MARKET << US, 5084, 1, 836300)
(STARFRUIT, MARKET << US, 5084, 1, 836300)
(STARFRUIT, MARKET << US, 5084, 1, 836300)
(STARFRUIT, MARKET << US, 5084, 1, 836300)
(STARFRUIT, MARKET << US, 5084, 1, 836300)","{""AMETHYSTS"": 5, ""STARFRUIT"": 3}",5304,5087,9999
836600,20004,-39948,"(AMETHYSTS, MARKET << US, 10002, 1, 836600)
(AMETHYSTS, MARKET << US, 10002, 1, 836600)","{""AMETHYSTS"": 3, ""STARFRUIT"": 3}",5310,5086,10000
836700,5088,-34860,"(STARFRUIT, MARKET << US, 5088, 1, 836700)","{""AMETHYSTS"": 3, ""STARFRUIT"": 2}",5319,5088,10001
836900,-10166,-45026,"(STARFRUIT, US << MARKET, 5083, 1, 836900)
(STARFRUIT, US << MARKET, 5083, 1, 836900)","{""AMETHYSTS"": 3, ""STARFRUIT"": 4}",5311,5085,9999
837600,5084,-39942,"(STARFRUIT, MARKET << US, 5084, 1, 837600)","{""AMETHYSTS"": 3, ""STARFRUIT"": 3}",5319,5087,10000
838000,9998,-29944,"(AMETHYSTS, MARKET << US, 9998, 1, 838000)","{""AMETHYSTS"": 2, ""STARFRUIT"": 3}",5309,5085,9999
838600,340,-29604,"(AMETHYSTS, US << MARKET, 9998, 1, 838600)
(AMETHYSTS, US << MARKET, 9998, 1, 838600)
(STARFRUIT, MARKET << US, 5084, 1, 838600)
(STARFRUIT, MARKET << US, 5084, 1, 838600)
(STARFRUIT, MARKET << US, 5084, 1, 838600)
(STARFRUIT, MARKET << US, 5084, 1, 838600)","{""AMETHYSTS"": 4, ""STARFRUIT"": -1}",5297,5083,9996
838900,15249,-14355,"(STARFRUIT, MARKET << US, 5083, 1, 838900)
(STARFRUIT, MARKET << US, 5083, 1, 838900)
(STARFRUIT, MARKET << US, 5083, 1, 838900)","{""AMETHYSTS"": 4, ""STARFRUIT"": -4}",5301,5086,10000
839300,-39984,-54339,"(AMETHYSTS, US << MARKET, 9996, 1, 839300)
(AMETHYSTS, US << MARKET, 9996, 1, 839300)
(AMETHYSTS, US << MARKET, 9996, 1, 839300)
(AMETHYSTS, US << MARKET, 9996, 1, 839300)","{""AMETHYSTS"": 8, ""STARFRUIT"": -4}",5301,5086,9998
839700,-4913,-59252,"(AMETHYSTS, US << MARKET, 10002, 1, 839700)
(STARFRUIT, MARKET << US, 5089, 1, 839700)","{""AMETHYSTS"": 9, ""STARFRUIT"": -5}",5317,5088,10001
840000,-30178,-89430,"(AMETHYSTS, US << MARKET, 9998, 1, 840000)
(AMETHYSTS, US << MARKET, 9998, 1, 840000)
(STARFRUIT, US << MARKET, 5091, 1, 840000)
(STARFRUIT, US << MARKET, 5091, 1, 840000)","{""AMETHYSTS"": 11, ""STARFRUIT"": -3}",5265,5087,9996
840100,2,-89428,"(STARFRUIT, US << MARKET, 5084, 1, 840100)
(STARFRUIT, US << MARKET, 5084, 1, 840100)
(STARFRUIT, MARKET << US, 5085, 1, 840100)
(STARFRUIT, MARKET << US, 5085, 1, 840100)","{""AMETHYSTS"": 11, ""STARFRUIT"": -3}",5320,5084,10000
840600,5084,-84344,"(STARFRUIT, MARKET << US, 5084, 1, 840600)","{""AMETHYSTS"": 11, ""STARFRUIT"": -4}",5308,5087,10000
840700,85100,756,"(AMETHYSTS, MARKET << US, 10002, 1, 840700)
(AMETHYSTS, MARKET << US, 10002, 1, 840700)
(AMETHYSTS, MARKET << US, 10002, 1, 840700)
(AMETHYSTS, MARKET << US, 10002, 1, 840700)
(AMETHYSTS, MARKET << US, 10002, 1, 840700)
(AMETHYSTS, MARKET << US, 10002, 1, 840700)
(AMETHYSTS, MARKET << US, 10002, 1, 840700)
(AMETHYSTS, MARKET << US, 10002, 1, 840700)
(STARFRUIT, MARKET << US, 5084, 1, 840700)","{""AMETHYSTS"": 3, ""STARFRUIT"": -5}",5350,5083,10003
840800,-19996,-19240,"(AMETHYSTS, US << MARKET, 9998, 1, 840800)
(AMETHYSTS, US << MARKET, 9998, 1, 840800)","{""AMETHYSTS"": 5, ""STARFRUIT"": -5}",5320,5089,10001
841300,100020,80780,"(AMETHYSTS, MARKET << US, 10002, 1, 841300)
(AMETHYSTS, MARKET << US, 10002, 1, 841300)
(AMETHYSTS, MARKET << US, 10002, 1, 841300)
(AMETHYSTS, MARKET << US, 10002, 1, 841300)
(AMETHYSTS, MARKET << US, 10002, 1, 841300)
(AMETHYSTS, MARKET << US, 10002, 1, 841300)
(AMETHYSTS, MARKET << US, 10002, 1, 841300)
(AMETHYSTS, MARKET << US, 10002, 1, 841300)
(AMETHYSTS, MARKET << US, 10002, 1, 841300)
(AMETHYSTS, MARKET << US, 10002, 1, 841300)","{""AMETHYSTS"": -5, ""STARFRUIT"": -5}",5335,5086,10003
841400,5088,85868,"(STARFRUIT, MARKET << US, 5088, 1, 841400)","{""AMETHYSTS"": -5, ""STARFRUIT"": -6}",5340,5088,10000
841500,20008,105876,"(AMETHYSTS, MARKET << US, 10004, 1, 841500)
(AMETHYSTS, MARKET << US, 10004, 1, 841500)","{""AMETHYSTS"": -7, ""STARFRUIT"": -6}",5342,5089,10000
841800,-40720,65156,"(STARFRUIT, US << MARKET, 5090, 1, 841800)
(STARFRUIT, US << MARKET, 5090, 1, 841800)
(STARFRUIT, US << MARKET, 5090, 1, 841800)
(STARFRUIT, US << MARKET, 5090, 1, 841800)
(STARFRUIT, US << MARKET, 5090, 1, 841800)
(STARFRUIT, US << MARKET, 5090, 1, 841800)
(STARFRUIT, US << MARKET, 5090, 1, 841800)
(STARFRUIT, US << MARKET, 5090, 1, 841800)","{""AMETHYSTS"": -7, ""STARFRUIT"": 2}",5325,5088,10001
842000,20368,85524,"(STARFRUIT, MARKET << US, 5092, 1, 842000)
(STARFRUIT, MARKET << US, 5092, 1, 842000)
(STARFRUIT, MARKET << US, 5092, 1, 842000)
(STARFRUIT, MARKET << US, 5092, 1, 842000)","{""AMETHYSTS"": -7, ""STARFRUIT"": -2}",5348,5088,10000
842200,10170,95694,"(STARFRUIT, MARKET << US, 5085, 1, 842200)
(STARFRUIT, MARKET << US, 5085, 1, 842200)","{""AMETHYSTS"": -7, ""STARFRUIT"": -4}",5321,5088,10003
842300,-10180,85514,"(STARFRUIT, US << MARKET, 5090, 1, 842300)
(STARFRUIT, US << MARKET, 5090, 1, 842300)","{""AMETHYSTS"": -7, ""STARFRUIT"": -2}",5332,5091,10000
842500,-60348,25166,"(AMETHYSTS, US << MARKET, 10002, 1, 842500)
(AMETHYSTS, US << MARKET, 10002, 1, 842500)
(AMETHYSTS, US << MARKET, 10002, 1, 842500)
(AMETHYSTS, US << MARKET, 10002, 1, 842500)
(STARFRUIT, US << MARKET, 5086, 1, 842500)
(STARFRUIT, US << MARKET, 5086, 1, 842500)
(STARFRUIT, US << MARKET, 5086, 1, 842500)
(STARFRUIT, US << MARKET, 5086, 1, 842500)
(STARFRUIT, US << MARKET, 5086, 1, 842500)
(STARFRUIT, US << MARKET, 5086, 1, 842500)
(STARFRUIT, MARKET << US, 5088, 1, 842500)
(STARFRUIT, MARKET << US, 5088, 1, 842500)","{""AMETHYSTS"": -3, ""STARFRUIT"": 2}",5339,5085,9999
842600,5085,30251,"(STARFRUIT, MARKET << US, 5085, 1, 842600)","{""AMETHYSTS"": -3, ""STARFRUIT"": 1}",5338,5087,10000
842700,-10002,20249,"(AMETHYSTS, US << MARKET, 10002, 1, 842700)","{""AMETHYSTS"": -2, ""STARFRUIT"": 1}",5342,5087,9997
843000,-39992,-19743,"(AMETHYSTS, US << MARKET, 9998, 1, 843000)
(AMETHYSTS, US << MARKET, 9998, 1, 843000)
(AMETHYSTS, US << MARKET, 9998, 1, 843000)
(AMETHYSTS, US << MARKET, 9998, 1, 843000)","{""AMETHYSTS"": 2, ""STARFRUIT"": 1}",5337,5086,9997
843100,-50010,-69753,"(AMETHYSTS, US << MARKET, 10002, 1, 843100)
(AMETHYSTS, US << MARKET, 10002, 1, 843100)
(AMETHYSTS, US << MARKET, 10002, 1, 843100)
(AMETHYSTS, US << MARKET, 10002, 1, 843100)
(AMETHYSTS, US << MARKET, 10002, 1, 843100)","{""AMETHYSTS"": 7, ""STARFRUIT"": 1}",5355,5087,10003
843400,5083,-64670,"(STARFRUIT, MARKET << US, 5083, 1, 843400)","{""AMETHYSTS"": 7, ""STARFRUIT"": 0}",5309,5084,9997
843900,-25097,-89767,"(AMETHYSTS, US << MARKET, 10005, 1, 843900)
(AMETHYSTS, US << MARKET, 10005, 1, 843900)
(STARFRUIT, US << MARKET, 5087, 1, 843900)
(STARFRUIT, US << MARKET, 5087, 1, 843900)
(STARFRUIT, MARKET << US, 5087, 1, 843900)","{""AMETHYSTS"": 9, ""STARFRUIT"": 1}",5317,5084,10000
844000,-10002,-99769,"(AMETHYSTS, US << MARKET, 10002, 1, 844000)","{""AMETHYSTS"": 10, ""STARFRUIT"": 1}",5347,5086,10003
844200,-30010,-129779,"(AMETHYSTS, US << MARKET, 10002, 1, 844200)
(AMETHYSTS, US << MARKET, 10002, 1, 844200)
(AMETHYSTS, US << MARKET, 10002, 1, 844200)
(AMETHYSTS, US << MARKET, 10002, 1, 844200)
(AMETHYSTS, MARKET << US, 9998, 1, 844200)","{""AMETHYSTS"": 13, ""STARFRUIT"": 1}",5344,5084,10003
844400,-54902,-184681,"(AMETHYSTS, US << MARKET, 9998, 1, 844400)
(AMETHYSTS, US << MARKET, 9998, 1, 844400)
(AMETHYSTS, US << MARKET, 9998, 1, 844400)
(AMETHYSTS, US << MARKET, 9998, 1, 844400)
(AMETHYSTS, US << MARKET, 9998, 1, 844400)
(AMETHYSTS, US << MARKET, 9998, 1, 844400)
(STARFRUIT, MARKET << US, 5086, 1, 844400)","{""AMETHYSTS"": 19, ""STARFRUIT"": 0}",5338,5086,10001
845700,-20155,-204836,"(AMETHYSTS, US << MARKET, 9995, 1, 845700)
(STARFRUIT, US << MARKET, 5080, 1, 845700)
(STARFRUIT, US << MARKET, 5080, 1, 845700)","{""AMETHYSTS"": 20, ""STARFRUIT"": 2}",5330,5083,10000
846100,29994,-174842,"(AMETHYSTS, MARKET << US, 9998, 1, 846100)
(AMETHYSTS, MARKET << US, 9998, 1, 846100)
(AMETHYSTS, MARKET << US, 9998, 1, 846100)","{""AMETHYSTS"": 17, ""STARFRUIT"": 2}",5339,5082,10001
846300,89982,-84860,"(AMETHYSTS, MARKET << US, 9998, 1, 846300)
(AMETHYSTS, MARKET << US, 9998, 1, 846300)
(AMETHYSTS, MARKET << US, 9998, 1, 846300)
(AMETHYSTS, MARKET << US, 9998, 1, 846300)
(AMETHYSTS, MARKET << US, 9998, 1, 846300)
(AMETHYSTS, MARKET << US, 9998, 1, 846300)
(AMETHYSTS, MARKET << US, 9998, 1, 846300)
(AMETHYSTS, MARKET << US, 9998, 1, 846300)
(AMETHYSTS, MARKET << US, 9998, 1, 846300)","{""AMETHYSTS"": 8, ""STARFRUIT"": 2}",5318,5085,10001
846400,139907,55047,"(AMETHYSTS, MARKET << US, 10005, 1, 846400)
(AMETHYSTS, MARKET << US, 10005, 1, 846400)
(AMETHYSTS, MARKET << US, 10005, 1, 846400)
(AMETHYSTS, MARKET << US, 10005, 1, 846400)
(AMETHYSTS, MARKET << US, 10005, 1, 846400)
(AMETHYSTS, MARKET << US, 10005, 1, 846400)
(AMETHYSTS, MARKET << US, 10005, 1, 846400)
(AMETHYSTS, MARKET << US, 10005, 1, 846400)
(AMETHYSTS, MARKET << US, 10005, 1, 846400)
(AMETHYSTS, MARKET << US, 10005, 1, 846400)
(AMETHYSTS, MARKET << US, 10005, 1, 846400)
(AMETHYSTS, MARKET << US, 10005, 1, 846400)
(AMETHYSTS, MARKET << US, 10005, 1, 846400)
(AMETHYSTS, MARKET << US, 10005, 1, 846400)
(AMETHYSTS, MARKET << US, 9995, 1, 846400)
(STARFRUIT, US << MARKET, 5079, 1, 846400)
(STARFRUIT, US << MARKET, 5079, 1, 846400)","{""AMETHYSTS"": -7, ""STARFRUIT"": 4}",5375,5082,10000
846800,24765,79812,"(AMETHYSTS, MARKET << US, 10005, 1, 846800)
(AMETHYSTS, MARKET << US, 10005, 1, 846800)
(AMETHYSTS, MARKET << US, 10005, 1, 846800)
(AMETHYSTS, MARKET << US, 10005, 1, 846800)
(STARFRUIT, US << MARKET, 5085, 1, 846800)
(STARFRUIT, US << MARKET, 5085, 1, 846800)
(STARFRUIT, US << MARKET, 5085, 1, 846800)","{""AMETHYSTS"": -11, ""STARFRUIT"": 7}",5346,5081,10003
846900,25093,104905,"(AMETHYSTS, MARKET << US, 10004, 1, 846900)
(AMETHYSTS, MARKET << US, 10004, 1, 846900)
(STARFRUIT, MARKET << US, 5085, 1, 846900)","{""AMETHYSTS"": -13, ""STARFRUIT"": 6}",5384,5082,10001
847000,20004,124909,"(AMETHYSTS, MARKET << US, 10002, 1, 847000)
(AMETHYSTS, MARKET << US, 10002, 1, 847000)","{""AMETHYSTS"": -15, ""STARFRUIT"": 6}",5425,5081,9998
848100,29842,154751,"(AMETHYSTS, MARKET << US, 10004, 1, 848100)
(AMETHYSTS, MARKET << US, 10004, 1, 848100)
(AMETHYSTS, MARKET << US, 10004, 1, 848100)
(AMETHYSTS, MARKET << US, 10004, 1, 848100)
(STARFRUIT, US << MARKET, 5087, 1, 848100)
(STARFRUIT, US << MARKET, 5087, 1, 848100)","{""AMETHYSTS"": -19, ""STARFRUIT"": 8}",5415,5083,10000
848600,10166,164917,"(STARFRUIT, MARKET << US, 5083, 1, 848600)
(STARFRUIT, MARKET << US, 5083, 1, 848600)","{""AMETHYSTS"": -19, ""STARFRUIT"": 6}",5447,5082,9998
849000,-19996,144921,"(AMETHYSTS, US << MARKET, 9998, 1, 849000)
(AMETHYSTS, US << MARKET, 9998, 1, 849000)","{""AMETHYSTS"": -17, ""STARFRUIT"": 6}",5481,5082,9996
849100,5399,150320,"(AMETHYSTS, US << MARKET, 9998, 1, 849100)
(AMETHYSTS, US << MARKET, 9998, 1, 849100)
(STARFRUIT, MARKET << US, 5079, 1, 849100)
(STARFRUIT, MARKET << US, 5079, 1, 849100)
(STARFRUIT, MARKET << US, 5079, 1, 849100)
(STARFRUIT, MARKET << US, 5079, 1, 849100)
(STARFRUIT, MARKET << US, 5079, 1, 849100)","{""AMETHYSTS"": -15, ""STARFRUIT"": 1}",5462,5082,9996
849400,40008,190328,"(AMETHYSTS, MARKET << US, 10002, 1, 849400)
(AMETHYSTS, MARKET << US, 10002, 1, 849400)
(AMETHYSTS, MARKET << US, 10002, 1, 849400)
(AMETHYSTS, MARKET << US, 10002, 1, 849400)","{""AMETHYSTS"": -19, ""STARFRUIT"": 1}",5352,5081,10003
849600,5078,195406,"(STARFRUIT, MARKET << US, 5078, 1, 849600)","{""AMETHYSTS"": -19, ""STARFRUIT"": 0}",5349,5080,10003
849700,9998,205404,"(AMETHYSTS, MARKET << US, 9998, 1, 849700)","{""AMETHYSTS"": -20, ""STARFRUIT"": 0}",5384,5081,10001
849900,-19996,185408,"(AMETHYSTS, US << MARKET, 9998, 1, 849900)
(AMETHYSTS, US << MARKET, 9998, 1, 849900)","{""AMETHYSTS"": -18, ""STARFRUIT"": 0}",5480,5080,9996
850500,-15240,170168,"(STARFRUIT, US << MARKET, 5080, 1, 850500)
(STARFRUIT, US << MARKET, 5080, 1, 850500)
(STARFRUIT, US << MARKET, 5080, 1, 850500)
(STARFRUIT, US << MARKET, 5080, 1, 850500)
(STARFRUIT, US << MARKET, 5080, 1, 850500)
(STARFRUIT, US << MARKET, 5080, 1, 850500)
(STARFRUIT, MARKET << US, 5080, 1, 850500)
(STARFRUIT, MARKET << US, 5080, 1, 850500)
(STARFRUIT, MARKET << US, 5080, 1, 850500)","{""AMETHYSTS"": -18, ""STARFRUIT"": 3}",5411,5081,10000
850700,5080,175248,"(STARFRUIT, MARKET << US, 5080, 1, 850700)","{""AMETHYSTS"": -18, ""STARFRUIT"": 2}",5410,5081,10000
850800,9844,185092,"(AMETHYSTS, MARKET << US, 10002, 1, 850800)
(AMETHYSTS, MARKET << US, 10002, 1, 850800)
(STARFRUIT, US << MARKET, 5080, 1, 850800)
(STARFRUIT, US << MARKET, 5080, 1, 850800)","{""AMETHYSTS"": -20, ""STARFRUIT"": 4}",5356,5081,10003
851000,5074,190166,"(STARFRUIT, MARKET << US, 5074, 1, 851000)","{""AMETHYSTS"": -20, ""STARFRUIT"": 3}",5397,5077,10000
851100,-100040,90126,"(AMETHYSTS, US << MARKET, 10004, 1, 851100)
(AMETHYSTS, US << MARKET, 10004, 1, 851100)
(AMETHYSTS, US << MARKET, 10004, 1, 851100)
(AMETHYSTS, US << MARKET, 10004, 1, 851100)
(AMETHYSTS, US << MARKET, 10004, 1, 851100)
(AMETHYSTS, US << MARKET, 10004, 1, 851100)
(AMETHYSTS, US << MARKET, 10004, 1, 851100)
(AMETHYSTS, US << MARKET, 10004, 1, 851100)
(AMETHYSTS, US << MARKET, 10004, 1, 851100)
(AMETHYSTS, US << MARKET, 10004, 1, 851100)","{""AMETHYSTS"": -10, ""STARFRUIT"": 3}",5360,5078,10000
851400,5079,95205,"(STARFRUIT, MARKET << US, 5079, 1, 851400)","{""AMETHYSTS"": -10, ""STARFRUIT"": 2}",5349,5077,10001
851800,9848,105053,"(AMETHYSTS, MARKET << US, 10004, 1, 851800)
(AMETHYSTS, MARKET << US, 10004, 1, 851800)
(STARFRUIT, US << MARKET, 5080, 1, 851800)
(STARFRUIT, US << MARKET, 5080, 1, 851800)","{""AMETHYSTS"": -12, ""STARFRUIT"": 4}",5345,5076,10001
852200,20004,125057,"(AMETHYSTS, MARKET << US, 10002, 1, 852200)
(AMETHYSTS, MARKET << US, 10002, 1, 852200)","{""AMETHYSTS"": -14, ""STARFRUIT"": 4}",5385,5075,9998
853000,-40292,84765,"(AMETHYSTS, US << MARKET, 10002, 1, 853000)
(AMETHYSTS, US << MARKET, 10002, 1, 853000)
(STARFRUIT, US << MARKET, 5072, 1, 853000)
(STARFRUIT, US << MARKET, 5072, 1, 853000)
(STARFRUIT, US << MARKET, 5072, 1, 853000)
(STARFRUIT, US << MARKET, 5072, 1, 853000)","{""AMETHYSTS"": -12, ""STARFRUIT"": 8}",5329,5075,10003
853600,-15079,69686,"(AMETHYSTS, US << MARKET, 10005, 1, 853600)
(STARFRUIT, US << MARKET, 5074, 1, 853600)","{""AMETHYSTS"": -11, ""STARFRUIT"": 9}",5343,5073,10000
853700,9998,79684,"(AMETHYSTS, MARKET << US, 9998, 1, 853700)","{""AMETHYSTS"": -12, ""STARFRUIT"": 9}",5362,5078,10002
854300,-20292,59392,"(STARFRUIT, US << MARKET, 5073, 1, 854300)
(STARFRUIT, US << MARKET, 5073, 1, 854300)
(STARFRUIT, US << MARKET, 5073, 1, 854300)
(STARFRUIT, US << MARKET, 5073, 1, 854300)","{""AMETHYSTS"": -12, ""STARFRUIT"": 13}",5380,5076,10000
854500,-20292,39100,"(STARFRUIT, US << MARKET, 5073, 1, 854500)
(STARFRUIT, US << MARKET, 5073, 1, 854500)
(STARFRUIT, US << MARKET, 5073, 1, 854500)
(STARFRUIT, US << MARKET, 5073, 1, 854500)","{""AMETHYSTS"": -12, ""STARFRUIT"": 17}",5348,5072,9998
854800,20308,59408,"(STARFRUIT, MARKET << US, 5077, 1, 854800)
(STARFRUIT, MARKET << US, 5077, 1, 854800)
(STARFRUIT, MARKET << US, 5077, 1, 854800)
(STARFRUIT, MARKET << US, 5077, 1, 854800)","{""AMETHYSTS"": -12, ""STARFRUIT"": 13}",5395,5075,9999
855300,0,59408,"(STARFRUIT, US << MARKET, 5075, 1, 855300)
(STARFRUIT, US << MARKET, 5075, 1, 855300)
(STARFRUIT, US << MARKET, 5075, 1, 855300)
(STARFRUIT, US << MARKET, 5075, 1, 855300)
(STARFRUIT, MARKET << US, 5075, 1, 855300)
(STARFRUIT, MARKET << US, 5075, 1, 855300)
(STARFRUIT, MARKET << US, 5075, 1, 855300)
(STARFRUIT, MARKET << US, 5075, 1, 855300)","{""AMETHYSTS"": -12, ""STARFRUIT"": 13}",5358,5074,10001
855500,-5074,54334,"(STARFRUIT, US << MARKET, 5074, 1, 855500)","{""AMETHYSTS"": -12, ""STARFRUIT"": 14}",5412,5077,10000
855700,60012,114346,"(AMETHYSTS, MARKET << US, 10002, 1, 855700)
(AMETHYSTS, MARKET << US, 10002, 1, 855700)
(AMETHYSTS, MARKET << US, 10002, 1, 855700)
(AMETHYSTS, MARKET << US, 10002, 1, 855700)
(AMETHYSTS, MARKET << US, 10002, 1, 855700)
(AMETHYSTS, MARKET << US, 10002, 1, 855700)","{""AMETHYSTS"": -18, ""STARFRUIT"": 14}",5370,5077,10003
856100,-20300,94046,"(STARFRUIT, US << MARKET, 5075, 1, 856100)
(STARFRUIT, US << MARKET, 5075, 1, 856100)
(STARFRUIT, US << MARKET, 5075, 1, 856100)
(STARFRUIT, US << MARKET, 5075, 1, 856100)","{""AMETHYSTS"": -18, ""STARFRUIT"": 18}",5378,5073,9999
856300,-10002,84044,"(AMETHYSTS, US << MARKET, 10002, 1, 856300)","{""AMETHYSTS"": -17, ""STARFRUIT"": 18}",5343,5075,10003
856400,5071,89115,"(STARFRUIT, MARKET << US, 5071, 1, 856400)","{""AMETHYSTS"": -17, ""STARFRUIT"": 17}",5373,5076,10002
856500,-5071,84044,"(STARFRUIT, US << MARKET, 5071, 1, 856500)","{""AMETHYSTS"": -17, ""STARFRUIT"": 18}",5392,5073,9998
856600,60427,144471,"(AMETHYSTS, MARKET << US, 10005, 1, 856600)
(AMETHYSTS, MARKET << US, 10005, 1, 856600)
(AMETHYSTS, MARKET << US, 10005, 1, 856600)
(STARFRUIT, US << MARKET, 5078, 1, 856600)
(STARFRUIT, US << MARKET, 5078, 1, 856600)
(STARFRUIT, MARKET << US, 5071, 1, 856600)
(STARFRUIT, MARKET << US, 5071, 1, 856600)
(STARFRUIT, MARKET << US, 5071, 1, 856600)
(STARFRUIT, MARKET << US, 5071, 1, 856600)
(STARFRUIT, MARKET << US, 5071, 1, 856600)
(STARFRUIT, MARKET << US, 5071, 1, 856600)
(STARFRUIT, MARKET << US, 5071, 1, 856600)
(STARFRUIT, MARKET << US, 5071, 1, 856600)","{""AMETHYSTS"": -20, ""STARFRUIT"": 12}",5359,5074,10000
856800,-20316,124155,"(STARFRUIT, US << MARKET, 5079, 1, 856800)
(STARFRUIT, US << MARKET, 5079, 1, 856800)
(STARFRUIT, US << MARKET, 5079, 1, 856800)
(STARFRUIT, US << MARKET, 5079, 1, 856800)","{""AMETHYSTS"": -20, ""STARFRUIT"": 16}",5371,5076,10000
856900,20308,144463,"(STARFRUIT, MARKET << US, 5077, 1, 856900)
(STARFRUIT, MARKET << US, 5077, 1, 856900)
(STARFRUIT, MARKET << US, 5077, 1, 856900)
(STARFRUIT, MARKET << US, 5077, 1, 856900)","{""AMETHYSTS"": -20, ""STARFRUIT"": 12}",5331,5074,10001
857400,-5078,139385,"(STARFRUIT, US << MARKET, 5078, 1, 857400)","{""AMETHYSTS"": -20, ""STARFRUIT"": 13}",5360,5075,10000
857800,15228,154613,"(STARFRUIT, MARKET << US, 5076, 1, 857800)
(STARFRUIT, MARKET << US, 5076, 1, 857800)
(STARFRUIT, MARKET << US, 5076, 1, 857800)","{""AMETHYSTS"": -20, ""STARFRUIT"": 10}",5393,5074,9998
858000,20312,174925,"(STARFRUIT, MARKET << US, 5078, 1, 858000)
(STARFRUIT, MARKET << US, 5078, 1, 858000)
(STARFRUIT, MARKET << US, 5078, 1, 858000)
(STARFRUIT, MARKET << US, 5078, 1, 858000)","{""AMETHYSTS"": -20, ""STARFRUIT"": 6}",5399,5079,10000
858200,10150,185075,"(STARFRUIT, US << MARKET, 5075, 1, 858200)
(STARFRUIT, US << MARKET, 5075, 1, 858200)
(STARFRUIT, US << MARKET, 5075, 1, 858200)
(STARFRUIT, MARKET << US, 5075, 1, 858200)
(STARFRUIT, MARKET << US, 5075, 1, 858200)
(STARFRUIT, MARKET << US, 5075, 1, 858200)
(STARFRUIT, MARKET << US, 5075, 1, 858200)
(STARFRUIT, MARKET << US, 5075, 1, 858200)","{""AMETHYSTS"": -20, ""STARFRUIT"": 4}",5403,5077,9999
858400,35525,220600,"(STARFRUIT, MARKET << US, 5075, 1, 858400)
(STARFRUIT, MARKET << US, 5075, 1, 858400)
(STARFRUIT, MARKET << US, 5075, 1, 858400)
(STARFRUIT, MARKET << US, 5075, 1, 858400)
(STARFRUIT, MARKET << US, 5075, 1, 858400)
(STARFRUIT, MARKET << US, 5075, 1, 858400)
(STARFRUIT, MARKET << US, 5075, 1, 858400)","{""AMETHYSTS"": -20, ""STARFRUIT"": -3}",5458,5074,9996
858500,0,220600,,"{""AMETHYSTS"": -20, ""STARFRUIT"": -3}",5446,5078,9996
858900,5074,225674,"(STARFRUIT, MARKET << US, 5074, 1, 858900)","{""AMETHYSTS"": -20, ""STARFRUIT"": -4}",5382,5073,10000
859000,-35560,190114,"(STARFRUIT, US << MARKET, 5080, 1, 859000)
(STARFRUIT, US << MARKET, 5080, 1, 859000)
(STARFRUIT, US << MARKET, 5080, 1, 859000)
(STARFRUIT, US << MARKET, 5080, 1, 859000)
(STARFRUIT, US << MARKET, 5080, 1, 859000)
(STARFRUIT, US << MARKET, 5080, 1, 859000)
(STARFRUIT, US << MARKET, 5080, 1, 859000)","{""AMETHYSTS"": -20, ""STARFRUIT"": 3}",5342,5076,10000
859500,-10148,179966,"(STARFRUIT, US << MARKET, 5074, 1, 859500)
(STARFRUIT, US << MARKET, 5074, 1, 859500)","{""AMETHYSTS"": -20, ""STARFRUIT"": 5}",5291,5077,10003
859600,5074,185040,"(STARFRUIT, MARKET << US, 5074, 1, 859600)","{""AMETHYSTS"": -20, ""STARFRUIT"": 4}",5288,5077,10003
859800,-30150,154890,"(AMETHYSTS, US << MARKET, 9996, 1, 859800)
(AMETHYSTS, US << MARKET, 9996, 1, 859800)
(STARFRUIT, US << MARKET, 5079, 1, 859800)
(STARFRUIT, US << MARKET, 5079, 1, 859800)","{""AMETHYSTS"": -18, ""STARFRUIT"": 6}",5364,5079,10000
860300,-19996,134894,"(AMETHYSTS, US << MARKET, 9998, 1, 860300)
(AMETHYSTS, US << MARKET, 9998, 1, 860300)","{""AMETHYSTS"": -16, ""STARFRUIT"": 6}",5330,5078,10002
860600,9998,144892,"(AMETHYSTS, MARKET << US, 9998, 1, 860600)","{""AMETHYSTS"": -17, ""STARFRUIT"": 6}",5337,5077,10001
861100,0,144892,"(AMETHYSTS, US << MARKET, 9998, 1, 861100)
(AMETHYSTS, US << MARKET, 9998, 1, 861100)
(AMETHYSTS, MARKET << US, 9998, 1, 861100)
(AMETHYSTS, MARKET << US, 9998, 1, 861100)","{""AMETHYSTS"": -17, ""STARFRUIT"": 6}",5405,5077,9997
861300,25365,170257,"(STARFRUIT, MARKET << US, 5073, 1, 861300)
(STARFRUIT, MARKET << US, 5073, 1, 861300)
(STARFRUIT, MARKET << US, 5073, 1, 861300)
(STARFRUIT, MARKET << US, 5073, 1, 861300)
(STARFRUIT, MARKET << US, 5073, 1, 861300)","{""AMETHYSTS"": -17, ""STARFRUIT"": 1}",5333,5076,10000
861600,-40326,129931,"(AMETHYSTS, US << MARKET, 10005, 1, 861600)
(AMETHYSTS, US << MARKET, 10005, 1, 861600)
(STARFRUIT, US << MARKET, 5079, 1, 861600)
(STARFRUIT, US << MARKET, 5079, 1, 861600)
(STARFRUIT, US << MARKET, 5079, 1, 861600)
(STARFRUIT, US << MARKET, 5079, 1, 861600)","{""AMETHYSTS"": -15, ""STARFRUIT"": 5}",5311,5076,10000
862300,39980,169911,"(AMETHYSTS, MARKET << US, 9995, 1, 862300)
(AMETHYSTS, MARKET << US, 9995, 1, 862300)
(AMETHYSTS, MARKET << US, 9995, 1, 862300)
(AMETHYSTS, MARKET << US, 9995, 1, 862300)","{""AMETHYSTS"": -19, ""STARFRUIT"": 5}",5334,5077,9998
862400,-19996,149915,"(AMETHYSTS, US << MARKET, 9998, 1, 862400)
(AMETHYSTS, US << MARKET, 9998, 1, 862400)","{""AMETHYSTS"": -17, ""STARFRUIT"": 5}",5358,5075,9996
862900,-10154,139761,"(STARFRUIT, US << MARKET, 5077, 1, 862900)
(STARFRUIT, US << MARKET, 5077, 1, 862900)","{""AMETHYSTS"": -17, ""STARFRUIT"": 7}",5307,5078,10000
864300,-5076,134685,"(STARFRUIT, US << MARKET, 5076, 1, 864300)","{""AMETHYSTS"": -17, ""STARFRUIT"": 8}",5293,5076,10000
864500,-5076,129609,"(STARFRUIT, US << MARKET, 5076, 1, 864500)","{""AMETHYSTS"": -17, ""STARFRUIT"": 9}",5257,5072,10000
864600,14933,144542,"(AMETHYSTS, MARKET << US, 10002, 1, 864600)
(AMETHYSTS, MARKET << US, 10002, 1, 864600)
(STARFRUIT, US << MARKET, 5071, 1, 864600)","{""AMETHYSTS"": -19, ""STARFRUIT"": 10}",5215,5073,10003
864800,-10150,134392,"(STARFRUIT, US << MARKET, 5075, 1, 864800)
(STARFRUIT, US << MARKET, 5075, 1, 864800)","{""AMETHYSTS"": -19, ""STARFRUIT"": 12}",5256,5072,10000
864900,4927,139319,"(AMETHYSTS, MARKET << US, 9998, 1, 864900)
(STARFRUIT, US << MARKET, 5071, 1, 864900)","{""AMETHYSTS"": -20, ""STARFRUIT"": 13}",5309,5070,9996
865100,15214,154533,"(STARFRUIT, US << MARKET, 5070, 1, 865100)
(STARFRUIT, MARKET << US, 5071, 1, 865100)
(STARFRUIT, MARKET << US, 5071, 1, 865100)
(STARFRUIT, MARKET << US, 5071, 1, 865100)
(STARFRUIT, MARKET << US, 5071, 1, 865100)","{""AMETHYSTS"": -20, ""STARFRUIT"": 10}",5253,5074,10001
865200,0,154533,,"{""AMETHYSTS"": -20, ""STARFRUIT"": 10}",5243,5073,10001
865400,5070,159603,"(STARFRUIT, MARKET << US, 5070, 1, 865400)","{""AMETHYSTS"": -20, ""STARFRUIT"": 9}",5260,5073,10000
865500,-5074,154529,"(STARFRUIT, US << MARKET, 5074, 1, 865500)
(STARFRUIT, US << MARKET, 5074, 1, 865500)
(STARFRUIT, US << MARKET, 5074, 1, 865500)
(STARFRUIT, US << MARKET, 5074, 1, 865500)
(STARFRUIT, MARKET << US, 5074, 1, 865500)
(STARFRUIT, MARKET << US, 5074, 1, 865500)
(STARFRUIT, MARKET << US, 5074, 1, 865500)","{""AMETHYSTS"": -20, ""STARFRUIT"": 10}",5219,5071,10001
865800,-20304,134225,"(STARFRUIT, US << MARKET, 5076, 1, 865800)
(STARFRUIT, US << MARKET, 5076, 1, 865800)
(STARFRUIT, US << MARKET, 5076, 1, 865800)
(STARFRUIT, US << MARKET, 5076, 1, 865800)","{""AMETHYSTS"": -20, ""STARFRUIT"": 14}",5201,5074,10003
865900,0,134225,,"{""AMETHYSTS"": -20, ""STARFRUIT"": 14}",5287,5073,9998
867100,20284,154509,"(STARFRUIT, MARKET << US, 5071, 1, 867100)
(STARFRUIT, MARKET << US, 5071, 1, 867100)
(STARFRUIT, MARKET << US, 5071, 1, 867100)
(STARFRUIT, MARKET << US, 5071, 1, 867100)","{""AMETHYSTS"": -20, ""STARFRUIT"": 10}",5239,5069,9998
867400,-19996,134513,"(AMETHYSTS, US << MARKET, 9998, 1, 867400)
(AMETHYSTS, US << MARKET, 9998, 1, 867400)","{""AMETHYSTS"": -18, ""STARFRUIT"": 10}",5215,5072,10001
867700,-20308,114205,"(STARFRUIT, US << MARKET, 5077, 1, 867700)
(STARFRUIT, US << MARKET, 5077, 1, 867700)
(STARFRUIT, US << MARKET, 5077, 1, 867700)
(STARFRUIT, US << MARKET, 5077, 1, 867700)","{""AMETHYSTS"": -18, ""STARFRUIT"": 14}",5241,5074,10000
867800,14933,129138,"(AMETHYSTS, MARKET << US, 10002, 1, 867800)
(AMETHYSTS, MARKET << US, 10002, 1, 867800)
(STARFRUIT, US << MARKET, 5071, 1, 867800)","{""AMETHYSTS"": -20, ""STARFRUIT"": 15}",5128,5070,10003
867900,10142,139280,"(STARFRUIT, MARKET << US, 5071, 1, 867900)
(STARFRUIT, MARKET << US, 5071, 1, 867900)","{""AMETHYSTS"": -20, ""STARFRUIT"": 13}",5230,5070,9998
868000,-5077,134203,"(STARFRUIT, US << MARKET, 5077, 1, 868000)","{""AMETHYSTS"": -20, ""STARFRUIT"": 14}",5205,5073,10001
868700,-20288,113915,"(STARFRUIT, US << MARKET, 5072, 1, 868700)
(STARFRUIT, US << MARKET, 5072, 1, 868700)
(STARFRUIT, US << MARKET, 5072, 1, 868700)
(STARFRUIT, US << MARKET, 5072, 1, 868700)","{""AMETHYSTS"": -20, ""STARFRUIT"": 18}",5193,5071,10000
868800,5076,118991,"(STARFRUIT, MARKET << US, 5076, 1, 868800)","{""AMETHYSTS"": -20, ""STARFRUIT"": 17}",5303,5076,9999
869000,-5076,113915,"(STARFRUIT, US << MARKET, 5076, 1, 869000)","{""AMETHYSTS"": -20, ""STARFRUIT"": 18}",5301,5077,10000
869200,5070,118985,"(STARFRUIT, MARKET << US, 5070, 1, 869200)","{""AMETHYSTS"": -20, ""STARFRUIT"": 17}",5226,5073,10000
869500,-10004,108981,"(AMETHYSTS, US << MARKET, 10004, 1, 869500)","{""AMETHYSTS"": -19, ""STARFRUIT"": 17}",5218,5075,10002
870000,5070,114051,"(STARFRUIT, MARKET << US, 5070, 1, 870000)","{""AMETHYSTS"": -19, ""STARFRUIT"": 16}",5219,5073,10000
870200,-159920,-45869,"(AMETHYSTS, US << MARKET, 9995, 1, 870200)
(AMETHYSTS, US << MARKET, 9995, 1, 870200)
(AMETHYSTS, US << MARKET, 9995, 1, 870200)
(AMETHYSTS, US << MARKET, 9995, 1, 870200)
(AMETHYSTS, US << MARKET, 9995, 1, 870200)
(AMETHYSTS, US << MARKET, 9995, 1, 870200)
(AMETHYSTS, US << MARKET, 9995, 1, 870200)
(AMETHYSTS, US << MARKET, 9995, 1, 870200)
(AMETHYSTS, US << MARKET, 9995, 1, 870200)
(AMETHYSTS, US << MARKET, 9995, 1, 870200)
(AMETHYSTS, US << MARKET, 9995, 1, 870200)
(AMETHYSTS, US << MARKET, 9995, 1, 870200)
(AMETHYSTS, US << MARKET, 9995, 1, 870200)
(AMETHYSTS, US << MARKET, 9995, 1, 870200)
(AMETHYSTS, US << MARKET, 9995, 1, 870200)
(AMETHYSTS, US << MARKET, 9995, 1, 870200)","{""AMETHYSTS"": -3, ""STARFRUIT"": 16}",5283,5072,10000
870500,-19996,-65865,"(AMETHYSTS, US << MARKET, 9998, 1, 870500)
(AMETHYSTS, US << MARKET, 9998, 1, 870500)","{""AMETHYSTS"": -1, ""STARFRUIT"": 16}",5307,5073,9996
870900,14936,-50929,"(AMETHYSTS, MARKET << US, 10005, 1, 870900)
(AMETHYSTS, MARKET << US, 10005, 1, 870900)
(STARFRUIT, US << MARKET, 5074, 1, 870900)","{""AMETHYSTS"": -3, ""STARFRUIT"": 17}",5278,5071,10000
871000,9998,-40931,"(AMETHYSTS, MARKET << US, 9998, 1, 871000)","{""AMETHYSTS"": -4, ""STARFRUIT"": 17}",5254,5069,9997
871700,-14921,-55852,"(AMETHYSTS, US << MARKET, 9996, 1, 871700)
(AMETHYSTS, US << MARKET, 9996, 1, 871700)
(STARFRUIT, MARKET << US, 5071, 1, 871700)","{""AMETHYSTS"": -2, ""STARFRUIT"": 16}",5334,5074,9999
872000,-20280,-76132,"(STARFRUIT, US << MARKET, 5070, 1, 872000)
(STARFRUIT, US << MARKET, 5070, 1, 872000)
(STARFRUIT, US << MARKET, 5070, 1, 872000)
(STARFRUIT, US << MARKET, 5070, 1, 872000)","{""AMETHYSTS"": -2, ""STARFRUIT"": 20}",5326,5073,10001
872200,0,-76132,,"{""AMETHYSTS"": -2, ""STARFRUIT"": 20}",5308,5072,10000
872500,5070,-71062,"(STARFRUIT, MARKET << US, 5070, 1, 872500)","{""AMETHYSTS"": -2, ""STARFRUIT"": 19}",5323,5073,10001
872600,-5071,-76133,"(STARFRUIT, US << MARKET, 5071, 1, 872600)","{""AMETHYSTS"": -2, ""STARFRUIT"": 20}",5329,5073,9999
872900,0,-76133,,"{""AMETHYSTS"": -2, ""STARFRUIT"": 20}",5365,5075,10001
873400,55057,-21076,"(AMETHYSTS, MARKET << US, 9998, 1, 873400)
(AMETHYSTS, MARKET << US, 9998, 1, 873400)
(AMETHYSTS, MARKET << US, 9998, 1, 873400)
(AMETHYSTS, MARKET << US, 9998, 1, 873400)
(AMETHYSTS, MARKET << US, 9998, 1, 873400)
(STARFRUIT, MARKET << US, 5067, 1, 873400)","{""AMETHYSTS"": -7, ""STARFRUIT"": 19}",5199,5066,9997
873500,100020,78944,"(AMETHYSTS, MARKET << US, 10002, 1, 873500)
(AMETHYSTS, MARKET << US, 10002, 1, 873500)
(AMETHYSTS, MARKET << US, 10002, 1, 873500)
(AMETHYSTS, MARKET << US, 10002, 1, 873500)
(AMETHYSTS, MARKET << US, 10002, 1, 873500)
(AMETHYSTS, MARKET << US, 10002, 1, 873500)
(AMETHYSTS, MARKET << US, 10002, 1, 873500)
(AMETHYSTS, MARKET << US, 10002, 1, 873500)
(AMETHYSTS, MARKET << US, 10002, 1, 873500)
(AMETHYSTS, MARKET << US, 10002, 1, 873500)
(STARFRUIT, US << MARKET, 5067, 1, 873500)
(STARFRUIT, MARKET << US, 5067, 1, 873500)","{""AMETHYSTS"": -17, ""STARFRUIT"": 19}",5223,5070,10003
873700,35462,114406,"(STARFRUIT, MARKET << US, 5066, 1, 873700)
(STARFRUIT, MARKET << US, 5066, 1, 873700)
(STARFRUIT, MARKET << US, 5066, 1, 873700)
(STARFRUIT, MARKET << US, 5066, 1, 873700)
(STARFRUIT, MARKET << US, 5066, 1, 873700)
(STARFRUIT, MARKET << US, 5066, 1, 873700)
(STARFRUIT, MARKET << US, 5066, 1, 873700)","{""AMETHYSTS"": -17, ""STARFRUIT"": 12}",5229,5070,10001
873800,9998,124404,"(AMETHYSTS, MARKET << US, 9998, 1, 873800)","{""AMETHYSTS"": -18, ""STARFRUIT"": 12}",5298,5070,9997
874300,20004,144408,"(AMETHYSTS, MARKET << US, 10002, 1, 874300)
(AMETHYSTS, MARKET << US, 10002, 1, 874300)","{""AMETHYSTS"": -20, ""STARFRUIT"": 12}",5280,5071,9999
874400,-4791,139617,"(AMETHYSTS, US << MARKET, 10002, 1, 874400)
(AMETHYSTS, US << MARKET, 10002, 1, 874400)
(STARFRUIT, MARKET << US, 5071, 1, 874400)
(STARFRUIT, MARKET << US, 5071, 1, 874400)
(STARFRUIT, MARKET << US, 5071, 1, 874400)","{""AMETHYSTS"": -18, ""STARFRUIT"": 9}",5283,5072,9999
874500,-40016,99601,"(AMETHYSTS, US << MARKET, 10004, 1, 874500)
(AMETHYSTS, US << MARKET, 10004, 1, 874500)
(AMETHYSTS, US << MARKET, 10004, 1, 874500)
(AMETHYSTS, US << MARKET, 10004, 1, 874500)
(AMETHYSTS, US << MARKET, 10004, 1, 874500)
(AMETHYSTS, US << MARKET, 10004, 1, 874500)
(AMETHYSTS, MARKET << US, 10004, 1, 874500)
(AMETHYSTS, MARKET << US, 10004, 1, 874500)","{""AMETHYSTS"": -14, ""STARFRUIT"": 9}",5217,5070,10001
874600,10136,109737,"(STARFRUIT, MARKET << US, 5068, 1, 874600)
(STARFRUIT, MARKET << US, 5068, 1, 874600)","{""AMETHYSTS"": -14, ""STARFRUIT"": 7}",5206,5067,10000
874800,20004,129741,"(AMETHYSTS, MARKET << US, 10002, 1, 874800)
(AMETHYSTS, MARKET << US, 10002, 1, 874800)","{""AMETHYSTS"": -16, ""STARFRUIT"": 7}",5233,5068,9999
874900,-5068,124673,"(STARFRUIT, US << MARKET, 5068, 1, 874900)","{""AMETHYSTS"": -16, ""STARFRUIT"": 8}",5241,5071,10000
875000,-20300,104373,"(STARFRUIT, US << MARKET, 5075, 1, 875000)
(STARFRUIT, US << MARKET, 5075, 1, 875000)
(STARFRUIT, US << MARKET, 5075, 1, 875000)
(STARFRUIT, US << MARKET, 5075, 1, 875000)","{""AMETHYSTS"": -16, ""STARFRUIT"": 12}",5189,5072,10003
875600,20004,124377,"(AMETHYSTS, MARKET << US, 10002, 1, 875600)
(AMETHYSTS, MARKET << US, 10002, 1, 875600)","{""AMETHYSTS"": -18, ""STARFRUIT"": 12}",5271,5073,9999
875700,-5069,119308,"(STARFRUIT, US << MARKET, 5069, 1, 875700)","{""AMETHYSTS"": -18, ""STARFRUIT"": 13}",5285,5071,9997
875800,15472,134780,"(AMETHYSTS, US << MARKET, 10002, 1, 875800)
(AMETHYSTS, US << MARKET, 10002, 1, 875800)
(STARFRUIT, MARKET << US, 5068, 1, 875800)
(STARFRUIT, MARKET << US, 5068, 1, 875800)
(STARFRUIT, MARKET << US, 5068, 1, 875800)
(STARFRUIT, MARKET << US, 5068, 1, 875800)
(STARFRUIT, MARKET << US, 5068, 1, 875800)
(STARFRUIT, MARKET << US, 5068, 1, 875800)
(STARFRUIT, MARKET << US, 5068, 1, 875800)","{""AMETHYSTS"": -16, ""STARFRUIT"": 6}",5220,5068,9998
875900,-10138,124642,"(STARFRUIT, US << MARKET, 5069, 1, 875900)
(STARFRUIT, US << MARKET, 5069, 1, 875900)","{""AMETHYSTS"": -16, ""STARFRUIT"": 8}",5234,5072,9999
876000,40016,164658,"(AMETHYSTS, MARKET << US, 10004, 1, 876000)
(AMETHYSTS, MARKET << US, 10004, 1, 876000)
(AMETHYSTS, MARKET << US, 10004, 1, 876000)
(AMETHYSTS, MARKET << US, 10004, 1, 876000)","{""AMETHYSTS"": -20, ""STARFRUIT"": 8}",5202,5073,10002
876600,5067,169725,"(STARFRUIT, MARKET << US, 5067, 1, 876600)","{""AMETHYSTS"": -20, ""STARFRUIT"": 7}",5188,5069,10001
876700,272,169997,"(AMETHYSTS, US << MARKET, 9996, 1, 876700)
(AMETHYSTS, US << MARKET, 9996, 1, 876700)
(STARFRUIT, US << MARKET, 5066, 1, 876700)
(STARFRUIT, MARKET << US, 5066, 1, 876700)
(STARFRUIT, MARKET << US, 5066, 1, 876700)
(STARFRUIT, MARKET << US, 5066, 1, 876700)
(STARFRUIT, MARKET << US, 5066, 1, 876700)
(STARFRUIT, MARKET << US, 5066, 1, 876700)","{""AMETHYSTS"": -18, ""STARFRUIT"": 3}",5201,5068,10000
877100,5066,175063,"(STARFRUIT, MARKET << US, 5066, 1, 877100)","{""AMETHYSTS"": -18, ""STARFRUIT"": 2}",5193,5065,10000
877200,40296,215359,"(AMETHYSTS, MARKET << US, 10004, 1, 877200)
(AMETHYSTS, MARKET << US, 10004, 1, 877200)
(STARFRUIT, MARKET << US, 5072, 1, 877200)
(STARFRUIT, MARKET << US, 5072, 1, 877200)
(STARFRUIT, MARKET << US, 5072, 1, 877200)
(STARFRUIT, MARKET << US, 5072, 1, 877200)","{""AMETHYSTS"": -20, ""STARFRUIT"": -2}",5221,5069,10000
877300,0,215359,,"{""AMETHYSTS"": -20, ""STARFRUIT"": -2}",5305,5067,9996
877500,-19996,195363,"(AMETHYSTS, US << MARKET, 9998, 1, 877500)
(AMETHYSTS, US << MARKET, 9998, 1, 877500)","{""AMETHYSTS"": -18, ""STARFRUIT"": -2}",5211,5067,10001
877700,5065,200428,"(STARFRUIT, MARKET << US, 5065, 1, 877700)","{""AMETHYSTS"": -18, ""STARFRUIT"": -3}",5236,5064,10000
878100,5070,205498,"(STARFRUIT, MARKET << US, 5070, 1, 878100)","{""AMETHYSTS"": -18, ""STARFRUIT"": -4}",5218,5070,10000
878300,9998,215496,"(AMETHYSTS, MARKET << US, 9998, 1, 878300)","{""AMETHYSTS"": -19, ""STARFRUIT"": -4}",5281,5068,9997
879000,9998,225494,"(AMETHYSTS, MARKET << US, 9998, 1, 879000)","{""AMETHYSTS"": -20, ""STARFRUIT"": -4}",5286,5067,9997
879100,-10140,215354,"(STARFRUIT, US << MARKET, 5070, 1, 879100)
(STARFRUIT, US << MARKET, 5070, 1, 879100)","{""AMETHYSTS"": -20, ""STARFRUIT"": -2}",5214,5070,10000
879200,-10130,205224,"(STARFRUIT, US << MARKET, 5065, 1, 879200)
(STARFRUIT, US << MARKET, 5065, 1, 879200)","{""AMETHYSTS"": -20, ""STARFRUIT"": 0}",5224,5067,10000
879900,10134,215358,"(STARFRUIT, MARKET << US, 5067, 1, 879900)
(STARFRUIT, MARKET << US, 5067, 1, 879900)","{""AMETHYSTS"": -20, ""STARFRUIT"": -2}",5160,5069,10003
880000,5067,220425,"(STARFRUIT, MARKET << US, 5067, 1, 880000)","{""AMETHYSTS"": -20, ""STARFRUIT"": -3}",5209,5072,10000
880400,-35497,184928,"(STARFRUIT, US << MARKET, 5071, 1, 880400)
(STARFRUIT, US << MARKET, 5071, 1, 880400)
(STARFRUIT, US << MARKET, 5071, 1, 880400)
(STARFRUIT, US << MARKET, 5071, 1, 880400)
(STARFRUIT, US << MARKET, 5071, 1, 880400)
(STARFRUIT, US << MARKET, 5071, 1, 880400)
(STARFRUIT, US << MARKET, 5071, 1, 880400)","{""AMETHYSTS"": -20, ""STARFRUIT"": 4}",5216,5072,10000
880700,-20300,164628,"(STARFRUIT, US << MARKET, 5075, 1, 880700)
(STARFRUIT, US << MARKET, 5075, 1, 880700)
(STARFRUIT, US << MARKET, 5075, 1, 880700)
(STARFRUIT, US << MARKET, 5075, 1, 880700)","{""AMETHYSTS"": -20, ""STARFRUIT"": 8}",5196,5071,10000
881200,-15204,149424,"(STARFRUIT, US << MARKET, 5068, 1, 881200)
(STARFRUIT, US << MARKET, 5068, 1, 881200)
(STARFRUIT, US << MARKET, 5068, 1, 881200)","{""AMETHYSTS"": -20, ""STARFRUIT"": 11}",5161,5067,10000
881300,20284,169708,"(STARFRUIT, MARKET << US, 5071, 1, 881300)
(STARFRUIT, MARKET << US, 5071, 1, 881300)
(STARFRUIT, MARKET << US, 5071, 1, 881300)
(STARFRUIT, MARKET << US, 5071, 1, 881300)","{""AMETHYSTS"": -20, ""STARFRUIT"": 7}",5232,5072,9999
881600,-99980,69728,"(AMETHYSTS, US << MARKET, 9998, 1, 881600)
(AMETHYSTS, US << MARKET, 9998, 1, 881600)
(AMETHYSTS, US << MARKET, 9998, 1, 881600)
(AMETHYSTS, US << MARKET, 9998, 1, 881600)
(AMETHYSTS, US << MARKET, 9998, 1, 881600)
(AMETHYSTS, US << MARKET, 9998, 1, 881600)
(AMETHYSTS, US << MARKET, 9998, 1, 881600)
(AMETHYSTS, US << MARKET, 9998, 1, 881600)
(AMETHYSTS, US << MARKET, 9998, 1, 881600)
(AMETHYSTS, US << MARKET, 9998, 1, 881600)","{""AMETHYSTS"": -10, ""STARFRUIT"": 7}",5265,5071,9996
881800,-14924,54804,"(AMETHYSTS, US << MARKET, 9996, 1, 881800)
(AMETHYSTS, US << MARKET, 9996, 1, 881800)
(STARFRUIT, MARKET << US, 5068, 1, 881800)","{""AMETHYSTS"": -8, ""STARFRUIT"": 6}",5248,5070,9997
881900,9858,64662,"(AMETHYSTS, MARKET << US, 10004, 1, 881900)
(AMETHYSTS, MARKET << US, 10004, 1, 881900)
(STARFRUIT, US << MARKET, 5075, 1, 881900)
(STARFRUIT, US << MARKET, 5075, 1, 881900)","{""AMETHYSTS"": -10, ""STARFRUIT"": 8}",5230,5071,10000
882300,9858,74520,"(AMETHYSTS, MARKET << US, 9996, 1, 882300)
(AMETHYSTS, MARKET << US, 9996, 1, 882300)
(STARFRUIT, US << MARKET, 5067, 1, 882300)
(STARFRUIT, US << MARKET, 5067, 1, 882300)","{""AMETHYSTS"": -12, ""STARFRUIT"": 10}",5220,5070,10000
882500,-5074,69446,"(STARFRUIT, US << MARKET, 5074, 1, 882500)","{""AMETHYSTS"": -12, ""STARFRUIT"": 11}",5216,5070,10000
882800,25370,94816,"(STARFRUIT, MARKET << US, 5074, 1, 882800)
(STARFRUIT, MARKET << US, 5074, 1, 882800)
(STARFRUIT, MARKET << US, 5074, 1, 882800)
(STARFRUIT, MARKET << US, 5074, 1, 882800)
(STARFRUIT, MARKET << US, 5074, 1, 882800)","{""AMETHYSTS"": -12, ""STARFRUIT"": 6}",5266,5075,10000
883100,5071,99887,"(STARFRUIT, MARKET << US, 5071, 1, 883100)","{""AMETHYSTS"": -12, ""STARFRUIT"": 5}",5252,5073,10000
883300,5076,104963,"(STARFRUIT, MARKET << US, 5076, 1, 883300)","{""AMETHYSTS"": -12, ""STARFRUIT"": 4}",5279,5073,9998
883900,-20312,84651,"(STARFRUIT, US << MARKET, 5078, 1, 883900)
(STARFRUIT, US << MARKET, 5078, 1, 883900)
(STARFRUIT, US << MARKET, 5078, 1, 883900)
(STARFRUIT, US << MARKET, 5078, 1, 883900)","{""AMETHYSTS"": -12, ""STARFRUIT"": 8}",5255,5074,9999
884200,-14924,69727,"(AMETHYSTS, US << MARKET, 9998, 1, 884200)
(AMETHYSTS, US << MARKET, 9998, 1, 884200)
(STARFRUIT, MARKET << US, 5072, 1, 884200)","{""AMETHYSTS"": -10, ""STARFRUIT"": 7}",5282,5075,9997
884300,5073,74800,"(STARFRUIT, MARKET << US, 5073, 1, 884300)","{""AMETHYSTS"": -10, ""STARFRUIT"": 6}",5250,5075,10000
884400,-10158,64642,"(STARFRUIT, US << MARKET, 5079, 1, 884400)
(STARFRUIT, US << MARKET, 5079, 1, 884400)","{""AMETHYSTS"": -10, ""STARFRUIT"": 8}",5274,5079,10000
884500,-15218,49424,"(STARFRUIT, US << MARKET, 5073, 1, 884500)
(STARFRUIT, US << MARKET, 5073, 1, 884500)
(STARFRUIT, US << MARKET, 5073, 1, 884500)
(STARFRUIT, US << MARKET, 5073, 1, 884500)
(STARFRUIT, MARKET << US, 5074, 1, 884500)","{""AMETHYSTS"": -10, ""STARFRUIT"": 11}",5217,5073,10001
884800,-10158,39266,"(STARFRUIT, US << MARKET, 5079, 1, 884800)
(STARFRUIT, US << MARKET, 5079, 1, 884800)
(STARFRUIT, US << MARKET, 5079, 1, 884800)
(STARFRUIT, MARKET << US, 5079, 1, 884800)","{""AMETHYSTS"": -10, ""STARFRUIT"": 13}",5264,5076,9999
884900,-10156,29110,"(STARFRUIT, US << MARKET, 5078, 1, 884900)
(STARFRUIT, US << MARKET, 5078, 1, 884900)","{""AMETHYSTS"": -10, ""STARFRUIT"": 15}",5205,5075,10003
885400,9998,39108,"(AMETHYSTS, MARKET << US, 9998, 1, 885400)","{""AMETHYSTS"": -11, ""STARFRUIT"": 15}",5233,5075,10000
885600,20008,59116,"(AMETHYSTS, MARKET << US, 10004, 1, 885600)
(AMETHYSTS, MARKET << US, 10004, 1, 885600)","{""AMETHYSTS"": -13, ""STARFRUIT"": 15}",5256,5076,10000
886100,-5074,54042,"(STARFRUIT, US << MARKET, 5074, 1, 886100)","{""AMETHYSTS"": -13, ""STARFRUIT"": 16}",5258,5076,10000
886900,-5073,48969,"(STARFRUIT, US << MARKET, 5073, 1, 886900)","{""AMETHYSTS"": -13, ""STARFRUIT"": 17}",5244,5075,10000
887000,142,49111,"(AMETHYSTS, US << MARKET, 10002, 1, 887000)
(STARFRUIT, MARKET << US, 5072, 1, 887000)
(STARFRUIT, MARKET << US, 5072, 1, 887000)","{""AMETHYSTS"": -12, ""STARFRUIT"": 15}",5200,5075,10003
887200,5078,54189,"(STARFRUIT, MARKET << US, 5078, 1, 887200)","{""AMETHYSTS"": -12, ""STARFRUIT"": 14}",5269,5078,10001
887300,9996,64185,"(AMETHYSTS, MARKET << US, 9996, 1, 887300)","{""AMETHYSTS"": -13, ""STARFRUIT"": 14}",5235,5075,10000
887400,-10146,54039,"(STARFRUIT, US << MARKET, 5073, 1, 887400)
(STARFRUIT, US << MARKET, 5073, 1, 887400)","{""AMETHYSTS"": -13, ""STARFRUIT"": 16}",5217,5072,9998
887600,-5077,48962,"(STARFRUIT, US << MARKET, 5077, 1, 887600)","{""AMETHYSTS"": -13, ""STARFRUIT"": 17}",5271,5077,10000
887700,-19996,28966,"(AMETHYSTS, US << MARKET, 9998, 1, 887700)
(AMETHYSTS, US << MARKET, 9998, 1, 887700)","{""AMETHYSTS"": -11, ""STARFRUIT"": 17}",5258,5076,10000
888100,30299,59265,"(AMETHYSTS, US << MARKET, 9996, 1, 888100)
(AMETHYSTS, US << MARKET, 9996, 1, 888100)
(AMETHYSTS, MARKET << US, 10002, 1, 888100)
(AMETHYSTS, MARKET << US, 10002, 1, 888100)
(AMETHYSTS, MARKET << US, 9996, 1, 888100)
(STARFRUIT, US << MARKET, 5078, 1, 888100)
(STARFRUIT, US << MARKET, 5078, 1, 888100)
(STARFRUIT, MARKET << US, 5077, 1, 888100)
(STARFRUIT, MARKET << US, 5074, 1, 888100)
(STARFRUIT, MARKET << US, 5074, 1, 888100)
(STARFRUIT, MARKET << US, 5074, 1, 888100)
(STARFRUIT, MARKET << US, 5074, 1, 888100)
(STARFRUIT, MARKET << US, 5074, 1, 888100)","{""AMETHYSTS"": -12, ""STARFRUIT"": 13}",5225,5072,9998
888300,25375,84640,"(STARFRUIT, MARKET << US, 5075, 1, 888300)
(STARFRUIT, MARKET << US, 5075, 1, 888300)
(STARFRUIT, MARKET << US, 5075, 1, 888300)
(STARFRUIT, MARKET << US, 5075, 1, 888300)
(STARFRUIT, MARKET << US, 5075, 1, 888300)","{""AMETHYSTS"": -12, ""STARFRUIT"": 8}",5248,5076,10000
888400,25350,109990,"(STARFRUIT, US << MARKET, 5070, 1, 888400)
(STARFRUIT, MARKET << US, 5070, 1, 888400)
(STARFRUIT, MARKET << US, 5070, 1, 888400)
(STARFRUIT, MARKET << US, 5070, 1, 888400)
(STARFRUIT, MARKET << US, 5070, 1, 888400)
(STARFRUIT, MARKET << US, 5070, 1, 888400)
(STARFRUIT, MARKET << US, 5070, 1, 888400)","{""AMETHYSTS"": -12, ""STARFRUIT"": 3}",5173,5073,10003
888500,-39980,70010,"(AMETHYSTS, US << MARKET, 9995, 1, 888500)
(AMETHYSTS, US << MARKET, 9995, 1, 888500)
(AMETHYSTS, US << MARKET, 9995, 1, 888500)
(AMETHYSTS, US << MARKET, 9995, 1, 888500)","{""AMETHYSTS"": -8, ""STARFRUIT"": 3}",5226,5072,10000
888600,-15211,54799,"(STARFRUIT, US << MARKET, 5070, 1, 888600)
(STARFRUIT, US << MARKET, 5070, 1, 888600)
(STARFRUIT, US << MARKET, 5071, 1, 888600)","{""AMETHYSTS"": -8, ""STARFRUIT"": 6}",5205,5069,10001
888900,-10138,44661,"(STARFRUIT, US << MARKET, 5069, 1, 888900)
(STARFRUIT, US << MARKET, 5069, 1, 888900)","{""AMETHYSTS"": -8, ""STARFRUIT"": 8}",5237,5072,10000
889100,25350,70011,"(STARFRUIT, MARKET << US, 5070, 1, 889100)
(STARFRUIT, MARKET << US, 5070, 1, 889100)
(STARFRUIT, MARKET << US, 5070, 1, 889100)
(STARFRUIT, MARKET << US, 5070, 1, 889100)
(STARFRUIT, MARKET << US, 5070, 1, 889100)","{""AMETHYSTS"": -8, ""STARFRUIT"": 3}",5239,5068,9997
889200,-45331,24680,"(AMETHYSTS, US << MARKET, 9998, 1, 889200)
(AMETHYSTS, US << MARKET, 9998, 1, 889200)
(STARFRUIT, US << MARKET, 5067, 1, 889200)
(STARFRUIT, US << MARKET, 5067, 1, 889200)
(STARFRUIT, US << MARKET, 5067, 1, 889200)
(STARFRUIT, US << MARKET, 5067, 1, 889200)
(STARFRUIT, US << MARKET, 5067, 1, 889200)","{""AMETHYSTS"": -6, ""STARFRUIT"": 8}",5208,5066,10000
889400,-5072,19608,"(STARFRUIT, US << MARKET, 5072, 1, 889400)","{""AMETHYSTS"": -6, ""STARFRUIT"": 9}",5265,5073,10000
889500,20004,39612,"(AMETHYSTS, MARKET << US, 10002, 1, 889500)
(AMETHYSTS, MARKET << US, 10002, 1, 889500)","{""AMETHYSTS"": -8, ""STARFRUIT"": 9}",5249,5069,9998
889600,19992,59604,"(AMETHYSTS, MARKET << US, 9996, 1, 889600)
(AMETHYSTS, MARKET << US, 9996, 1, 889600)","{""AMETHYSTS"": -10, ""STARFRUIT"": 9}",5225,5069,10000
890600,50150,109754,"(AMETHYSTS, MARKET << US, 10004, 1, 890600)
(AMETHYSTS, MARKET << US, 10004, 1, 890600)
(AMETHYSTS, MARKET << US, 10004, 1, 890600)
(AMETHYSTS, MARKET << US, 10004, 1, 890600)
(STARFRUIT, MARKET << US, 5067, 1, 890600)
(STARFRUIT, MARKET << US, 5067, 1, 890600)","{""AMETHYSTS"": -14, ""STARFRUIT"": 7}",5202,5066,10001
891200,49990,159744,"(AMETHYSTS, MARKET << US, 9998, 1, 891200)
(AMETHYSTS, MARKET << US, 9998, 1, 891200)
(AMETHYSTS, MARKET << US, 9998, 1, 891200)
(AMETHYSTS, MARKET << US, 9998, 1, 891200)
(AMETHYSTS, MARKET << US, 9998, 1, 891200)","{""AMETHYSTS"": -19, ""STARFRUIT"": 7}",5284,5069,9997
891700,-19996,139748,"(AMETHYSTS, US << MARKET, 9998, 1, 891700)
(AMETHYSTS, US << MARKET, 9998, 1, 891700)","{""AMETHYSTS"": -17, ""STARFRUIT"": 7}",5207,5068,10001
892000,-10002,129746,"(AMETHYSTS, US << MARKET, 10002, 1, 892000)","{""AMETHYSTS"": -16, ""STARFRUIT"": 7}",5247,5067,9998
892100,-9868,119878,"(AMETHYSTS, US << MARKET, 10005, 1, 892100)
(AMETHYSTS, US << MARKET, 10005, 1, 892100)
(STARFRUIT, MARKET << US, 5071, 1, 892100)
(STARFRUIT, MARKET << US, 5071, 1, 892100)","{""AMETHYSTS"": -14, ""STARFRUIT"": 5}",5199,5067,10001
892600,-19996,99882,"(AMETHYSTS, US << MARKET, 9998, 1, 892600)
(AMETHYSTS, US << MARKET, 9998, 1, 892600)","{""AMETHYSTS"": -12, ""STARFRUIT"": 5}",5248,5066,9997
892700,-20130,79752,"(AMETHYSTS, US << MARKET, 10002, 1, 892700)
(STARFRUIT, US << MARKET, 5064, 1, 892700)
(STARFRUIT, US << MARKET, 5064, 1, 892700)","{""AMETHYSTS"": -11, ""STARFRUIT"": 7}",5215,5063,9998
892800,-5068,74684,"(STARFRUIT, US << MARKET, 5068, 1, 892800)","{""AMETHYSTS"": -11, ""STARFRUIT"": 8}",5204,5065,10000
893100,9998,84682,"(AMETHYSTS, MARKET << US, 9998, 1, 893100)","{""AMETHYSTS"": -12, ""STARFRUIT"": 8}",5238,5065,9997
893300,-99980,-15298,"(AMETHYSTS, US << MARKET, 9998, 1, 893300)
(AMETHYSTS, US << MARKET, 9998, 1, 893300)
(AMETHYSTS, US << MARKET, 9998, 1, 893300)
(AMETHYSTS, US << MARKET, 9998, 1, 893300)
(AMETHYSTS, US << MARKET, 9998, 1, 893300)
(AMETHYSTS, US << MARKET, 9998, 1, 893300)
(AMETHYSTS, US << MARKET, 9998, 1, 893300)
(AMETHYSTS, US << MARKET, 9998, 1, 893300)
(AMETHYSTS, US << MARKET, 9998, 1, 893300)
(AMETHYSTS, US << MARKET, 9998, 1, 893300)","{""AMETHYSTS"": -2, ""STARFRUIT"": 8}",5204,5063,10001
893600,40016,24718,"(AMETHYSTS, MARKET << US, 10004, 1, 893600)
(AMETHYSTS, MARKET << US, 10004, 1, 893600)
(AMETHYSTS, MARKET << US, 10004, 1, 893600)
(AMETHYSTS, MARKET << US, 10004, 1, 893600)","{""AMETHYSTS"": -6, ""STARFRUIT"": 8}",5238,5065,10000
894100,-5067,19651,"(STARFRUIT, US << MARKET, 5067, 1, 894100)","{""AMETHYSTS"": -6, ""STARFRUIT"": 9}",5251,5064,9996
894300,-10002,9649,"(AMETHYSTS, US << MARKET, 10002, 1, 894300)","{""AMETHYSTS"": -5, ""STARFRUIT"": 9}",5210,5064,10003
894500,80032,89681,"(AMETHYSTS, MARKET << US, 10004, 1, 894500)
(AMETHYSTS, MARKET << US, 10004, 1, 894500)
(AMETHYSTS, MARKET << US, 10004, 1, 894500)
(AMETHYSTS, MARKET << US, 10004, 1, 894500)
(AMETHYSTS, MARKET << US, 10004, 1, 894500)
(AMETHYSTS, MARKET << US, 10004, 1, 894500)
(AMETHYSTS, MARKET << US, 10004, 1, 894500)
(AMETHYSTS, MARKET << US, 10004, 1, 894500)","{""AMETHYSTS"": -13, ""STARFRUIT"": 9}",5253,5065,10001
894600,-20252,69429,"(STARFRUIT, US << MARKET, 5063, 1, 894600)
(STARFRUIT, US << MARKET, 5063, 1, 894600)
(STARFRUIT, US << MARKET, 5063, 1, 894600)
(STARFRUIT, US << MARKET, 5063, 1, 894600)","{""AMETHYSTS"": -13, ""STARFRUIT"": 13}",5235,5062,10000
894700,-130,69299,"(AMETHYSTS, MARKET << US, 9996, 1, 894700)
(STARFRUIT, US << MARKET, 5063, 1, 894700)
(STARFRUIT, US << MARKET, 5063, 1, 894700)","{""AMETHYSTS"": -14, ""STARFRUIT"": 15}",5274,5065,10000
894800,-5068,64231,"(STARFRUIT, US << MARKET, 5068, 1, 894800)","{""AMETHYSTS"": -14, ""STARFRUIT"": 16}",5335,5069,10000
895100,-10002,54229,"(AMETHYSTS, US << MARKET, 10002, 1, 895100)","{""AMETHYSTS"": -13, ""STARFRUIT"": 16}",5246,5066,10003
895200,-115178,-60949,"(AMETHYSTS, US << MARKET, 9998, 1, 895200)
(AMETHYSTS, US << MARKET, 9998, 1, 895200)
(AMETHYSTS, US << MARKET, 9998, 1, 895200)
(AMETHYSTS, US << MARKET, 9998, 1, 895200)
(AMETHYSTS, US << MARKET, 9998, 1, 895200)
(AMETHYSTS, US << MARKET, 9998, 1, 895200)
(AMETHYSTS, US << MARKET, 9998, 1, 895200)
(AMETHYSTS, US << MARKET, 9998, 1, 895200)
(AMETHYSTS, US << MARKET, 9998, 1, 895200)
(AMETHYSTS, US << MARKET, 9998, 1, 895200)
(STARFRUIT, US << MARKET, 5066, 1, 895200)
(STARFRUIT, US << MARKET, 5066, 1, 895200)
(STARFRUIT, US << MARKET, 5066, 1, 895200)","{""AMETHYSTS"": -3, ""STARFRUIT"": 19}",5276,5064,9997
895400,-5068,-66017,"(STARFRUIT, US << MARKET, 5068, 1, 895400)","{""AMETHYSTS"": -3, ""STARFRUIT"": 20}",5363,5069,10000
895700,5068,-60949,"(STARFRUIT, MARKET << US, 5068, 1, 895700)","{""AMETHYSTS"": -3, ""STARFRUIT"": 19}",5362,5069,10000
897100,19992,-40957,"(AMETHYSTS, MARKET << US, 9996, 1, 897100)
(AMETHYSTS, MARKET << US, 9996, 1, 897100)","{""AMETHYSTS"": -5, ""STARFRUIT"": 19}",5259,5064,10000
897300,99950,58993,"(AMETHYSTS, MARKET << US, 9995, 1, 897300)
(AMETHYSTS, MARKET << US, 9995, 1, 897300)
(AMETHYSTS, MARKET << US, 9995, 1, 897300)
(AMETHYSTS, MARKET << US, 9995, 1, 897300)
(AMETHYSTS, MARKET << US, 9995, 1, 897300)
(AMETHYSTS, MARKET << US, 9995, 1, 897300)
(AMETHYSTS, MARKET << US, 9995, 1, 897300)
(AMETHYSTS, MARKET << US, 9995, 1, 897300)
(AMETHYSTS, MARKET << US, 9995, 1, 897300)
(AMETHYSTS, MARKET << US, 9995, 1, 897300)","{""AMETHYSTS"": -15, ""STARFRUIT"": 19}",5190,5063,10000
898000,-5060,53933,"(STARFRUIT, US << MARKET, 5060, 1, 898000)","{""AMETHYSTS"": -15, ""STARFRUIT"": 20}",5193,5063,10000
898100,20004,73937,"(AMETHYSTS, MARKET << US, 10002, 1, 898100)
(AMETHYSTS, MARKET << US, 10002, 1, 898100)","{""AMETHYSTS"": -17, ""STARFRUIT"": 20}",5146,5063,10003
898300,5060,78997,"(STARFRUIT, MARKET << US, 5060, 1, 898300)","{""AMETHYSTS"": -17, ""STARFRUIT"": 19}",5175,5062,10000
898400,-15071,63926,"(AMETHYSTS, US << MARKET, 10004, 1, 898400)
(STARFRUIT, US << MARKET, 5067, 1, 898400)","{""AMETHYSTS"": -16, ""STARFRUIT"": 20}",5186,5063,10000
898700,-10000,53926,"(AMETHYSTS, US << MARKET, 10000, 1, 898700)","{""AMETHYSTS"": -15, ""STARFRUIT"": 20}",5216,5066,10002
898900,25069,78995,"(AMETHYSTS, MARKET << US, 10004, 1, 898900)
(AMETHYSTS, MARKET << US, 10004, 1, 898900)
(STARFRUIT, MARKET << US, 5061, 1, 898900)","{""AMETHYSTS"": -17, ""STARFRUIT"": 19}",5211,5064,10000
899400,-14931,64064,"(AMETHYSTS, US << MARKET, 10002, 1, 899400)
(AMETHYSTS, US << MARKET, 10002, 1, 899400)
(STARFRUIT, US << MARKET, 5061, 1, 899400)
(STARFRUIT, MARKET << US, 5067, 1, 899400)
(STARFRUIT, MARKET << US, 5067, 1, 899400)","{""AMETHYSTS"": -15, ""STARFRUIT"": 18}",5231,5064,9999
899800,-5065,58999,"(STARFRUIT, US << MARKET, 5065, 1, 899800)","{""AMETHYSTS"": -15, ""STARFRUIT"": 19}",5234,5065,10000
899900,-5064,53935,"(STARFRUIT, US << MARKET, 5064, 1, 899900)","{""AMETHYSTS"": -15, ""STARFRUIT"": 20}",5220,5065,10001
900000,9995,63930,"(AMETHYSTS, MARKET << US, 9995, 1, 900000)","{""AMETHYSTS"": -16, ""STARFRUIT"": 20}",5190,5063,10000
900100,-20008,43922,"(AMETHYSTS, US << MARKET, 10004, 1, 900100)
(AMETHYSTS, US << MARKET, 10004, 1, 900100)","{""AMETHYSTS"": -14, ""STARFRUIT"": 20}",5174,5064,10002
900200,5060,48982,"(STARFRUIT, MARKET << US, 5060, 1, 900200)","{""AMETHYSTS"": -14, ""STARFRUIT"": 19}",5179,5063,10000
900500,5061,54043,"(STARFRUIT, MARKET << US, 5061, 1, 900500)","{""AMETHYSTS"": -14, ""STARFRUIT"": 18}",5195,5064,10000
900700,-15063,38980,"(AMETHYSTS, US << MARKET, 10000, 1, 900700)
(STARFRUIT, US << MARKET, 5063, 1, 900700)","{""AMETHYSTS"": -13, ""STARFRUIT"": 19}",5184,5062,9998
900900,40488,79468,"(STARFRUIT, US << MARKET, 5061, 1, 900900)
(STARFRUIT, MARKET << US, 5061, 1, 900900)
(STARFRUIT, MARKET << US, 5061, 1, 900900)
(STARFRUIT, MARKET << US, 5061, 1, 900900)
(STARFRUIT, MARKET << US, 5061, 1, 900900)
(STARFRUIT, MARKET << US, 5061, 1, 900900)
(STARFRUIT, MARKET << US, 5061, 1, 900900)
(STARFRUIT, MARKET << US, 5061, 1, 900900)
(STARFRUIT, MARKET << US, 5061, 1, 900900)
(STARFRUIT, MARKET << US, 5061, 1, 900900)","{""AMETHYSTS"": -13, ""STARFRUIT"": 11}",5172,5064,10000
901100,-5060,74408,"(STARFRUIT, US << MARKET, 5060, 1, 901100)","{""AMETHYSTS"": -13, ""STARFRUIT"": 12}",5164,5063,10000
901400,-15195,59213,"(STARFRUIT, US << MARKET, 5065, 1, 901400)
(STARFRUIT, US << MARKET, 5065, 1, 901400)
(STARFRUIT, US << MARKET, 5065, 1, 901400)
(STARFRUIT, US << MARKET, 5065, 1, 901400)
(STARFRUIT, MARKET << US, 5065, 1, 901400)","{""AMETHYSTS"": -13, ""STARFRUIT"": 15}",5203,5066,10000
901500,34918,94131,"(AMETHYSTS, MARKET << US, 9996, 1, 901500)
(AMETHYSTS, MARKET << US, 9996, 1, 901500)
(AMETHYSTS, MARKET << US, 9996, 1, 901500)
(AMETHYSTS, MARKET << US, 9996, 1, 901500)
(STARFRUIT, US << MARKET, 5066, 1, 901500)","{""AMETHYSTS"": -17, ""STARFRUIT"": 16}",5187,5066,10000
901900,25305,119436,"(STARFRUIT, MARKET << US, 5061, 1, 901900)
(STARFRUIT, MARKET << US, 5061, 1, 901900)
(STARFRUIT, MARKET << US, 5061, 1, 901900)
(STARFRUIT, MARKET << US, 5061, 1, 901900)
(STARFRUIT, MARKET << US, 5061, 1, 901900)","{""AMETHYSTS"": -17, ""STARFRUIT"": 11}",5089,5064,10003
902200,15198,134634,"(STARFRUIT, MARKET << US, 5066, 1, 902200)
(STARFRUIT, MARKET << US, 5066, 1, 902200)
(STARFRUIT, MARKET << US, 5066, 1, 902200)","{""AMETHYSTS"": -17, ""STARFRUIT"": 8}",5136,5067,10002
902400,9998,144632,"(AMETHYSTS, MARKET << US, 9998, 1, 902400)","{""AMETHYSTS"": -18, ""STARFRUIT"": 8}",5132,5067,10002
902700,-5068,139564,"(STARFRUIT, US << MARKET, 5068, 1, 902700)","{""AMETHYSTS"": -18, ""STARFRUIT"": 9}",5140,5064,10000
902900,9998,149562,"(AMETHYSTS, MARKET << US, 9998, 1, 902900)","{""AMETHYSTS"": -19, ""STARFRUIT"": 9}",5127,5067,10002
903900,-19996,129566,"(AMETHYSTS, US << MARKET, 9998, 1, 903900)
(AMETHYSTS, US << MARKET, 9998, 1, 903900)","{""AMETHYSTS"": -17, ""STARFRUIT"": 9}",5170,5069,10001
904100,20004,149570,"(AMETHYSTS, MARKET << US, 10002, 1, 904100)
(AMETHYSTS, MARKET << US, 10002, 1, 904100)","{""AMETHYSTS"": -19, ""STARFRUIT"": 9}",5116,5067,10003
904300,-50025,99545,"(AMETHYSTS, US << MARKET, 10005, 1, 904300)
(AMETHYSTS, US << MARKET, 10005, 1, 904300)
(AMETHYSTS, US << MARKET, 10005, 1, 904300)
(AMETHYSTS, US << MARKET, 10005, 1, 904300)
(AMETHYSTS, US << MARKET, 10005, 1, 904300)","{""AMETHYSTS"": -14, ""STARFRUIT"": 9}",5157,5068,10000
904400,-5071,94474,"(STARFRUIT, US << MARKET, 5071, 1, 904400)","{""AMETHYSTS"": -14, ""STARFRUIT"": 10}",5184,5071,10000
904600,-35218,59256,"(AMETHYSTS, US << MARKET, 10004, 1, 904600)
(AMETHYSTS, US << MARKET, 10004, 1, 904600)
(STARFRUIT, US << MARKET, 5070, 1, 904600)
(STARFRUIT, US << MARKET, 5070, 1, 904600)
(STARFRUIT, US << MARKET, 5070, 1, 904600)","{""AMETHYSTS"": -12, ""STARFRUIT"": 13}",5127,5067,10000
904800,20004,79260,"(AMETHYSTS, MARKET << US, 10002, 1, 904800)
(AMETHYSTS, MARKET << US, 10002, 1, 904800)","{""AMETHYSTS"": -14, ""STARFRUIT"": 13}",5158,5068,9999
905000,20004,99264,"(AMETHYSTS, MARKET << US, 10002, 1, 905000)
(AMETHYSTS, MARKET << US, 10002, 1, 905000)","{""AMETHYSTS"": -16, ""STARFRUIT"": 13}",5087,5067,10003
905300,5069,104333,"(STARFRUIT, MARKET << US, 5069, 1, 905300)","{""AMETHYSTS"": -16, ""STARFRUIT"": 12}",5161,5069,10000
905400,9998,114331,"(AMETHYSTS, MARKET << US, 9998, 1, 905400)","{""AMETHYSTS"": -17, ""STARFRUIT"": 12}",5186,5067,9997
905500,-14920,99411,"(AMETHYSTS, US << MARKET, 9995, 1, 905500)
(AMETHYSTS, US << MARKET, 9995, 1, 905500)
(STARFRUIT, MARKET << US, 5070, 1, 905500)","{""AMETHYSTS"": -15, ""STARFRUIT"": 11}",5181,5070,10000
905800,9998,109409,"(AMETHYSTS, MARKET << US, 9998, 1, 905800)","{""AMETHYSTS"": -16, ""STARFRUIT"": 11}",5194,5067,9997
906900,-20004,89405,"(AMETHYSTS, US << MARKET, 10002, 1, 906900)
(AMETHYSTS, US << MARKET, 10002, 1, 906900)","{""AMETHYSTS"": -14, ""STARFRUIT"": 11}",5089,5066,10003
907000,-39992,49413,"(AMETHYSTS, US << MARKET, 9998, 1, 907000)
(AMETHYSTS, US << MARKET, 9998, 1, 907000)
(AMETHYSTS, US << MARKET, 9998, 1, 907000)
(AMETHYSTS, US << MARKET, 9998, 1, 907000)","{""AMETHYSTS"": -10, ""STARFRUIT"": 11}",5169,5066,9997
907300,-10004,39409,"(AMETHYSTS, US << MARKET, 10004, 1, 907300)","{""AMETHYSTS"": -9, ""STARFRUIT"": 11}",5135,5066,10000
907400,-4935,34474,"(AMETHYSTS, US << MARKET, 10004, 1, 907400)
(STARFRUIT, MARKET << US, 5069, 1, 907400)","{""AMETHYSTS"": -8, ""STARFRUIT"": 10}",5124,5065,10000
907500,30372,64846,"(STARFRUIT, MARKET << US, 5062, 1, 907500)
(STARFRUIT, MARKET << US, 5062, 1, 907500)
(STARFRUIT, MARKET << US, 5062, 1, 907500)
(STARFRUIT, MARKET << US, 5062, 1, 907500)
(STARFRUIT, MARKET << US, 5062, 1, 907500)
(STARFRUIT, MARKET << US, 5062, 1, 907500)","{""AMETHYSTS"": -8, ""STARFRUIT"": 4}",5102,5064,10000
907600,24815,89661,"(AMETHYSTS, MARKET << US, 10004, 1, 907600)
(AMETHYSTS, MARKET << US, 10004, 1, 907600)
(AMETHYSTS, MARKET << US, 10004, 1, 907600)
(AMETHYSTS, MARKET << US, 10004, 1, 907600)
(STARFRUIT, US << MARKET, 5067, 1, 907600)
(STARFRUIT, US << MARKET, 5067, 1, 907600)
(STARFRUIT, US << MARKET, 5067, 1, 907600)","{""AMETHYSTS"": -12, ""STARFRUIT"": 7}",5116,5065,10000
907800,70014,159675,"(AMETHYSTS, MARKET << US, 10002, 1, 907800)
(AMETHYSTS, MARKET << US, 10002, 1, 907800)
(AMETHYSTS, MARKET << US, 10002, 1, 907800)
(AMETHYSTS, MARKET << US, 10002, 1, 907800)
(AMETHYSTS, MARKET << US, 10002, 1, 907800)
(AMETHYSTS, MARKET << US, 10002, 1, 907800)
(AMETHYSTS, MARKET << US, 10002, 1, 907800)","{""AMETHYSTS"": -19, ""STARFRUIT"": 7}",5080,5066,10003
908000,-10002,149673,"(AMETHYSTS, US << MARKET, 10002, 1, 908000)","{""AMETHYSTS"": -18, ""STARFRUIT"": 7}",5081,5066,10003
908100,-60012,89661,"(AMETHYSTS, US << MARKET, 10002, 1, 908100)
(AMETHYSTS, US << MARKET, 10002, 1, 908100)
(AMETHYSTS, US << MARKET, 10002, 1, 908100)
(AMETHYSTS, US << MARKET, 10002, 1, 908100)
(AMETHYSTS, US << MARKET, 10002, 1, 908100)
(AMETHYSTS, US << MARKET, 10002, 1, 908100)","{""AMETHYSTS"": -12, ""STARFRUIT"": 7}",5154,5067,9998
908200,5064,94725,"(STARFRUIT, MARKET << US, 5064, 1, 908200)","{""AMETHYSTS"": -12, ""STARFRUIT"": 6}",5139,5067,9999
908300,-10138,84587,"(STARFRUIT, US << MARKET, 5069, 1, 908300)
(STARFRUIT, US << MARKET, 5069, 1, 908300)","{""AMETHYSTS"": -12, ""STARFRUIT"": 8}",5163,5069,9998
908500,-19996,64591,"(AMETHYSTS, US << MARKET, 9998, 1, 908500)
(AMETHYSTS, US << MARKET, 9998, 1, 908500)","{""AMETHYSTS"": -10, ""STARFRUIT"": 8}",5157,5067,9997
908700,-24937,39654,"(AMETHYSTS, US << MARKET, 10002, 1, 908700)
(AMETHYSTS, US << MARKET, 10002, 1, 908700)
(AMETHYSTS, US << MARKET, 10002, 1, 908700)
(STARFRUIT, MARKET << US, 5069, 1, 908700)","{""AMETHYSTS"": -7, ""STARFRUIT"": 7}",5116,5069,10003
909500,-4938,34716,"(AMETHYSTS, US << MARKET, 10002, 1, 909500)
(STARFRUIT, MARKET << US, 5064, 1, 909500)","{""AMETHYSTS"": -6, ""STARFRUIT"": 6}",5124,5067,9999
910200,9878,44594,"(AMETHYSTS, US << MARKET, 10002, 1, 910200)
(AMETHYSTS, US << MARKET, 10002, 1, 910200)
(AMETHYSTS, MARKET << US, 10002, 1, 910200)
(AMETHYSTS, MARKET << US, 10002, 1, 910200)
(AMETHYSTS, MARKET << US, 10002, 1, 910200)
(AMETHYSTS, MARKET << US, 10002, 1, 910200)
(STARFRUIT, US << MARKET, 5063, 1, 910200)
(STARFRUIT, US << MARKET, 5063, 1, 910200)","{""AMETHYSTS"": -8, ""STARFRUIT"": 8}",5098,5066,10003
910400,90426,135020,"(AMETHYSTS, MARKET << US, 10002, 1, 910400)
(AMETHYSTS, MARKET << US, 10002, 1, 910400)
(AMETHYSTS, MARKET << US, 10002, 1, 910400)
(AMETHYSTS, MARKET << US, 10002, 1, 910400)
(AMETHYSTS, MARKET << US, 10002, 1, 910400)
(AMETHYSTS, MARKET << US, 10002, 1, 910400)
(STARFRUIT, MARKET << US, 5069, 1, 910400)
(STARFRUIT, MARKET << US, 5069, 1, 910400)
(STARFRUIT, MARKET << US, 5069, 1, 910400)
(STARFRUIT, MARKET << US, 5069, 1, 910400)
(STARFRUIT, MARKET << US, 5069, 1, 910400)
(STARFRUIT, MARKET << US, 5069, 1, 910400)","{""AMETHYSTS"": -14, ""STARFRUIT"": 2}",5164,5065,9999
910500,5062,140082,"(STARFRUIT, MARKET << US, 5062, 1, 910500)","{""AMETHYSTS"": -14, ""STARFRUIT"": 1}",5147,5065,10000
910900,25079,165161,"(AMETHYSTS, MARKET << US, 10005, 1, 910900)
(AMETHYSTS, MARKET << US, 10005, 1, 910900)
(STARFRUIT, MARKET << US, 5069, 1, 910900)","{""AMETHYSTS"": -16, ""STARFRUIT"": 0}",5161,5065,10000
911300,29985,195146,"(AMETHYSTS, MARKET << US, 9995, 1, 911300)
(AMETHYSTS, MARKET << US, 9995, 1, 911300)
(AMETHYSTS, MARKET << US, 9995, 1, 911300)","{""AMETHYSTS"": -19, ""STARFRUIT"": 0}",5146,5063,10000
911500,10004,205150,"(AMETHYSTS, MARKET << US, 10004, 1, 911500)","{""AMETHYSTS"": -20, ""STARFRUIT"": 0}",5150,5062,10000
911800,0,205150,,"{""AMETHYSTS"": -20, ""STARFRUIT"": 0}",5230,5063,9996
912100,5060,210210,"(STARFRUIT, MARKET << US, 5060, 1, 912100)","{""AMETHYSTS"": -20, ""STARFRUIT"": -1}",5148,5062,10000
912700,-14931,195279,"(AMETHYSTS, US << MARKET, 9996, 1, 912700)
(AMETHYSTS, US << MARKET, 9996, 1, 912700)
(STARFRUIT, MARKET << US, 5061, 1, 912700)","{""AMETHYSTS"": -18, ""STARFRUIT"": -2}",5151,5064,10000
912800,-30396,164883,"(STARFRUIT, US << MARKET, 5066, 1, 912800)
(STARFRUIT, US << MARKET, 5066, 1, 912800)
(STARFRUIT, US << MARKET, 5066, 1, 912800)
(STARFRUIT, US << MARKET, 5066, 1, 912800)
(STARFRUIT, US << MARKET, 5066, 1, 912800)
(STARFRUIT, US << MARKET, 5066, 1, 912800)","{""AMETHYSTS"": -18, ""STARFRUIT"": 4}",5151,5067,10000
913100,5067,169950,"(STARFRUIT, MARKET << US, 5067, 1, 913100)","{""AMETHYSTS"": -18, ""STARFRUIT"": 3}",5133,5067,10001
913200,-5062,164888,"(STARFRUIT, US << MARKET, 5062, 1, 913200)
(STARFRUIT, US << MARKET, 5062, 1, 913200)
(STARFRUIT, US << MARKET, 5062, 1, 913200)
(STARFRUIT, US << MARKET, 5062, 1, 913200)
(STARFRUIT, US << MARKET, 5062, 1, 913200)
(STARFRUIT, MARKET << US, 5062, 1, 913200)
(STARFRUIT, MARKET << US, 5062, 1, 913200)
(STARFRUIT, MARKET << US, 5062, 1, 913200)
(STARFRUIT, MARKET << US, 5062, 1, 913200)","{""AMETHYSTS"": -18, ""STARFRUIT"": 4}",5166,5065,9999
913300,-15186,149702,"(STARFRUIT, US << MARKET, 5062, 1, 913300)
(STARFRUIT, US << MARKET, 5062, 1, 913300)
(STARFRUIT, US << MARKET, 5062, 1, 913300)","{""AMETHYSTS"": -18, ""STARFRUIT"": 7}",5157,5065,10000
913700,-19996,129706,"(AMETHYSTS, US << MARKET, 9998, 1, 913700)
(AMETHYSTS, US << MARKET, 9998, 1, 913700)","{""AMETHYSTS"": -16, ""STARFRUIT"": 7}",5202,5064,9997
914000,-5063,124643,"(STARFRUIT, US << MARKET, 5063, 1, 914000)","{""AMETHYSTS"": -16, ""STARFRUIT"": 8}",5163,5065,10000
914700,30140,154783,"(AMETHYSTS, MARKET << US, 10004, 1, 914700)
(AMETHYSTS, MARKET << US, 10004, 1, 914700)
(STARFRUIT, MARKET << US, 5066, 1, 914700)
(STARFRUIT, MARKET << US, 5066, 1, 914700)","{""AMETHYSTS"": -18, ""STARFRUIT"": 6}",5155,5062,10000
914800,-39992,114791,"(AMETHYSTS, US << MARKET, 9998, 1, 914800)
(AMETHYSTS, US << MARKET, 9998, 1, 914800)
(AMETHYSTS, US << MARKET, 9998, 1, 914800)
(AMETHYSTS, US << MARKET, 9998, 1, 914800)","{""AMETHYSTS"": -14, ""STARFRUIT"": 6}",5217,5064,9997
914900,-10120,104671,"(STARFRUIT, US << MARKET, 5060, 1, 914900)
(STARFRUIT, US << MARKET, 5060, 1, 914900)","{""AMETHYSTS"": -14, ""STARFRUIT"": 8}",5183,5064,10000
915000,-15070,89601,"(AMETHYSTS, US << MARKET, 10004, 1, 915000)
(STARFRUIT, US << MARKET, 5066, 1, 915000)","{""AMETHYSTS"": -13, ""STARFRUIT"": 9}",5168,5063,10000
915100,4938,94539,"(AMETHYSTS, MARKET << US, 9998, 1, 915100)
(STARFRUIT, US << MARKET, 5060, 1, 915100)","{""AMETHYSTS"": -14, ""STARFRUIT"": 10}",5211,5063,9997
915200,10124,104663,"(STARFRUIT, MARKET << US, 5062, 1, 915200)
(STARFRUIT, MARKET << US, 5062, 1, 915200)","{""AMETHYSTS"": -14, ""STARFRUIT"": 8}",5185,5060,9997
915600,5059,109722,"(STARFRUIT, MARKET << US, 5059, 1, 915600)","{""AMETHYSTS"": -14, ""STARFRUIT"": 7}",5156,5062,10000
916200,0,109722,"(AMETHYSTS, US << MARKET, 9998, 1, 916200)
(AMETHYSTS, US << MARKET, 9998, 1, 916200)
(AMETHYSTS, MARKET << US, 9998, 1, 916200)
(AMETHYSTS, MARKET << US, 9998, 1, 916200)","{""AMETHYSTS"": -14, ""STARFRUIT"": 7}",5114,5058,10001
916300,25300,135022,"(STARFRUIT, MARKET << US, 5060, 1, 916300)
(STARFRUIT, MARKET << US, 5060, 1, 916300)
(STARFRUIT, MARKET << US, 5060, 1, 916300)
(STARFRUIT, MARKET << US, 5060, 1, 916300)
(STARFRUIT, MARKET << US, 5060, 1, 916300)","{""AMETHYSTS"": -14, ""STARFRUIT"": 2}",5166,5058,9998
916700,25074,160096,"(AMETHYSTS, MARKET << US, 10005, 1, 916700)
(AMETHYSTS, MARKET << US, 10005, 1, 916700)
(STARFRUIT, MARKET << US, 5064, 1, 916700)","{""AMETHYSTS"": -16, ""STARFRUIT"": 1}",5156,5060,10000
916800,15177,175273,"(STARFRUIT, MARKET << US, 5059, 1, 916800)
(STARFRUIT, MARKET << US, 5059, 1, 916800)
(STARFRUIT, MARKET << US, 5059, 1, 916800)","{""AMETHYSTS"": -16, ""STARFRUIT"": -2}",5157,5058,10000
916900,-30348,144925,"(STARFRUIT, US << MARKET, 5058, 1, 916900)
(STARFRUIT, US << MARKET, 5058, 1, 916900)
(STARFRUIT, US << MARKET, 5058, 1, 916900)
(STARFRUIT, US << MARKET, 5058, 1, 916900)
(STARFRUIT, US << MARKET, 5058, 1, 916900)
(STARFRUIT, US << MARKET, 5058, 1, 916900)","{""AMETHYSTS"": -16, ""STARFRUIT"": 4}",5177,5063,10000
917300,20256,165181,"(STARFRUIT, MARKET << US, 5064, 1, 917300)
(STARFRUIT, MARKET << US, 5064, 1, 917300)
(STARFRUIT, MARKET << US, 5064, 1, 917300)
(STARFRUIT, MARKET << US, 5064, 1, 917300)","{""AMETHYSTS"": -16, ""STARFRUIT"": 0}",5181,5061,10000
917600,-90012,75169,"(AMETHYSTS, US << MARKET, 10002, 1, 917600)
(AMETHYSTS, US << MARKET, 10002, 1, 917600)
(AMETHYSTS, US << MARKET, 10002, 1, 917600)
(AMETHYSTS, US << MARKET, 10002, 1, 917600)
(AMETHYSTS, US << MARKET, 10002, 1, 917600)
(AMETHYSTS, US << MARKET, 10002, 1, 917600)
(AMETHYSTS, US << MARKET, 10002, 1, 917600)
(AMETHYSTS, US << MARKET, 10002, 1, 917600)
(AMETHYSTS, US << MARKET, 10002, 1, 917600)
(AMETHYSTS, US << MARKET, 10002, 1, 917600)
(AMETHYSTS, US << MARKET, 10002, 1, 917600)
(AMETHYSTS, US << MARKET, 10002, 1, 917600)
(AMETHYSTS, US << MARKET, 10004, 1, 917600)
(AMETHYSTS, MARKET << US, 10004, 1, 917600)
(AMETHYSTS, MARKET << US, 10004, 1, 917600)
(AMETHYSTS, MARKET << US, 10004, 1, 917600)
(AMETHYSTS, MARKET << US, 10004, 1, 917600)","{""AMETHYSTS"": -7, ""STARFRUIT"": 0}",5148,5060,10003
917800,-10116,65053,"(STARFRUIT, US << MARKET, 5058, 1, 917800)
(STARFRUIT, US << MARKET, 5058, 1, 917800)","{""AMETHYSTS"": -7, ""STARFRUIT"": 2}",5182,5061,9999
918000,20244,85297,"(STARFRUIT, MARKET << US, 5061, 1, 918000)
(STARFRUIT, MARKET << US, 5061, 1, 918000)
(STARFRUIT, MARKET << US, 5061, 1, 918000)
(STARFRUIT, MARKET << US, 5061, 1, 918000)","{""AMETHYSTS"": -7, ""STARFRUIT"": -2}",5194,5062,9997
918400,-19996,65301,"(AMETHYSTS, US << MARKET, 9998, 1, 918400)
(AMETHYSTS, US << MARKET, 9998, 1, 918400)","{""AMETHYSTS"": -5, ""STARFRUIT"": -2}",5198,5059,9997
918800,5057,70358,"(STARFRUIT, MARKET << US, 5057, 1, 918800)","{""AMETHYSTS"": -5, ""STARFRUIT"": -3}",5173,5060,10001
918900,-30360,39998,"(STARFRUIT, US << MARKET, 5060, 1, 918900)
(STARFRUIT, US << MARKET, 5060, 1, 918900)
(STARFRUIT, US << MARKET, 5060, 1, 918900)
(STARFRUIT, US << MARKET, 5060, 1, 918900)
(STARFRUIT, US << MARKET, 5060, 1, 918900)
(STARFRUIT, US << MARKET, 5060, 1, 918900)","{""AMETHYSTS"": -5, ""STARFRUIT"": 3}",5185,5059,9998
919000,-179928,-139930,"(AMETHYSTS, US << MARKET, 9996, 1, 919000)
(AMETHYSTS, US << MARKET, 9996, 1, 919000)
(AMETHYSTS, US << MARKET, 9996, 1, 919000)
(AMETHYSTS, US << MARKET, 9996, 1, 919000)
(AMETHYSTS, US << MARKET, 9996, 1, 919000)
(AMETHYSTS, US << MARKET, 9996, 1, 919000)
(AMETHYSTS, US << MARKET, 9996, 1, 919000)
(AMETHYSTS, US << MARKET, 9996, 1, 919000)
(AMETHYSTS, US << MARKET, 9996, 1, 919000)
(AMETHYSTS, US << MARKET, 9996, 1, 919000)
(AMETHYSTS, US << MARKET, 9996, 1, 919000)
(AMETHYSTS, US << MARKET, 9996, 1, 919000)
(AMETHYSTS, US << MARKET, 9996, 1, 919000)
(AMETHYSTS, US << MARKET, 9996, 1, 919000)
(AMETHYSTS, US << MARKET, 9996, 1, 919000)
(AMETHYSTS, US << MARKET, 9996, 1, 919000)
(AMETHYSTS, US << MARKET, 9996, 1, 919000)
(AMETHYSTS, US << MARKET, 9996, 1, 919000)","{""AMETHYSTS"": 13, ""STARFRUIT"": 3}",5250,5060,10000
919500,-54926,-194856,"(AMETHYSTS, US << MARKET, 9998, 1, 919500)
(AMETHYSTS, US << MARKET, 9998, 1, 919500)
(AMETHYSTS, US << MARKET, 9998, 1, 919500)
(AMETHYSTS, US << MARKET, 9998, 1, 919500)
(AMETHYSTS, US << MARKET, 9998, 1, 919500)
(AMETHYSTS, US << MARKET, 9998, 1, 919500)
(STARFRUIT, MARKET << US, 5062, 1, 919500)","{""AMETHYSTS"": 19, ""STARFRUIT"": 2}",5205,5059,9997
919600,-9996,-204852,"(AMETHYSTS, US << MARKET, 9996, 1, 919600)","{""AMETHYSTS"": 20, ""STARFRUIT"": 2}",5204,5058,9997
919800,9998,-194854,"(AMETHYSTS, MARKET << US, 9998, 1, 919800)","{""AMETHYSTS"": 19, ""STARFRUIT"": 2}",5281,5058,10001
920100,-20236,-215090,"(STARFRUIT, US << MARKET, 5059, 1, 920100)
(STARFRUIT, US << MARKET, 5059, 1, 920100)
(STARFRUIT, US << MARKET, 5059, 1, 920100)
(STARFRUIT, US << MARKET, 5059, 1, 920100)","{""AMETHYSTS"": 19, ""STARFRUIT"": 6}",5195,5057,9997
920400,49990,-165100,"(AMETHYSTS, MARKET << US, 9998, 1, 920400)
(AMETHYSTS, MARKET << US, 9998, 1, 920400)
(AMETHYSTS, MARKET << US, 9998, 1, 920400)
(AMETHYSTS, MARKET << US, 9998, 1, 920400)
(AMETHYSTS, MARKET << US, 9998, 1, 920400)","{""AMETHYSTS"": 14, ""STARFRUIT"": 6}",5206,5058,9997
920900,-30106,-195206,"(AMETHYSTS, US << MARKET, 9996, 1, 920900)
(AMETHYSTS, US << MARKET, 9996, 1, 920900)
(STARFRUIT, US << MARKET, 5057, 1, 920900)
(STARFRUIT, US << MARKET, 5057, 1, 920900)","{""AMETHYSTS"": 16, ""STARFRUIT"": 8}",5250,5057,10000
922000,-10118,-205324,"(STARFRUIT, US << MARKET, 5059, 1, 922000)
(STARFRUIT, US << MARKET, 5059, 1, 922000)","{""AMETHYSTS"": 16, ""STARFRUIT"": 10}",5276,5060,10000
922400,39992,-165332,"(AMETHYSTS, MARKET << US, 9998, 1, 922400)
(AMETHYSTS, MARKET << US, 9998, 1, 922400)
(AMETHYSTS, MARKET << US, 9998, 1, 922400)
(AMETHYSTS, MARKET << US, 9998, 1, 922400)","{""AMETHYSTS"": 12, ""STARFRUIT"": 10}",5212,5058,9997
922700,30360,-134972,"(STARFRUIT, MARKET << US, 5060, 1, 922700)
(STARFRUIT, MARKET << US, 5060, 1, 922700)
(STARFRUIT, MARKET << US, 5060, 1, 922700)
(STARFRUIT, MARKET << US, 5060, 1, 922700)
(STARFRUIT, MARKET << US, 5060, 1, 922700)
(STARFRUIT, MARKET << US, 5060, 1, 922700)","{""AMETHYSTS"": 12, ""STARFRUIT"": 4}",5256,5057,10000
922800,20004,-114968,"(AMETHYSTS, MARKET << US, 10002, 1, 922800)
(AMETHYSTS, MARKET << US, 10002, 1, 922800)","{""AMETHYSTS"": 10, ""STARFRUIT"": 4}",5290,5057,10003
923300,-10122,-125090,"(STARFRUIT, US << MARKET, 5061, 1, 923300)
(STARFRUIT, US << MARKET, 5061, 1, 923300)","{""AMETHYSTS"": 10, ""STARFRUIT"": 6}",5276,5061,10000
923400,-10002,-135092,"(AMETHYSTS, US << MARKET, 10002, 1, 923400)","{""AMETHYSTS"": 11, ""STARFRUIT"": 6}",5283,5057,10003
923500,-116,-135208,"(AMETHYSTS, MARKET << US, 9996, 1, 923500)
(STARFRUIT, US << MARKET, 5056, 1, 923500)
(STARFRUIT, US << MARKET, 5056, 1, 923500)","{""AMETHYSTS"": 10, ""STARFRUIT"": 8}",5264,5059,10000
923600,-15068,-150276,"(AMETHYSTS, US << MARKET, 10005, 1, 923600)
(STARFRUIT, US << MARKET, 5063, 1, 923600)","{""AMETHYSTS"": 11, ""STARFRUIT"": 9}",5255,5059,10000
923800,-20004,-170280,"(AMETHYSTS, US << MARKET, 10002, 1, 923800)
(AMETHYSTS, US << MARKET, 10002, 1, 923800)","{""AMETHYSTS"": 13, ""STARFRUIT"": 9}",5290,5059,10003
924100,20004,-150276,"(AMETHYSTS, MARKET << US, 10002, 1, 924100)
(AMETHYSTS, MARKET << US, 10002, 1, 924100)","{""AMETHYSTS"": 11, ""STARFRUIT"": 9}",5235,5058,9999
924700,14948,-135328,"(AMETHYSTS, MARKET << US, 10002, 1, 924700)
(AMETHYSTS, MARKET << US, 10002, 1, 924700)
(STARFRUIT, US << MARKET, 5056, 1, 924700)","{""AMETHYSTS"": 9, ""STARFRUIT"": 10}",5289,5059,10003
924800,-10002,-145330,"(AMETHYSTS, US << MARKET, 10002, 1, 924800)","{""AMETHYSTS"": 10, ""STARFRUIT"": 10}",5300,5060,10003
925400,5059,-140271,"(STARFRUIT, MARKET << US, 5059, 1, 925400)","{""AMETHYSTS"": 10, ""STARFRUIT"": 9}",5278,5061,10000
925600,-14931,-155202,"(AMETHYSTS, US << MARKET, 9995, 1, 925600)
(AMETHYSTS, US << MARKET, 9995, 1, 925600)
(STARFRUIT, MARKET << US, 5059, 1, 925600)","{""AMETHYSTS"": 12, ""STARFRUIT"": 8}",5294,5062,10000
926200,5062,-150140,"(STARFRUIT, MARKET << US, 5062, 1, 926200)","{""AMETHYSTS"": 12, ""STARFRUIT"": 7}",5282,5062,9999
926300,-5057,-155197,"(STARFRUIT, US << MARKET, 5057, 1, 926300)","{""AMETHYSTS"": 12, ""STARFRUIT"": 8}",5263,5059,9999
926800,-10002,-165199,"(AMETHYSTS, US << MARKET, 10002, 1, 926800)","{""AMETHYSTS"": 13, ""STARFRUIT"": 8}",5328,5061,10003
926900,5063,-160136,"(STARFRUIT, MARKET << US, 5063, 1, 926900)","{""AMETHYSTS"": 13, ""STARFRUIT"": 7}",5244,5058,9998
927600,-10118,-170254,"(STARFRUIT, US << MARKET, 5059, 1, 927600)
(STARFRUIT, US << MARKET, 5059, 1, 927600)","{""AMETHYSTS"": 13, ""STARFRUIT"": 9}",5242,5058,9998
927700,30336,-139918,"(STARFRUIT, MARKET << US, 5056, 1, 927700)
(STARFRUIT, MARKET << US, 5056, 1, 927700)
(STARFRUIT, MARKET << US, 5056, 1, 927700)
(STARFRUIT, MARKET << US, 5056, 1, 927700)
(STARFRUIT, MARKET << US, 5056, 1, 927700)
(STARFRUIT, MARKET << US, 5056, 1, 927700)","{""AMETHYSTS"": 13, ""STARFRUIT"": 3}",5259,5059,10000
928200,-19996,-159914,"(AMETHYSTS, US << MARKET, 9998, 1, 928200)
(AMETHYSTS, US << MARKET, 9998, 1, 928200)","{""AMETHYSTS"": 15, ""STARFRUIT"": 3}",5278,5059,10001
928400,5062,-154852,"(STARFRUIT, MARKET << US, 5062, 1, 928400)","{""AMETHYSTS"": 15, ""STARFRUIT"": 2}",5247,5057,9999
928800,-10124,-164976,"(STARFRUIT, US << MARKET, 5062, 1, 928800)
(STARFRUIT, US << MARKET, 5062, 1, 928800)","{""AMETHYSTS"": 15, ""STARFRUIT"": 4}",5260,5059,10000
928900,-20236,-185212,"(STARFRUIT, US << MARKET, 5059, 1, 928900)
(STARFRUIT, US << MARKET, 5059, 1, 928900)
(STARFRUIT, US << MARKET, 5059, 1, 928900)
(STARFRUIT, US << MARKET, 5059, 1, 928900)","{""AMETHYSTS"": 15, ""STARFRUIT"": 8}",5214,5057,9998
929600,-5058,-190270,"(STARFRUIT, US << MARKET, 5058, 1, 929600)","{""AMETHYSTS"": 15, ""STARFRUIT"": 9}",5279,5061,10000
929700,-20134,-210404,"(AMETHYSTS, US << MARKET, 10004, 1, 929700)
(STARFRUIT, US << MARKET, 5065, 1, 929700)
(STARFRUIT, US << MARKET, 5065, 1, 929700)","{""AMETHYSTS"": 16, ""STARFRUIT"": 11}",5283,5061,10001
930100,9998,-200406,"(AMETHYSTS, US << MARKET, 9998, 1, 930100)
(AMETHYSTS, US << MARKET, 9998, 1, 930100)
(AMETHYSTS, US << MARKET, 9998, 1, 930100)
(AMETHYSTS, MARKET << US, 9998, 1, 930100)
(AMETHYSTS, MARKET << US, 9998, 1, 930100)
(AMETHYSTS, MARKET << US, 9998, 1, 930100)
(AMETHYSTS, MARKET << US, 9998, 1, 930100)","{""AMETHYSTS"": 15, ""STARFRUIT"": 11}",5231,5062,9997
930200,5059,-195347,"(STARFRUIT, MARKET << US, 5059, 1, 930200)","{""AMETHYSTS"": 15, ""STARFRUIT"": 10}",5258,5062,9999
931100,-19996,-215343,"(AMETHYSTS, US << MARKET, 9998, 1, 931100)
(AMETHYSTS, US << MARKET, 9998, 1, 931100)","{""AMETHYSTS"": 17, ""STARFRUIT"": 10}",5294,5062,10001
931400,9998,-205345,"(AMETHYSTS, MARKET << US, 9998, 1, 931400)
(STARFRUIT, US << MARKET, 5064, 1, 931400)
(STARFRUIT, US << MARKET, 5064, 1, 931400)
(STARFRUIT, US << MARKET, 5064, 1, 931400)
(STARFRUIT, US << MARKET, 5064, 1, 931400)
(STARFRUIT, MARKET << US, 5064, 1, 931400)
(STARFRUIT, MARKET << US, 5064, 1, 931400)
(STARFRUIT, MARKET << US, 5064, 1, 931400)
(STARFRUIT, MARKET << US, 5064, 1, 931400)","{""AMETHYSTS"": 16, ""STARFRUIT"": 10}",5217,5061,9997
931600,35170,-170175,"(AMETHYSTS, MARKET << US, 9995, 1, 931600)
(AMETHYSTS, MARKET << US, 9995, 1, 931600)
(STARFRUIT, MARKET << US, 5064, 1, 931600)
(STARFRUIT, MARKET << US, 5058, 1, 931600)
(STARFRUIT, MARKET << US, 5058, 1, 931600)","{""AMETHYSTS"": 14, ""STARFRUIT"": 7}",5252,5061,10000
931700,-19996,-190171,"(AMETHYSTS, US << MARKET, 9998, 1, 931700)
(AMETHYSTS, US << MARKET, 9998, 1, 931700)","{""AMETHYSTS"": 16, ""STARFRUIT"": 7}",5263,5062,10000
931900,-10128,-200299,"(STARFRUIT, US << MARKET, 5064, 1, 931900)
(STARFRUIT, US << MARKET, 5064, 1, 931900)","{""AMETHYSTS"": 16, ""STARFRUIT"": 9}",5270,5065,9999
932200,-19996,-220295,"(AMETHYSTS, US << MARKET, 9998, 1, 932200)
(AMETHYSTS, US << MARKET, 9998, 1, 932200)","{""AMETHYSTS"": 18, ""STARFRUIT"": 9}",5281,5062,10001
932900,-5064,-225359,"(STARFRUIT, US << MARKET, 5064, 1, 932900)","{""AMETHYSTS"": 18, ""STARFRUIT"": 10}",5269,5061,10001
933000,-19996,-245355,"(AMETHYSTS, US << MARKET, 9998, 1, 933000)
(AMETHYSTS, US << MARKET, 9998, 1, 933000)","{""AMETHYSTS"": 20, ""STARFRUIT"": 10}",5195,5061,9997
933200,40231,-205124,"(AMETHYSTS, MARKET << US, 9998, 1, 933200)
(AMETHYSTS, MARKET << US, 9996, 1, 933200)
(STARFRUIT, MARKET << US, 5060, 1, 933200)
(STARFRUIT, MARKET << US, 5060, 1, 933200)
(STARFRUIT, MARKET << US, 5060, 1, 933200)
(STARFRUIT, MARKET << US, 5057, 1, 933200)","{""AMETHYSTS"": 18, ""STARFRUIT"": 6}",5170,5058,9997
933300,50006,-155118,"(AMETHYSTS, US << MARKET, 10002, 1, 933300)
(AMETHYSTS, MARKET << US, 10002, 1, 933300)
(AMETHYSTS, MARKET << US, 10002, 1, 933300)
(AMETHYSTS, MARKET << US, 10002, 1, 933300)
(AMETHYSTS, MARKET << US, 10002, 1, 933300)
(AMETHYSTS, MARKET << US, 10002, 1, 933300)
(AMETHYSTS, MARKET << US, 10002, 1, 933300)
(STARFRUIT, US << MARKET, 5063, 1, 933300)
(STARFRUIT, US << MARKET, 5063, 1, 933300)
(STARFRUIT, MARKET << US, 5061, 1, 933300)
(STARFRUIT, MARKET << US, 5061, 1, 933300)","{""AMETHYSTS"": 13, ""STARFRUIT"": 6}",5275,5059,10003
933400,20248,-134870,"(STARFRUIT, MARKET << US, 5062, 1, 933400)
(STARFRUIT, MARKET << US, 5062, 1, 933400)
(STARFRUIT, MARKET << US, 5062, 1, 933400)
(STARFRUIT, MARKET << US, 5062, 1, 933400)","{""AMETHYSTS"": 13, ""STARFRUIT"": 2}",5254,5062,10000
933500,-69965,-204835,"(AMETHYSTS, US << MARKET, 9995, 1, 933500)
(AMETHYSTS, US << MARKET, 9995, 1, 933500)
(AMETHYSTS, US << MARKET, 9995, 1, 933500)
(AMETHYSTS, US << MARKET, 9995, 1, 933500)
(AMETHYSTS, US << MARKET, 9995, 1, 933500)
(AMETHYSTS, US << MARKET, 9995, 1, 933500)
(AMETHYSTS, US << MARKET, 9995, 1, 933500)","{""AMETHYSTS"": 20, ""STARFRUIT"": 2}",5289,5062,10000
933900,10130,-194705,"(STARFRUIT, MARKET << US, 5065, 1, 933900)
(STARFRUIT, MARKET << US, 5065, 1, 933900)","{""AMETHYSTS"": 20, ""STARFRUIT"": 0}",5315,5061,10001
934000,160080,-34625,"(AMETHYSTS, MARKET << US, 10005, 1, 934000)
(AMETHYSTS, MARKET << US, 10005, 1, 934000)
(AMETHYSTS, MARKET << US, 10005, 1, 934000)
(AMETHYSTS, MARKET << US, 10005, 1, 934000)
(AMETHYSTS, MARKET << US, 10005, 1, 934000)
(AMETHYSTS, MARKET << US, 10005, 1, 934000)
(AMETHYSTS, MARKET << US, 10005, 1, 934000)
(AMETHYSTS, MARKET << US, 10005, 1, 934000)
(AMETHYSTS, MARKET << US, 10005, 1, 934000)
(AMETHYSTS, MARKET << US, 10005, 1, 934000)
(AMETHYSTS, MARKET << US, 10005, 1, 934000)
(AMETHYSTS, MARKET << US, 10005, 1, 934000)
(AMETHYSTS, MARKET << US, 10005, 1, 934000)
(AMETHYSTS, MARKET << US, 10005, 1, 934000)
(AMETHYSTS, MARKET << US, 10005, 1, 934000)
(AMETHYSTS, MARKET << US, 10005, 1, 934000)","{""AMETHYSTS"": 4, ""STARFRUIT"": 0}",5375,5060,10000
934300,-19996,-54621,"(AMETHYSTS, US << MARKET, 9998, 1, 934300)
(AMETHYSTS, US << MARKET, 9998, 1, 934300)","{""AMETHYSTS"": 6, ""STARFRUIT"": 0}",5361,5060,9997
934600,-10364,-64985,"(AMETHYSTS, MARKET << US, 9998, 1, 934600)
(AMETHYSTS, MARKET << US, 9998, 1, 934600)
(STARFRUIT, US << MARKET, 5060, 1, 934600)
(STARFRUIT, US << MARKET, 5060, 1, 934600)
(STARFRUIT, US << MARKET, 5060, 1, 934600)
(STARFRUIT, US << MARKET, 5060, 1, 934600)
(STARFRUIT, US << MARKET, 5060, 1, 934600)
(STARFRUIT, US << MARKET, 5060, 1, 934600)","{""AMETHYSTS"": 4, ""STARFRUIT"": 6}",5357,5059,9997
934700,-10116,-75101,"(STARFRUIT, US << MARKET, 5058, 1, 934700)
(STARFRUIT, US << MARKET, 5058, 1, 934700)","{""AMETHYSTS"": 4, ""STARFRUIT"": 8}",5355,5057,10000
934800,-5057,-80158,"(STARFRUIT, US << MARKET, 5057, 1, 934800)","{""AMETHYSTS"": 4, ""STARFRUIT"": 9}",5382,5060,10000
935100,-4943,-85101,"(AMETHYSTS, US << MARKET, 10004, 1, 935100)
(STARFRUIT, MARKET << US, 5061, 1, 935100)","{""AMETHYSTS"": 5, ""STARFRUIT"": 8}",5363,5058,10000
935200,-25053,-110154,"(AMETHYSTS, US << MARKET, 9998, 1, 935200)
(AMETHYSTS, US << MARKET, 9998, 1, 935200)
(STARFRUIT, US << MARKET, 5057, 1, 935200)","{""AMETHYSTS"": 7, ""STARFRUIT"": 9}",5322,5056,9996
935600,29892,-80262,"(AMETHYSTS, MARKET << US, 10005, 1, 935600)
(AMETHYSTS, MARKET << US, 10005, 1, 935600)
(AMETHYSTS, MARKET << US, 10005, 1, 935600)
(AMETHYSTS, MARKET << US, 10005, 1, 935600)
(STARFRUIT, US << MARKET, 5064, 1, 935600)
(STARFRUIT, US << MARKET, 5064, 1, 935600)","{""AMETHYSTS"": 3, ""STARFRUIT"": 11}",5412,5061,10001
935800,-80040,-160302,"(AMETHYSTS, US << MARKET, 10005, 1, 935800)
(AMETHYSTS, US << MARKET, 10005, 1, 935800)
(AMETHYSTS, US << MARKET, 10005, 1, 935800)
(AMETHYSTS, US << MARKET, 10005, 1, 935800)
(AMETHYSTS, US << MARKET, 10005, 1, 935800)
(AMETHYSTS, US << MARKET, 10005, 1, 935800)
(AMETHYSTS, US << MARKET, 10005, 1, 935800)
(AMETHYSTS, US << MARKET, 10005, 1, 935800)","{""AMETHYSTS"": 11, ""STARFRUIT"": 11}",5347,5058,10001
935900,-25046,-185348,"(AMETHYSTS, US << MARKET, 9995, 1, 935900)
(AMETHYSTS, US << MARKET, 9995, 1, 935900)
(STARFRUIT, US << MARKET, 5056, 1, 935900)","{""AMETHYSTS"": 13, ""STARFRUIT"": 12}",5348,5058,10000
936600,5062,-180286,"(STARFRUIT, MARKET << US, 5062, 1, 936600)","{""AMETHYSTS"": 13, ""STARFRUIT"": 11}",5363,5059,10000
936700,-19996,-200282,"(AMETHYSTS, US << MARKET, 9998, 1, 936700)
(AMETHYSTS, US << MARKET, 9998, 1, 936700)","{""AMETHYSTS"": 15, ""STARFRUIT"": 11}",5322,5059,9997
937000,5062,-195220,"(STARFRUIT, MARKET << US, 5062, 1, 937000)","{""AMETHYSTS"": 15, ""STARFRUIT"": 10}",5370,5062,9998
937200,-50124,-245344,"(AMETHYSTS, US << MARKET, 9996, 1, 937200)
(AMETHYSTS, US << MARKET, 9996, 1, 937200)
(AMETHYSTS, US << MARKET, 9996, 1, 937200)
(AMETHYSTS, US << MARKET, 9996, 1, 937200)
(STARFRUIT, US << MARKET, 5063, 1, 937200)
(STARFRUIT, US << MARKET, 5063, 1, 937200)
(STARFRUIT, US << MARKET, 5063, 1, 937200)
(STARFRUIT, US << MARKET, 5063, 1, 937200)
(STARFRUIT, MARKET << US, 5056, 1, 937200)
(STARFRUIT, MARKET << US, 5056, 1, 937200)","{""AMETHYSTS"": 19, ""STARFRUIT"": 12}",5364,5059,10000
937300,15171,-230173,"(STARFRUIT, MARKET << US, 5057, 1, 937300)
(STARFRUIT, MARKET << US, 5057, 1, 937300)
(STARFRUIT, MARKET << US, 5057, 1, 937300)","{""AMETHYSTS"": 19, ""STARFRUIT"": 9}",5331,5056,10000
937700,40220,-189953,"(AMETHYSTS, MARKET << US, 9996, 1, 937700)
(AMETHYSTS, MARKET << US, 9996, 1, 937700)
(STARFRUIT, MARKET << US, 5057, 1, 937700)
(STARFRUIT, MARKET << US, 5057, 1, 937700)
(STARFRUIT, MARKET << US, 5057, 1, 937700)
(STARFRUIT, MARKET << US, 5057, 1, 937700)","{""AMETHYSTS"": 17, ""STARFRUIT"": 5}",5296,5060,9997
937800,-20004,-209957,"(AMETHYSTS, US << MARKET, 10002, 1, 937800)
(AMETHYSTS, US << MARKET, 10002, 1, 937800)","{""AMETHYSTS"": 19, ""STARFRUIT"": 5}",5385,5057,10003
937900,9996,-199961,"(AMETHYSTS, MARKET << US, 9996, 1, 937900)","{""AMETHYSTS"": 18, ""STARFRUIT"": 5}",5334,5059,10000
938000,15051,-184910,"(AMETHYSTS, MARKET << US, 9996, 1, 938000)
(STARFRUIT, MARKET << US, 5055, 1, 938000)","{""AMETHYSTS"": 17, ""STARFRUIT"": 4}",5322,5058,10000
938200,25073,-159837,"(AMETHYSTS, MARKET << US, 10005, 1, 938200)
(AMETHYSTS, MARKET << US, 10005, 1, 938200)
(STARFRUIT, MARKET << US, 5063, 1, 938200)","{""AMETHYSTS"": 15, ""STARFRUIT"": 3}",5340,5059,10000
939100,20256,-139581,"(STARFRUIT, MARKET << US, 5064, 1, 939100)
(STARFRUIT, MARKET << US, 5064, 1, 939100)
(STARFRUIT, MARKET << US, 5064, 1, 939100)
(STARFRUIT, MARKET << US, 5064, 1, 939100)","{""AMETHYSTS"": 15, ""STARFRUIT"": -1}",5374,5060,10001
939200,-10236,-149817,"(AMETHYSTS, MARKET << US, 9996, 1, 939200)
(STARFRUIT, US << MARKET, 5058, 1, 939200)
(STARFRUIT, US << MARKET, 5058, 1, 939200)
(STARFRUIT, US << MARKET, 5058, 1, 939200)
(STARFRUIT, US << MARKET, 5058, 1, 939200)","{""AMETHYSTS"": 14, ""STARFRUIT"": 3}",5352,5061,9999
939600,20004,-129813,"(AMETHYSTS, MARKET << US, 10002, 1, 939600)
(AMETHYSTS, MARKET << US, 10002, 1, 939600)","{""AMETHYSTS"": 12, ""STARFRUIT"": 3}",5403,5060,10003
939700,-20004,-149817,"(AMETHYSTS, US << MARKET, 10002, 1, 939700)
(AMETHYSTS, US << MARKET, 10002, 1, 939700)","{""AMETHYSTS"": 14, ""STARFRUIT"": 3}",5405,5060,10003
939800,5061,-144756,"(STARFRUIT, MARKET << US, 5061, 1, 939800)","{""AMETHYSTS"": 14, ""STARFRUIT"": 2}",5358,5057,10000
940000,-10110,-154866,"(STARFRUIT, US << MARKET, 5055, 1, 940000)
(STARFRUIT, US << MARKET, 5055, 1, 940000)","{""AMETHYSTS"": 14, ""STARFRUIT"": 4}",5366,5058,10000
940500,-20126,-174992,"(AMETHYSTS, US << MARKET, 10002, 1, 940500)
(STARFRUIT, US << MARKET, 5062, 1, 940500)
(STARFRUIT, US << MARKET, 5062, 1, 940500)","{""AMETHYSTS"": 15, ""STARFRUIT"": 6}",5425,5062,10003
940800,-10002,-184994,"(AMETHYSTS, US << MARKET, 10002, 1, 940800)","{""AMETHYSTS"": 16, ""STARFRUIT"": 6}",5344,5059,9999
940900,-20248,-205242,"(STARFRUIT, US << MARKET, 5062, 1, 940900)
(STARFRUIT, US << MARKET, 5062, 1, 940900)
(STARFRUIT, US << MARKET, 5062, 1, 940900)
(STARFRUIT, US << MARKET, 5062, 1, 940900)","{""AMETHYSTS"": 16, ""STARFRUIT"": 10}",5332,5059,9999
941100,30336,-174906,"(STARFRUIT, MARKET << US, 5056, 1, 941100)
(STARFRUIT, MARKET << US, 5056, 1, 941100)
(STARFRUIT, MARKET << US, 5056, 1, 941100)
(STARFRUIT, MARKET << US, 5056, 1, 941100)
(STARFRUIT, MARKET << US, 5056, 1, 941100)
(STARFRUIT, MARKET << US, 5056, 1, 941100)","{""AMETHYSTS"": 16, ""STARFRUIT"": 4}",5282,5059,9997
941200,-29985,-204891,"(AMETHYSTS, US << MARKET, 9995, 1, 941200)
(AMETHYSTS, US << MARKET, 9995, 1, 941200)
(AMETHYSTS, US << MARKET, 9995, 1, 941200)","{""AMETHYSTS"": 19, ""STARFRUIT"": 4}",5345,5059,10000
941300,-15177,-220068,"(STARFRUIT, US << MARKET, 5059, 1, 941300)
(STARFRUIT, US << MARKET, 5059, 1, 941300)
(STARFRUIT, US << MARKET, 5059, 1, 941300)","{""AMETHYSTS"": 19, ""STARFRUIT"": 7}",5300,5058,9998
941700,-15168,-235236,"(STARFRUIT, US << MARKET, 5056, 1, 941700)
(STARFRUIT, US << MARKET, 5056, 1, 941700)
(STARFRUIT, US << MARKET, 5056, 1, 941700)
(STARFRUIT, US << MARKET, 5056, 1, 941700)
(STARFRUIT, MARKET << US, 5056, 1, 941700)","{""AMETHYSTS"": 19, ""STARFRUIT"": 10}",5295,5055,9999
942100,-5060,-240296,"(STARFRUIT, US << MARKET, 5060, 1, 942100)","{""AMETHYSTS"": 19, ""STARFRUIT"": 11}",5274,5057,9997
942600,120,-240176,"(AMETHYSTS, US << MARKET, 10004, 1, 942600)
(STARFRUIT, MARKET << US, 5062, 1, 942600)
(STARFRUIT, MARKET << US, 5062, 1, 942600)","{""AMETHYSTS"": 20, ""STARFRUIT"": 9}",5366,5058,10001
942700,0,-240176,,"{""AMETHYSTS"": 20, ""STARFRUIT"": 9}",5366,5058,10001
942800,30330,-209846,"(STARFRUIT, MARKET << US, 5055, 1, 942800)
(STARFRUIT, MARKET << US, 5055, 1, 942800)
(STARFRUIT, MARKET << US, 5055, 1, 942800)
(STARFRUIT, MARKET << US, 5055, 1, 942800)
(STARFRUIT, MARKET << US, 5055, 1, 942800)
(STARFRUIT, MARKET << US, 5055, 1, 942800)","{""AMETHYSTS"": 20, ""STARFRUIT"": 3}",5325,5057,10000
943400,-15180,-225026,"(STARFRUIT, US << MARKET, 5060, 1, 943400)
(STARFRUIT, US << MARKET, 5060, 1, 943400)
(STARFRUIT, US << MARKET, 5060, 1, 943400)","{""AMETHYSTS"": 20, ""STARFRUIT"": 6}",5340,5061,10000
943500,9998,-215028,"(AMETHYSTS, MARKET << US, 9998, 1, 943500)","{""AMETHYSTS"": 19, ""STARFRUIT"": 6}",5320,5058,10000
943800,5061,-209967,"(STARFRUIT, MARKET << US, 5061, 1, 943800)","{""AMETHYSTS"": 19, ""STARFRUIT"": 5}",5300,5061,9998
943900,-10112,-220079,"(STARFRUIT, US << MARKET, 5056, 1, 943900)
(STARFRUIT, US << MARKET, 5056, 1, 943900)","{""AMETHYSTS"": 19, ""STARFRUIT"": 7}",5334,5059,10000
944000,5056,-215023,"(STARFRUIT, MARKET << US, 5056, 1, 944000)","{""AMETHYSTS"": 19, ""STARFRUIT"": 6}",5331,5059,10000
944700,-20224,-235247,"(STARFRUIT, US << MARKET, 5056, 1, 944700)
(STARFRUIT, US << MARKET, 5056, 1, 944700)
(STARFRUIT, US << MARKET, 5056, 1, 944700)
(STARFRUIT, US << MARKET, 5056, 1, 944700)","{""AMETHYSTS"": 19, ""STARFRUIT"": 10}",5333,5058,10000
945000,29896,-205351,"(AMETHYSTS, MARKET << US, 10005, 1, 945000)
(AMETHYSTS, MARKET << US, 10005, 1, 945000)
(AMETHYSTS, MARKET << US, 10005, 1, 945000)
(AMETHYSTS, MARKET << US, 10005, 1, 945000)
(STARFRUIT, US << MARKET, 5062, 1, 945000)
(STARFRUIT, US << MARKET, 5062, 1, 945000)","{""AMETHYSTS"": 15, ""STARFRUIT"": 12}",5345,5058,10000
945100,-10002,-215353,"(AMETHYSTS, US << MARKET, 10002, 1, 945100)","{""AMETHYSTS"": 16, ""STARFRUIT"": 12}",5391,5058,10003
945400,-10002,-225355,"(AMETHYSTS, US << MARKET, 10002, 1, 945400)","{""AMETHYSTS"": 17, ""STARFRUIT"": 12}",5404,5059,10003
945900,24942,-200413,"(AMETHYSTS, US << MARKET, 9996, 1, 945900)
(AMETHYSTS, US << MARKET, 9996, 1, 945900)
(AMETHYSTS, MARKET << US, 9998, 1, 945900)
(AMETHYSTS, MARKET << US, 9998, 1, 945900)
(AMETHYSTS, MARKET << US, 9998, 1, 945900)
(AMETHYSTS, MARKET << US, 9998, 1, 945900)
(AMETHYSTS, MARKET << US, 9998, 1, 945900)
(STARFRUIT, US << MARKET, 5056, 1, 945900)","{""AMETHYSTS"": 14, ""STARFRUIT"": 13}",5312,5059,9997
946200,-5057,-205470,"(STARFRUIT, US << MARKET, 5057, 1, 946200)","{""AMETHYSTS"": 14, ""STARFRUIT"": 14}",5314,5056,10000
946300,-15171,-220641,"(STARFRUIT, US << MARKET, 5057, 1, 946300)
(STARFRUIT, US << MARKET, 5057, 1, 946300)
(STARFRUIT, US << MARKET, 5057, 1, 946300)
(STARFRUIT, US << MARKET, 5057, 1, 946300)
(STARFRUIT, MARKET << US, 5057, 1, 946300)","{""AMETHYSTS"": 14, ""STARFRUIT"": 17}",5379,5060,10000
946900,5063,-215578,"(STARFRUIT, MARKET << US, 5063, 1, 946900)","{""AMETHYSTS"": 14, ""STARFRUIT"": 16}",5366,5059,10000
947100,60474,-155104,"(AMETHYSTS, MARKET << US, 10005, 1, 947100)
(AMETHYSTS, MARKET << US, 10005, 1, 947100)
(STARFRUIT, MARKET << US, 5058, 1, 947100)
(STARFRUIT, MARKET << US, 5058, 1, 947100)
(STARFRUIT, MARKET << US, 5058, 1, 947100)
(STARFRUIT, MARKET << US, 5058, 1, 947100)
(STARFRUIT, MARKET << US, 5058, 1, 947100)
(STARFRUIT, MARKET << US, 5058, 1, 947100)
(STARFRUIT, MARKET << US, 5058, 1, 947100)
(STARFRUIT, MARKET << US, 5058, 1, 947100)","{""AMETHYSTS"": 12, ""STARFRUIT"": 8}",5352,5057,10000
947400,-5057,-160161,"(STARFRUIT, US << MARKET, 5057, 1, 947400)","{""AMETHYSTS"": 12, ""STARFRUIT"": 9}",5379,5060,10000
947600,25072,-135089,"(AMETHYSTS, MARKET << US, 10004, 1, 947600)
(AMETHYSTS, MARKET << US, 10004, 1, 947600)
(STARFRUIT, MARKET << US, 5064, 1, 947600)","{""AMETHYSTS"": 10, ""STARFRUIT"": 8}",5391,5060,10000
947900,29994,-105095,"(AMETHYSTS, MARKET << US, 9998, 1, 947900)
(AMETHYSTS, MARKET << US, 9998, 1, 947900)
(AMETHYSTS, MARKET << US, 9998, 1, 947900)","{""AMETHYSTS"": 7, ""STARFRUIT"": 8}",5392,5060,10001
948200,-30134,-135229,"(AMETHYSTS, US << MARKET, 10004, 1, 948200)
(AMETHYSTS, US << MARKET, 10004, 1, 948200)
(STARFRUIT, US << MARKET, 5063, 1, 948200)
(STARFRUIT, US << MARKET, 5063, 1, 948200)","{""AMETHYSTS"": 9, ""STARFRUIT"": 10}",5371,5060,10000
948400,25048,-110181,"(AMETHYSTS, MARKET << US, 9996, 1, 948400)
(AMETHYSTS, MARKET << US, 9996, 1, 948400)
(STARFRUIT, MARKET << US, 5056, 1, 948400)","{""AMETHYSTS"": 7, ""STARFRUIT"": 9}",5329,5059,9997
948500,30336,-79845,"(STARFRUIT, MARKET << US, 5056, 1, 948500)
(STARFRUIT, MARKET << US, 5056, 1, 948500)
(STARFRUIT, MARKET << US, 5056, 1, 948500)
(STARFRUIT, MARKET << US, 5056, 1, 948500)
(STARFRUIT, MARKET << US, 5056, 1, 948500)
(STARFRUIT, MARKET << US, 5056, 1, 948500)","{""AMETHYSTS"": 7, ""STARFRUIT"": 3}",5336,5058,10001
948900,20228,-59617,"(STARFRUIT, MARKET << US, 5057, 1, 948900)
(STARFRUIT, MARKET << US, 5057, 1, 948900)
(STARFRUIT, MARKET << US, 5057, 1, 948900)
(STARFRUIT, MARKET << US, 5057, 1, 948900)","{""AMETHYSTS"": 7, ""STARFRUIT"": -1}",5327,5056,10000
949300,246,-59371,"(AMETHYSTS, US << MARKET, 10005, 1, 949300)
(AMETHYSTS, US << MARKET, 10005, 1, 949300)
(STARFRUIT, MARKET << US, 5064, 1, 949300)
(STARFRUIT, MARKET << US, 5064, 1, 949300)
(STARFRUIT, MARKET << US, 5064, 1, 949300)
(STARFRUIT, MARKET << US, 5064, 1, 949300)","{""AMETHYSTS"": 9, ""STARFRUIT"": -5}",5314,5063,10000
949800,15068,-44303,"(AMETHYSTS, US << MARKET, 10004, 1, 949800)
(AMETHYSTS, MARKET << US, 10004, 1, 949800)
(AMETHYSTS, MARKET << US, 10004, 1, 949800)
(STARFRUIT, US << MARKET, 5064, 1, 949800)
(STARFRUIT, MARKET << US, 5064, 1, 949800)
(STARFRUIT, MARKET << US, 5064, 1, 949800)","{""AMETHYSTS"": 8, ""STARFRUIT"": -6}",5339,5061,10001
950100,30136,-14167,"(AMETHYSTS, MARKET << US, 10004, 1, 950100)
(AMETHYSTS, MARKET << US, 10004, 1, 950100)
(STARFRUIT, MARKET << US, 5064, 1, 950100)
(STARFRUIT, MARKET << US, 5064, 1, 950100)","{""AMETHYSTS"": 6, ""STARFRUIT"": -8}",5345,5061,10000
950500,-64966,-79133,"(AMETHYSTS, US << MARKET, 10004, 1, 950500)
(AMETHYSTS, US << MARKET, 10004, 1, 950500)
(AMETHYSTS, US << MARKET, 10004, 1, 950500)
(AMETHYSTS, US << MARKET, 10004, 1, 950500)
(AMETHYSTS, US << MARKET, 10004, 1, 950500)
(AMETHYSTS, US << MARKET, 10004, 1, 950500)
(AMETHYSTS, US << MARKET, 10004, 1, 950500)
(AMETHYSTS, US << MARKET, 10004, 1, 950500)
(AMETHYSTS, US << MARKET, 10004, 1, 950500)
(AMETHYSTS, MARKET << US, 10004, 1, 950500)
(AMETHYSTS, MARKET << US, 10004, 1, 950500)
(STARFRUIT, MARKET << US, 5062, 1, 950500)","{""AMETHYSTS"": 13, ""STARFRUIT"": -9}",5309,5062,10000
950700,25058,-54075,"(AMETHYSTS, MARKET << US, 9998, 1, 950700)
(AMETHYSTS, MARKET << US, 9998, 1, 950700)
(STARFRUIT, MARKET << US, 5062, 1, 950700)","{""AMETHYSTS"": 11, ""STARFRUIT"": -10}",5335,5059,10000
951200,-100208,-154283,"(AMETHYSTS, US << MARKET, 9998, 1, 951200)
(AMETHYSTS, US << MARKET, 9998, 1, 951200)
(AMETHYSTS, US << MARKET, 9998, 1, 951200)
(AMETHYSTS, US << MARKET, 9998, 1, 951200)
(AMETHYSTS, US << MARKET, 9998, 1, 951200)
(AMETHYSTS, US << MARKET, 9998, 1, 951200)
(AMETHYSTS, US << MARKET, 9998, 1, 951200)
(AMETHYSTS, US << MARKET, 9998, 1, 951200)
(STARFRUIT, US << MARKET, 5056, 1, 951200)
(STARFRUIT, US << MARKET, 5056, 1, 951200)
(STARFRUIT, US << MARKET, 5056, 1, 951200)
(STARFRUIT, US << MARKET, 5056, 1, 951200)","{""AMETHYSTS"": 19, ""STARFRUIT"": -6}",5306,5059,9997
951700,-10002,-164285,"(AMETHYSTS, US << MARKET, 10002, 1, 951700)","{""AMETHYSTS"": 20, ""STARFRUIT"": -6}",5339,5056,9998
951800,25070,-139215,"(AMETHYSTS, MARKET << US, 10005, 1, 951800)
(AMETHYSTS, MARKET << US, 10005, 1, 951800)
(STARFRUIT, MARKET << US, 5060, 1, 951800)","{""AMETHYSTS"": 18, ""STARFRUIT"": -7}",5393,5056,10000
951900,5055,-134160,"(STARFRUIT, MARKET << US, 5055, 1, 951900)","{""AMETHYSTS"": 18, ""STARFRUIT"": -8}",5408,5054,10000
952000,0,-134160,,"{""AMETHYSTS"": 18, ""STARFRUIT"": -8}",5386,5059,10001
952600,5058,-129102,"(STARFRUIT, MARKET << US, 5058, 1, 952600)","{""AMETHYSTS"": 18, ""STARFRUIT"": -9}",5376,5054,9998
952800,5054,-124048,"(STARFRUIT, MARKET << US, 5054, 1, 952800)","{""AMETHYSTS"": 18, ""STARFRUIT"": -10}",5422,5053,10000
953000,-10002,-134050,"(AMETHYSTS, US << MARKET, 10002, 1, 953000)","{""AMETHYSTS"": 19, ""STARFRUIT"": -10}",5457,5055,10003
953100,0,-134050,,"{""AMETHYSTS"": 19, ""STARFRUIT"": -10}",5400,5055,10000
953300,0,-134050,,"{""AMETHYSTS"": 19, ""STARFRUIT"": -10}",5430,5052,10000
953400,-10004,-144054,"(AMETHYSTS, US << MARKET, 10004, 1, 953400)","{""AMETHYSTS"": 20, ""STARFRUIT"": -10}",5386,5056,10000
953500,-30466,-174520,"(AMETHYSTS, MARKET << US, 9998, 1, 953500)
(STARFRUIT, US << MARKET, 5058, 1, 953500)
(STARFRUIT, US << MARKET, 5058, 1, 953500)
(STARFRUIT, US << MARKET, 5058, 1, 953500)
(STARFRUIT, US << MARKET, 5058, 1, 953500)
(STARFRUIT, US << MARKET, 5058, 1, 953500)
(STARFRUIT, US << MARKET, 5058, 1, 953500)
(STARFRUIT, US << MARKET, 5058, 1, 953500)
(STARFRUIT, US << MARKET, 5058, 1, 953500)","{""AMETHYSTS"": 19, ""STARFRUIT"": -2}",5305,5059,9997
953600,9998,-164522,"(AMETHYSTS, MARKET << US, 9998, 1, 953600)","{""AMETHYSTS"": 18, ""STARFRUIT"": -2}",5384,5056,10001
953800,-20216,-184738,"(STARFRUIT, US << MARKET, 5054, 1, 953800)
(STARFRUIT, US << MARKET, 5054, 1, 953800)
(STARFRUIT, US << MARKET, 5054, 1, 953800)
(STARFRUIT, US << MARKET, 5054, 1, 953800)","{""AMETHYSTS"": 18, ""STARFRUIT"": 2}",5376,5057,10000
953900,-40198,-224936,"(AMETHYSTS, US << MARKET, 9995, 1, 953900)
(AMETHYSTS, US << MARKET, 9995, 1, 953900)
(STARFRUIT, US << MARKET, 5052, 1, 953900)
(STARFRUIT, US << MARKET, 5052, 1, 953900)
(STARFRUIT, US << MARKET, 5052, 1, 953900)
(STARFRUIT, US << MARKET, 5052, 1, 953900)","{""AMETHYSTS"": 20, ""STARFRUIT"": 6}",5354,5055,9998
954300,-10118,-235054,"(STARFRUIT, US << MARKET, 5059, 1, 954300)
(STARFRUIT, US << MARKET, 5059, 1, 954300)","{""AMETHYSTS"": 20, ""STARFRUIT"": 8}",5478,5059,10003
955200,-20228,-255282,"(STARFRUIT, US << MARKET, 5057, 1, 955200)
(STARFRUIT, US << MARKET, 5057, 1, 955200)
(STARFRUIT, US << MARKET, 5057, 1, 955200)
(STARFRUIT, US << MARKET, 5057, 1, 955200)","{""AMETHYSTS"": 20, ""STARFRUIT"": 12}",5374,5058,9998
955600,10114,-245168,"(STARFRUIT, MARKET << US, 5057, 1, 955600)
(STARFRUIT, MARKET << US, 5057, 1, 955600)","{""AMETHYSTS"": 20, ""STARFRUIT"": 10}",5362,5055,9999
955800,5060,-240108,"(STARFRUIT, MARKET << US, 5060, 1, 955800)","{""AMETHYSTS"": 20, ""STARFRUIT"": 9}",5432,5060,10000
956100,10116,-229992,"(STARFRUIT, MARKET << US, 5058, 1, 956100)
(STARFRUIT, MARKET << US, 5058, 1, 956100)","{""AMETHYSTS"": 20, ""STARFRUIT"": 7}",5421,5059,10000
956500,10118,-219874,"(STARFRUIT, MARKET << US, 5059, 1, 956500)
(STARFRUIT, MARKET << US, 5059, 1, 956500)","{""AMETHYSTS"": 20, ""STARFRUIT"": 5}",5361,5055,9998
956700,19996,-199878,"(AMETHYSTS, MARKET << US, 9998, 1, 956700)
(AMETHYSTS, MARKET << US, 9998, 1, 956700)","{""AMETHYSTS"": 18, ""STARFRUIT"": 5}",5343,5055,9997
957600,-30112,-229990,"(AMETHYSTS, US << MARKET, 9998, 1, 957600)
(AMETHYSTS, US << MARKET, 9998, 1, 957600)
(STARFRUIT, US << MARKET, 5058, 1, 957600)
(STARFRUIT, US << MARKET, 5058, 1, 957600)","{""AMETHYSTS"": 20, ""STARFRUIT"": 7}",5336,5058,9996
957800,40008,-189982,"(AMETHYSTS, MARKET << US, 10002, 1, 957800)
(AMETHYSTS, MARKET << US, 10002, 1, 957800)
(AMETHYSTS, MARKET << US, 10002, 1, 957800)
(AMETHYSTS, MARKET << US, 10002, 1, 957800)","{""AMETHYSTS"": 16, ""STARFRUIT"": 7}",5380,5054,9999
958000,-25048,-215030,"(AMETHYSTS, US << MARKET, 9998, 1, 958000)
(AMETHYSTS, US << MARKET, 9998, 1, 958000)
(STARFRUIT, US << MARKET, 5052, 1, 958000)","{""AMETHYSTS"": 18, ""STARFRUIT"": 8}",5428,5055,10001
958100,-20236,-235266,"(STARFRUIT, US << MARKET, 5059, 1, 958100)
(STARFRUIT, US << MARKET, 5059, 1, 958100)
(STARFRUIT, US << MARKET, 5059, 1, 958100)
(STARFRUIT, US << MARKET, 5059, 1, 958100)","{""AMETHYSTS"": 18, ""STARFRUIT"": 12}",5436,5057,10001
958400,4940,-230326,"(AMETHYSTS, MARKET << US, 9998, 1, 958400)
(STARFRUIT, US << MARKET, 5058, 1, 958400)","{""AMETHYSTS"": 17, ""STARFRUIT"": 13}",5338,5055,9997
958500,15049,-215277,"(AMETHYSTS, MARKET << US, 9996, 1, 958500)
(STARFRUIT, MARKET << US, 5053, 1, 958500)","{""AMETHYSTS"": 16, ""STARFRUIT"": 12}",5395,5056,10000
958700,25068,-190209,"(AMETHYSTS, MARKET << US, 10004, 1, 958700)
(AMETHYSTS, MARKET << US, 10004, 1, 958700)
(STARFRUIT, MARKET << US, 5060, 1, 958700)","{""AMETHYSTS"": 14, ""STARFRUIT"": 11}",5421,5056,10001
959300,-15057,-205266,"(AMETHYSTS, US << MARKET, 10004, 1, 959300)
(STARFRUIT, US << MARKET, 5053, 1, 959300)","{""AMETHYSTS"": 15, ""STARFRUIT"": 12}",5409,5055,10001
960100,5059,-200207,"(STARFRUIT, MARKET << US, 5059, 1, 960100)","{""AMETHYSTS"": 15, ""STARFRUIT"": 11}",5442,5059,10000
960200,-20232,-220439,"(STARFRUIT, US << MARKET, 5058, 1, 960200)
(STARFRUIT, US << MARKET, 5058, 1, 960200)
(STARFRUIT, US << MARKET, 5058, 1, 960200)
(STARFRUIT, US << MARKET, 5058, 1, 960200)","{""AMETHYSTS"": 15, ""STARFRUIT"": 15}",5341,5055,9997
960400,-10002,-230441,"(AMETHYSTS, US << MARKET, 10002, 1, 960400)","{""AMETHYSTS"": 16, ""STARFRUIT"": 15}",5477,5058,10003
960600,-35187,-265628,"(AMETHYSTS, US << MARKET, 10005, 1, 960600)
(AMETHYSTS, US << MARKET, 10005, 1, 960600)
(STARFRUIT, US << MARKET, 5059, 1, 960600)
(STARFRUIT, US << MARKET, 5059, 1, 960600)
(STARFRUIT, US << MARKET, 5059, 1, 960600)","{""AMETHYSTS"": 18, ""STARFRUIT"": 18}",5380,5056,10000
961000,-10110,-275738,"(STARFRUIT, US << MARKET, 5055, 1, 961000)
(STARFRUIT, US << MARKET, 5055, 1, 961000)","{""AMETHYSTS"": 18, ""STARFRUIT"": 20}",5422,5058,10000
961100,59970,-215768,"(AMETHYSTS, MARKET << US, 9995, 1, 961100)
(AMETHYSTS, MARKET << US, 9995, 1, 961100)
(AMETHYSTS, MARKET << US, 9995, 1, 961100)
(AMETHYSTS, MARKET << US, 9995, 1, 961100)
(AMETHYSTS, MARKET << US, 9995, 1, 961100)
(AMETHYSTS, MARKET << US, 9995, 1, 961100)","{""AMETHYSTS"": 12, ""STARFRUIT"": 20}",5304,5056,9996
961400,20022,-195746,"(AMETHYSTS, US << MARKET, 10002, 1, 961400)
(AMETHYSTS, US << MARKET, 10002, 1, 961400)
(AMETHYSTS, US << MARKET, 10002, 1, 961400)
(AMETHYSTS, US << MARKET, 10002, 1, 961400)
(AMETHYSTS, MARKET << US, 10005, 1, 961400)
(AMETHYSTS, MARKET << US, 10005, 1, 961400)
(AMETHYSTS, MARKET << US, 10005, 1, 961400)
(AMETHYSTS, MARKET << US, 10005, 1, 961400)
(AMETHYSTS, MARKET << US, 10005, 1, 961400)
(AMETHYSTS, MARKET << US, 10005, 1, 961400)","{""AMETHYSTS"": 10, ""STARFRUIT"": 20}",5384,5055,10003
961500,-10002,-205748,"(AMETHYSTS, US << MARKET, 10002, 1, 961500)","{""AMETHYSTS"": 11, ""STARFRUIT"": 20}",5465,5059,10003
961600,5059,-200689,"(STARFRUIT, MARKET << US, 5059, 1, 961600)","{""AMETHYSTS"": 11, ""STARFRUIT"": 19}",5399,5059,9997
961700,9998,-190691,"(AMETHYSTS, MARKET << US, 9998, 1, 961700)","{""AMETHYSTS"": 10, ""STARFRUIT"": 19}",5314,5055,9996
962300,-65047,-255738,"(AMETHYSTS, US << MARKET, 9998, 1, 962300)
(AMETHYSTS, US << MARKET, 9998, 1, 962300)
(AMETHYSTS, US << MARKET, 9998, 1, 962300)
(AMETHYSTS, US << MARKET, 9998, 1, 962300)
(AMETHYSTS, US << MARKET, 9998, 1, 962300)
(AMETHYSTS, US << MARKET, 9998, 1, 962300)
(STARFRUIT, US << MARKET, 5059, 1, 962300)","{""AMETHYSTS"": 16, ""STARFRUIT"": 20}",5398,5056,10001
962600,-10005,-265743,"(AMETHYSTS, US << MARKET, 10005, 1, 962600)","{""AMETHYSTS"": 17, ""STARFRUIT"": 20}",5377,5056,10000
962800,15048,-250695,"(AMETHYSTS, MARKET << US, 9996, 1, 962800)
(STARFRUIT, MARKET << US, 5052, 1, 962800)","{""AMETHYSTS"": 16, ""STARFRUIT"": 19}",5350,5055,10000
962900,50092,-200603,"(AMETHYSTS, US << MARKET, 9998, 1, 962900)
(AMETHYSTS, US << MARKET, 9998, 1, 962900)
(AMETHYSTS, MARKET << US, 9998, 1, 962900)
(AMETHYSTS, MARKET << US, 9998, 1, 962900)
(AMETHYSTS, MARKET << US, 9998, 1, 962900)
(AMETHYSTS, MARKET << US, 9998, 1, 962900)
(AMETHYSTS, MARKET << US, 9996, 1, 962900)
(AMETHYSTS, MARKET << US, 9996, 1, 962900)
(STARFRUIT, MARKET << US, 5052, 1, 962900)
(STARFRUIT, MARKET << US, 5052, 1, 962900)","{""AMETHYSTS"": 12, ""STARFRUIT"": 17}",5296,5055,9997
963300,-10112,-210715,"(STARFRUIT, US << MARKET, 5056, 1, 963300)
(STARFRUIT, US << MARKET, 5056, 1, 963300)","{""AMETHYSTS"": 12, ""STARFRUIT"": 19}",5275,5054,9997
963400,19996,-190719,"(AMETHYSTS, MARKET << US, 9998, 1, 963400)
(AMETHYSTS, MARKET << US, 9998, 1, 963400)","{""AMETHYSTS"": 10, ""STARFRUIT"": 19}",5374,5057,10001
964500,-5060,-195779,"(STARFRUIT, US << MARKET, 5060, 1, 964500)","{""AMETHYSTS"": 10, ""STARFRUIT"": 20}",5341,5056,10000
964800,60012,-135767,"(AMETHYSTS, MARKET << US, 10002, 1, 964800)
(AMETHYSTS, MARKET << US, 10002, 1, 964800)
(AMETHYSTS, MARKET << US, 10002, 1, 964800)
(AMETHYSTS, MARKET << US, 10002, 1, 964800)
(AMETHYSTS, MARKET << US, 10002, 1, 964800)
(AMETHYSTS, MARKET << US, 10002, 1, 964800)","{""AMETHYSTS"": 4, ""STARFRUIT"": 20}",5345,5056,9998
965800,39992,-95775,"(AMETHYSTS, MARKET << US, 9998, 1, 965800)
(AMETHYSTS, MARKET << US, 9998, 1, 965800)
(AMETHYSTS, MARKET << US, 9998, 1, 965800)
(AMETHYSTS, MARKET << US, 9998, 1, 965800)","{""AMETHYSTS"": 0, ""STARFRUIT"": 20}",5365,5057,10001
966100,20004,-75771,"(AMETHYSTS, MARKET << US, 10002, 1, 966100)
(AMETHYSTS, MARKET << US, 10002, 1, 966100)","{""AMETHYSTS"": -2, ""STARFRUIT"": 20}",5403,5059,10003
966300,-10002,-85773,"(AMETHYSTS, US << MARKET, 10002, 1, 966300)","{""AMETHYSTS"": -1, ""STARFRUIT"": 20}",5364,5057,10003
966900,9998,-75775,"(AMETHYSTS, MARKET << US, 9998, 1, 966900)","{""AMETHYSTS"": -2, ""STARFRUIT"": 20}",5371,5057,9997
967000,0,-75775,,"{""AMETHYSTS"": -2, ""STARFRUIT"": 20}",5429,5060,9998
967500,0,-75775,,"{""AMETHYSTS"": -2, ""STARFRUIT"": 20}",5445,5061,10000
967700,20008,-55767,"(AMETHYSTS, MARKET << US, 10004, 1, 967700)
(AMETHYSTS, MARKET << US, 10004, 1, 967700)","{""AMETHYSTS"": -4, ""STARFRUIT"": 20}",5373,5057,10000
967900,5056,-50711,"(STARFRUIT, MARKET << US, 5056, 1, 967900)","{""AMETHYSTS"": -4, ""STARFRUIT"": 19}",5334,5055,10000
968100,10120,-40591,"(STARFRUIT, MARKET << US, 5060, 1, 968100)
(STARFRUIT, MARKET << US, 5060, 1, 968100)","{""AMETHYSTS"": -4, ""STARFRUIT"": 17}",5446,5061,10000
968400,5061,-35530,"(STARFRUIT, MARKET << US, 5061, 1, 968400)","{""AMETHYSTS"": -4, ""STARFRUIT"": 16}",5446,5061,10000
968500,-30132,-65662,"(AMETHYSTS, US << MARKET, 10004, 1, 968500)
(AMETHYSTS, US << MARKET, 10004, 1, 968500)
(STARFRUIT, US << MARKET, 5062, 1, 968500)
(STARFRUIT, US << MARKET, 5062, 1, 968500)","{""AMETHYSTS"": -2, ""STARFRUIT"": 18}",5398,5059,10001
968600,140070,74408,"(AMETHYSTS, MARKET << US, 10005, 1, 968600)
(AMETHYSTS, MARKET << US, 10005, 1, 968600)
(AMETHYSTS, MARKET << US, 10005, 1, 968600)
(AMETHYSTS, MARKET << US, 10005, 1, 968600)
(AMETHYSTS, MARKET << US, 10005, 1, 968600)
(AMETHYSTS, MARKET << US, 10005, 1, 968600)
(AMETHYSTS, MARKET << US, 10005, 1, 968600)
(AMETHYSTS, MARKET << US, 10005, 1, 968600)
(AMETHYSTS, MARKET << US, 10005, 1, 968600)
(AMETHYSTS, MARKET << US, 10005, 1, 968600)
(AMETHYSTS, MARKET << US, 10005, 1, 968600)
(AMETHYSTS, MARKET << US, 10005, 1, 968600)
(AMETHYSTS, MARKET << US, 10005, 1, 968600)
(AMETHYSTS, MARKET << US, 10005, 1, 968600)","{""AMETHYSTS"": -16, ""STARFRUIT"": 18}",5454,5059,10001
968900,9998,84406,"(AMETHYSTS, MARKET << US, 9998, 1, 968900)","{""AMETHYSTS"": -17, ""STARFRUIT"": 18}",5518,5058,9996
969000,4941,89347,"(AMETHYSTS, MARKET << US, 9996, 1, 969000)
(STARFRUIT, US << MARKET, 5055, 1, 969000)","{""AMETHYSTS"": -18, ""STARFRUIT"": 19}",5449,5058,10000
969300,20008,109355,"(AMETHYSTS, MARKET << US, 10004, 1, 969300)
(AMETHYSTS, MARKET << US, 10004, 1, 969300)","{""AMETHYSTS"": -20, ""STARFRUIT"": 19}",5457,5058,10000
969500,-59988,49367,"(AMETHYSTS, US << MARKET, 9998, 1, 969500)
(AMETHYSTS, US << MARKET, 9998, 1, 969500)
(AMETHYSTS, US << MARKET, 9998, 1, 969500)
(AMETHYSTS, US << MARKET, 9998, 1, 969500)
(AMETHYSTS, US << MARKET, 9998, 1, 969500)
(AMETHYSTS, US << MARKET, 9998, 1, 969500)","{""AMETHYSTS"": -14, ""STARFRUIT"": 19}",5511,5058,9997
969700,54964,104331,"(AMETHYSTS, MARKET << US, 10004, 1, 969700)
(AMETHYSTS, MARKET << US, 10004, 1, 969700)
(AMETHYSTS, MARKET << US, 10004, 1, 969700)
(AMETHYSTS, MARKET << US, 10004, 1, 969700)
(AMETHYSTS, MARKET << US, 10004, 1, 969700)
(AMETHYSTS, MARKET << US, 10004, 1, 969700)
(STARFRUIT, US << MARKET, 5060, 1, 969700)","{""AMETHYSTS"": -20, ""STARFRUIT"": 20}",5531,5060,10000
970300,0,104331,,"{""AMETHYSTS"": -20, ""STARFRUIT"": 20}",5431,5055,10000
970400,0,104331,,"{""AMETHYSTS"": -20, ""STARFRUIT"": 20}",5511,5059,10000
971100,-20008,84323,"(AMETHYSTS, US << MARKET, 10004, 1, 971100)
(AMETHYSTS, US << MARKET, 10004, 1, 971100)","{""AMETHYSTS"": -18, ""STARFRUIT"": 20}",5487,5060,10002
971500,25305,109628,"(STARFRUIT, MARKET << US, 5061, 1, 971500)
(STARFRUIT, MARKET << US, 5061, 1, 971500)
(STARFRUIT, MARKET << US, 5061, 1, 971500)
(STARFRUIT, MARKET << US, 5061, 1, 971500)
(STARFRUIT, MARKET << US, 5061, 1, 971500)","{""AMETHYSTS"": -18, ""STARFRUIT"": 15}",5558,5062,10000
971600,20010,129638,"(AMETHYSTS, MARKET << US, 10005, 1, 971600)
(AMETHYSTS, MARKET << US, 10005, 1, 971600)","{""AMETHYSTS"": -20, ""STARFRUIT"": 15}",5463,5059,10003
972200,15177,144815,"(STARFRUIT, MARKET << US, 5059, 1, 972200)
(STARFRUIT, MARKET << US, 5059, 1, 972200)
(STARFRUIT, MARKET << US, 5059, 1, 972200)","{""AMETHYSTS"": -20, ""STARFRUIT"": 12}",5547,5061,10000
972300,122,144937,"(AMETHYSTS, US << MARKET, 10004, 1, 972300)
(STARFRUIT, MARKET << US, 5063, 1, 972300)
(STARFRUIT, MARKET << US, 5063, 1, 972300)","{""AMETHYSTS"": -19, ""STARFRUIT"": 10}",5480,5060,10003
972900,-59988,84949,"(AMETHYSTS, US << MARKET, 9998, 1, 972900)
(AMETHYSTS, US << MARKET, 9998, 1, 972900)
(AMETHYSTS, US << MARKET, 9998, 1, 972900)
(AMETHYSTS, US << MARKET, 9998, 1, 972900)
(AMETHYSTS, US << MARKET, 9998, 1, 972900)
(AMETHYSTS, US << MARKET, 9998, 1, 972900)","{""AMETHYSTS"": -13, ""STARFRUIT"": 10}",5546,5061,10001
973100,-10114,74835,"(STARFRUIT, US << MARKET, 5057, 1, 973100)
(STARFRUIT, US << MARKET, 5057, 1, 973100)
(STARFRUIT, US << MARKET, 5057, 1, 973100)
(STARFRUIT, US << MARKET, 5057, 1, 973100)
(STARFRUIT, MARKET << US, 5057, 1, 973100)
(STARFRUIT, MARKET << US, 5057, 1, 973100)","{""AMETHYSTS"": -13, ""STARFRUIT"": 12}",5507,5056,10000
973900,-5055,69780,"(STARFRUIT, US << MARKET, 5055, 1, 973900)","{""AMETHYSTS"": -13, ""STARFRUIT"": 13}",5560,5057,9997
974000,-29870,39910,"(AMETHYSTS, US << MARKET, 9995, 1, 974000)
(AMETHYSTS, US << MARKET, 9995, 1, 974000)
(AMETHYSTS, US << MARKET, 9995, 1, 974000)
(AMETHYSTS, US << MARKET, 9995, 1, 974000)
(STARFRUIT, MARKET << US, 5055, 1, 974000)
(STARFRUIT, MARKET << US, 5055, 1, 974000)","{""AMETHYSTS"": -9, ""STARFRUIT"": 11}",5548,5058,10000
974400,5054,44964,"(STARFRUIT, MARKET << US, 5054, 1, 974400)","{""AMETHYSTS"": -9, ""STARFRUIT"": 10}",5534,5057,10000
974500,-5059,39905,"(STARFRUIT, US << MARKET, 5059, 1, 974500)","{""AMETHYSTS"": -9, ""STARFRUIT"": 11}",5556,5060,10001
974700,34933,74838,"(AMETHYSTS, MARKET << US, 9998, 1, 974700)
(AMETHYSTS, MARKET << US, 9998, 1, 974700)
(AMETHYSTS, MARKET << US, 9998, 1, 974700)
(AMETHYSTS, MARKET << US, 9998, 1, 974700)
(STARFRUIT, US << MARKET, 5059, 1, 974700)","{""AMETHYSTS"": -13, ""STARFRUIT"": 12}",5585,5059,9997
974800,-30006,44832,"(AMETHYSTS, US << MARKET, 10002, 1, 974800)
(AMETHYSTS, US << MARKET, 10002, 1, 974800)
(AMETHYSTS, US << MARKET, 10002, 1, 974800)","{""AMETHYSTS"": -10, ""STARFRUIT"": 12}",5486,5057,10003
975000,-5054,39778,"(STARFRUIT, US << MARKET, 5054, 1, 975000)","{""AMETHYSTS"": -10, ""STARFRUIT"": 13}",5506,5056,10000
975100,-40008,-230,"(AMETHYSTS, US << MARKET, 10002, 1, 975100)
(AMETHYSTS, US << MARKET, 10002, 1, 975100)
(AMETHYSTS, US << MARKET, 10002, 1, 975100)
(AMETHYSTS, US << MARKET, 10002, 1, 975100)","{""AMETHYSTS"": -6, ""STARFRUIT"": 13}",5493,5057,10003
975300,135080,134850,"(AMETHYSTS, MARKET << US, 10002, 1, 975300)
(AMETHYSTS, MARKET << US, 10002, 1, 975300)
(AMETHYSTS, MARKET << US, 10002, 1, 975300)
(AMETHYSTS, MARKET << US, 10002, 1, 975300)
(AMETHYSTS, MARKET << US, 10002, 1, 975300)
(AMETHYSTS, MARKET << US, 10002, 1, 975300)
(AMETHYSTS, MARKET << US, 10002, 1, 975300)
(AMETHYSTS, MARKET << US, 10002, 1, 975300)
(AMETHYSTS, MARKET << US, 10002, 1, 975300)
(AMETHYSTS, MARKET << US, 10002, 1, 975300)
(AMETHYSTS, MARKET << US, 10002, 1, 975300)
(AMETHYSTS, MARKET << US, 10002, 1, 975300)
(AMETHYSTS, MARKET << US, 10002, 1, 975300)
(STARFRUIT, MARKET << US, 5054, 1, 975300)","{""AMETHYSTS"": -19, ""STARFRUIT"": 12}",5553,5057,9999
975400,-5059,129791,"(STARFRUIT, US << MARKET, 5059, 1, 975400)","{""AMETHYSTS"": -19, ""STARFRUIT"": 13}",5577,5059,9999
975900,-5055,124736,"(STARFRUIT, US << MARKET, 5055, 1, 975900)","{""AMETHYSTS"": -19, ""STARFRUIT"": 14}",5586,5058,9998
976200,25275,150011,"(STARFRUIT, MARKET << US, 5055, 1, 976200)
(STARFRUIT, MARKET << US, 5055, 1, 976200)
(STARFRUIT, MARKET << US, 5055, 1, 976200)
(STARFRUIT, MARKET << US, 5055, 1, 976200)
(STARFRUIT, MARKET << US, 5055, 1, 976200)","{""AMETHYSTS"": -19, ""STARFRUIT"": 9}",5476,5058,10003
976500,-10002,140009,"(AMETHYSTS, US << MARKET, 10002, 1, 976500)","{""AMETHYSTS"": -18, ""STARFRUIT"": 9}",5477,5058,10003
976700,5059,145068,"(STARFRUIT, MARKET << US, 5059, 1, 976700)","{""AMETHYSTS"": -18, ""STARFRUIT"": 8}",5558,5059,9999
976900,30336,175404,"(STARFRUIT, MARKET << US, 5056, 1, 976900)
(STARFRUIT, MARKET << US, 5056, 1, 976900)
(STARFRUIT, MARKET << US, 5056, 1, 976900)
(STARFRUIT, MARKET << US, 5056, 1, 976900)
(STARFRUIT, MARKET << US, 5056, 1, 976900)
(STARFRUIT, MARKET << US, 5056, 1, 976900)","{""AMETHYSTS"": -18, ""STARFRUIT"": 2}",5548,5054,9998
977100,15057,190461,"(AMETHYSTS, MARKET << US, 9998, 1, 977100)
(STARFRUIT, MARKET << US, 5059, 1, 977100)","{""AMETHYSTS"": -19, ""STARFRUIT"": 1}",5497,5055,10001
977500,10106,200567,"(STARFRUIT, MARKET << US, 5053, 1, 977500)
(STARFRUIT, MARKET << US, 5053, 1, 977500)","{""AMETHYSTS"": -19, ""STARFRUIT"": -1}",5511,5056,10000
977900,-20350,180217,"(AMETHYSTS, MARKET << US, 9998, 1, 977900)
(STARFRUIT, US << MARKET, 5058, 1, 977900)
(STARFRUIT, US << MARKET, 5058, 1, 977900)
(STARFRUIT, US << MARKET, 5058, 1, 977900)
(STARFRUIT, US << MARKET, 5058, 1, 977900)
(STARFRUIT, US << MARKET, 5058, 1, 977900)
(STARFRUIT, US << MARKET, 5058, 1, 977900)","{""AMETHYSTS"": -20, ""STARFRUIT"": 5}",5472,5055,10001
978100,-10112,170105,"(STARFRUIT, US << MARKET, 5056, 1, 978100)
(STARFRUIT, US << MARKET, 5056, 1, 978100)","{""AMETHYSTS"": -20, ""STARFRUIT"": 7}",5524,5057,9999
978200,5051,175156,"(STARFRUIT, MARKET << US, 5051, 1, 978200)","{""AMETHYSTS"": -20, ""STARFRUIT"": 6}",5480,5054,10000
978700,-10102,165054,"(STARFRUIT, US << MARKET, 5051, 1, 978700)
(STARFRUIT, US << MARKET, 5051, 1, 978700)","{""AMETHYSTS"": -20, ""STARFRUIT"": 8}",5394,5050,10003
979200,30306,195360,"(STARFRUIT, MARKET << US, 5051, 1, 979200)
(STARFRUIT, MARKET << US, 5051, 1, 979200)
(STARFRUIT, MARKET << US, 5051, 1, 979200)
(STARFRUIT, MARKET << US, 5051, 1, 979200)
(STARFRUIT, MARKET << US, 5051, 1, 979200)
(STARFRUIT, MARKET << US, 5051, 1, 979200)","{""AMETHYSTS"": -20, ""STARFRUIT"": 2}",5508,5054,9998
979700,0,195360,,"{""AMETHYSTS"": -20, ""STARFRUIT"": 2}",5406,5053,10003
979800,-30206,165154,"(AMETHYSTS, US << MARKET, 10004, 1, 979800)
(STARFRUIT, US << MARKET, 5052, 1, 979800)
(STARFRUIT, US << MARKET, 5052, 1, 979800)
(STARFRUIT, US << MARKET, 5052, 1, 979800)
(STARFRUIT, US << MARKET, 5052, 1, 979800)
(STARFRUIT, US << MARKET, 5052, 1, 979800)
(STARFRUIT, MARKET << US, 5058, 1, 979800)","{""AMETHYSTS"": -19, ""STARFRUIT"": 6}",5484,5055,10000
979900,-10114,155040,"(STARFRUIT, US << MARKET, 5057, 1, 979900)
(STARFRUIT, US << MARKET, 5057, 1, 979900)","{""AMETHYSTS"": -19, ""STARFRUIT"": 8}",5496,5057,10000
980000,-80040,75000,"(AMETHYSTS, US << MARKET, 10005, 1, 980000)
(AMETHYSTS, US << MARKET, 10005, 1, 980000)
(AMETHYSTS, US << MARKET, 10005, 1, 980000)
(AMETHYSTS, US << MARKET, 10005, 1, 980000)
(AMETHYSTS, US << MARKET, 10005, 1, 980000)
(AMETHYSTS, US << MARKET, 10005, 1, 980000)
(AMETHYSTS, US << MARKET, 10005, 1, 980000)
(AMETHYSTS, US << MARKET, 10005, 1, 980000)","{""AMETHYSTS"": -11, ""STARFRUIT"": 8}",5432,5054,10000
980500,-20212,54788,"(STARFRUIT, US << MARKET, 5053, 1, 980500)
(STARFRUIT, US << MARKET, 5053, 1, 980500)
(STARFRUIT, US << MARKET, 5053, 1, 980500)
(STARFRUIT, US << MARKET, 5053, 1, 980500)","{""AMETHYSTS"": -11, ""STARFRUIT"": 12}",5423,5052,9999
980800,15046,69834,"(AMETHYSTS, MARKET << US, 9996, 1, 980800)
(STARFRUIT, MARKET << US, 5050, 1, 980800)","{""AMETHYSTS"": -12, ""STARFRUIT"": 11}",5406,5052,10000
980900,-5050,64784,"(STARFRUIT, US << MARKET, 5050, 1, 980900)","{""AMETHYSTS"": -12, ""STARFRUIT"": 12}",5384,5049,9999
981000,-9998,54786,"(AMETHYSTS, US << MARKET, 10005, 1, 981000)
(STARFRUIT, US << MARKET, 5050, 1, 981000)
(STARFRUIT, MARKET << US, 5057, 1, 981000)","{""AMETHYSTS"": -11, ""STARFRUIT"": 12}",5411,5053,10001
982100,-219890,-165104,"(AMETHYSTS, US << MARKET, 9995, 1, 982100)
(AMETHYSTS, US << MARKET, 9995, 1, 982100)
(AMETHYSTS, US << MARKET, 9995, 1, 982100)
(AMETHYSTS, US << MARKET, 9995, 1, 982100)
(AMETHYSTS, US << MARKET, 9995, 1, 982100)
(AMETHYSTS, US << MARKET, 9995, 1, 982100)
(AMETHYSTS, US << MARKET, 9995, 1, 982100)
(AMETHYSTS, US << MARKET, 9995, 1, 982100)
(AMETHYSTS, US << MARKET, 9995, 1, 982100)
(AMETHYSTS, US << MARKET, 9995, 1, 982100)
(AMETHYSTS, US << MARKET, 9995, 1, 982100)
(AMETHYSTS, US << MARKET, 9995, 1, 982100)
(AMETHYSTS, US << MARKET, 9995, 1, 982100)
(AMETHYSTS, US << MARKET, 9995, 1, 982100)
(AMETHYSTS, US << MARKET, 9995, 1, 982100)
(AMETHYSTS, US << MARKET, 9995, 1, 982100)
(AMETHYSTS, US << MARKET, 9995, 1, 982100)
(AMETHYSTS, US << MARKET, 9995, 1, 982100)
(AMETHYSTS, US << MARKET, 9995, 1, 982100)
(AMETHYSTS, US << MARKET, 9995, 1, 982100)
(AMETHYSTS, US << MARKET, 9995, 1, 982100)
(AMETHYSTS, US << MARKET, 9995, 1, 982100)","{""AMETHYSTS"": 11, ""STARFRUIT"": 12}",5476,5052,9996
982300,-10002,-175106,"(AMETHYSTS, US << MARKET, 10002, 1, 982300)","{""AMETHYSTS"": 12, ""STARFRUIT"": 12}",5566,5053,10003
982600,5051,-170055,"(STARFRUIT, MARKET << US, 5051, 1, 982600)","{""AMETHYSTS"": 12, ""STARFRUIT"": 11}",5539,5054,10000
983400,35350,-134705,"(STARFRUIT, MARKET << US, 5050, 1, 983400)
(STARFRUIT, MARKET << US, 5050, 1, 983400)
(STARFRUIT, MARKET << US, 5050, 1, 983400)
(STARFRUIT, MARKET << US, 5050, 1, 983400)
(STARFRUIT, MARKET << US, 5050, 1, 983400)
(STARFRUIT, MARKET << US, 5050, 1, 983400)
(STARFRUIT, MARKET << US, 5050, 1, 983400)","{""AMETHYSTS"": 12, ""STARFRUIT"": 4}",5503,5052,10000
983700,5051,-129654,"(STARFRUIT, MARKET << US, 5051, 1, 983700)","{""AMETHYSTS"": 12, ""STARFRUIT"": 3}",5508,5054,10000
983900,-25260,-154914,"(STARFRUIT, US << MARKET, 5052, 1, 983900)
(STARFRUIT, US << MARKET, 5052, 1, 983900)
(STARFRUIT, US << MARKET, 5052, 1, 983900)
(STARFRUIT, US << MARKET, 5052, 1, 983900)
(STARFRUIT, US << MARKET, 5052, 1, 983900)","{""AMETHYSTS"": 12, ""STARFRUIT"": 8}",5518,5054,10000
984200,25061,-129853,"(AMETHYSTS, MARKET << US, 10002, 1, 984200)
(AMETHYSTS, MARKET << US, 10002, 1, 984200)
(STARFRUIT, MARKET << US, 5057, 1, 984200)","{""AMETHYSTS"": 10, ""STARFRUIT"": 7}",5515,5054,9999
984300,45254,-84599,"(AMETHYSTS, MARKET << US, 10002, 1, 984300)
(AMETHYSTS, MARKET << US, 10002, 1, 984300)
(STARFRUIT, MARKET << US, 5050, 1, 984300)
(STARFRUIT, MARKET << US, 5050, 1, 984300)
(STARFRUIT, MARKET << US, 5050, 1, 984300)
(STARFRUIT, MARKET << US, 5050, 1, 984300)
(STARFRUIT, MARKET << US, 5050, 1, 984300)","{""AMETHYSTS"": 8, ""STARFRUIT"": 2}",5531,5053,10003
984500,9998,-74601,"(AMETHYSTS, MARKET << US, 9998, 1, 984500)","{""AMETHYSTS"": 7, ""STARFRUIT"": 2}",5488,5055,9997
984600,-9896,-84497,"(AMETHYSTS, US << MARKET, 10000, 1, 984600)
(AMETHYSTS, US << MARKET, 10000, 1, 984600)
(STARFRUIT, MARKET << US, 5052, 1, 984600)
(STARFRUIT, MARKET << US, 5052, 1, 984600)","{""AMETHYSTS"": 9, ""STARFRUIT"": 0}",5485,5051,9998
985300,20004,-64493,"(AMETHYSTS, MARKET << US, 10002, 1, 985300)
(AMETHYSTS, MARKET << US, 10002, 1, 985300)","{""AMETHYSTS"": 7, ""STARFRUIT"": 0}",5528,5054,10003
985400,170034,105541,"(AMETHYSTS, US << MARKET, 10002, 1, 985400)
(AMETHYSTS, MARKET << US, 10002, 1, 985400)
(AMETHYSTS, MARKET << US, 10002, 1, 985400)
(AMETHYSTS, MARKET << US, 10002, 1, 985400)
(AMETHYSTS, MARKET << US, 10002, 1, 985400)
(AMETHYSTS, MARKET << US, 10002, 1, 985400)
(AMETHYSTS, MARKET << US, 10002, 1, 985400)
(AMETHYSTS, MARKET << US, 10002, 1, 985400)
(AMETHYSTS, MARKET << US, 10002, 1, 985400)
(AMETHYSTS, MARKET << US, 10002, 1, 985400)
(AMETHYSTS, MARKET << US, 10002, 1, 985400)
(AMETHYSTS, MARKET << US, 10002, 1, 985400)
(AMETHYSTS, MARKET << US, 10002, 1, 985400)
(AMETHYSTS, MARKET << US, 10002, 1, 985400)
(AMETHYSTS, MARKET << US, 10002, 1, 985400)
(AMETHYSTS, MARKET << US, 10002, 1, 985400)
(AMETHYSTS, MARKET << US, 10002, 1, 985400)
(AMETHYSTS, MARKET << US, 10002, 1, 985400)
(AMETHYSTS, MARKET << US, 10002, 1, 985400)","{""AMETHYSTS"": -10, ""STARFRUIT"": 0}",5511,5054,10003
985700,5051,110592,"(STARFRUIT, MARKET << US, 5051, 1, 985700)","{""AMETHYSTS"": -10, ""STARFRUIT"": -1}",5538,5054,10000
985800,5056,115648,"(STARFRUIT, MARKET << US, 5056, 1, 985800)","{""AMETHYSTS"": -10, ""STARFRUIT"": -2}",5540,5054,10000
986000,-108,115540,"(AMETHYSTS, MARKET << US, 10000, 1, 986000)
(STARFRUIT, US << MARKET, 5054, 1, 986000)
(STARFRUIT, US << MARKET, 5054, 1, 986000)","{""AMETHYSTS"": -11, ""STARFRUIT"": 0}",5529,5056,10001
986200,-30092,85448,"(AMETHYSTS, US << MARKET, 9996, 1, 986200)
(AMETHYSTS, US << MARKET, 9996, 1, 986200)
(STARFRUIT, US << MARKET, 5050, 1, 986200)
(STARFRUIT, US << MARKET, 5050, 1, 986200)","{""AMETHYSTS"": -9, ""STARFRUIT"": 2}",5563,5053,9999
986400,-60180,25268,"(AMETHYSTS, US << MARKET, 9995, 1, 986400)
(AMETHYSTS, US << MARKET, 9995, 1, 986400)
(AMETHYSTS, US << MARKET, 9995, 1, 986400)
(AMETHYSTS, US << MARKET, 9995, 1, 986400)
(STARFRUIT, US << MARKET, 5050, 1, 986400)
(STARFRUIT, US << MARKET, 5050, 1, 986400)
(STARFRUIT, US << MARKET, 5050, 1, 986400)
(STARFRUIT, US << MARKET, 5050, 1, 986400)","{""AMETHYSTS"": -5, ""STARFRUIT"": 6}",5596,5053,9998
986600,-10002,15266,"(AMETHYSTS, US << MARKET, 10002, 1, 986600)","{""AMETHYSTS"": -4, ""STARFRUIT"": 6}",5566,5052,10003
986700,-10098,5168,"(STARFRUIT, US << MARKET, 5049, 1, 986700)
(STARFRUIT, US << MARKET, 5049, 1, 986700)","{""AMETHYSTS"": -4, ""STARFRUIT"": 8}",5584,5052,10000
986800,-20224,-15056,"(STARFRUIT, US << MARKET, 5056, 1, 986800)
(STARFRUIT, US << MARKET, 5056, 1, 986800)
(STARFRUIT, US << MARKET, 5056, 1, 986800)
(STARFRUIT, US << MARKET, 5056, 1, 986800)","{""AMETHYSTS"": -4, ""STARFRUIT"": 12}",5568,5052,10000
987000,20004,4948,"(AMETHYSTS, MARKET << US, 10002, 1, 987000)
(AMETHYSTS, MARKET << US, 10002, 1, 987000)","{""AMETHYSTS"": -6, ""STARFRUIT"": 12}",5578,5052,9999
987300,49990,54938,"(AMETHYSTS, MARKET << US, 9998, 1, 987300)
(AMETHYSTS, MARKET << US, 9998, 1, 987300)
(AMETHYSTS, MARKET << US, 9998, 1, 987300)
(AMETHYSTS, MARKET << US, 9998, 1, 987300)
(AMETHYSTS, MARKET << US, 9998, 1, 987300)","{""AMETHYSTS"": -11, ""STARFRUIT"": 12}",5551,5052,10001
987600,-5050,49888,"(STARFRUIT, US << MARKET, 5050, 1, 987600)","{""AMETHYSTS"": -11, ""STARFRUIT"": 13}",5577,5053,10000
988000,-20008,29880,"(AMETHYSTS, US << MARKET, 10004, 1, 988000)
(AMETHYSTS, US << MARKET, 10004, 1, 988000)
(STARFRUIT, US << MARKET, 5053, 1, 988000)
(STARFRUIT, MARKET << US, 5053, 1, 988000)","{""AMETHYSTS"": -9, ""STARFRUIT"": 13}",5543,5051,10000
988200,-5054,24826,"(STARFRUIT, US << MARKET, 5054, 1, 988200)","{""AMETHYSTS"": -9, ""STARFRUIT"": 14}",5582,5054,10000
988400,-134881,-110055,"(AMETHYSTS, US << MARKET, 9995, 1, 988400)
(AMETHYSTS, US << MARKET, 9995, 1, 988400)
(AMETHYSTS, US << MARKET, 9995, 1, 988400)
(AMETHYSTS, US << MARKET, 9995, 1, 988400)
(AMETHYSTS, US << MARKET, 9995, 1, 988400)
(AMETHYSTS, US << MARKET, 9995, 1, 988400)
(AMETHYSTS, US << MARKET, 9995, 1, 988400)
(AMETHYSTS, US << MARKET, 9995, 1, 988400)
(AMETHYSTS, US << MARKET, 9995, 1, 988400)
(AMETHYSTS, US << MARKET, 9995, 1, 988400)
(AMETHYSTS, US << MARKET, 9995, 1, 988400)
(AMETHYSTS, US << MARKET, 9995, 1, 988400)
(AMETHYSTS, US << MARKET, 9995, 1, 988400)
(AMETHYSTS, US << MARKET, 9995, 1, 988400)
(STARFRUIT, MARKET << US, 5049, 1, 988400)","{""AMETHYSTS"": 5, ""STARFRUIT"": 13}",5621,5052,10000
988900,5049,-105006,"(STARFRUIT, MARKET << US, 5049, 1, 988900)","{""AMETHYSTS"": 5, ""STARFRUIT"": 12}",5633,5052,10003
989000,-10002,-115008,"(AMETHYSTS, US << MARKET, 10002, 1, 989000)","{""AMETHYSTS"": 6, ""STARFRUIT"": 12}",5634,5052,10003
989100,-5049,-120057,"(STARFRUIT, US << MARKET, 5049, 1, 989100)","{""AMETHYSTS"": 6, ""STARFRUIT"": 13}",5594,5051,9998
989900,-20004,-140061,"(AMETHYSTS, US << MARKET, 10002, 1, 989900)
(AMETHYSTS, US << MARKET, 10002, 1, 989900)","{""AMETHYSTS"": 8, ""STARFRUIT"": 13}",5639,5052,10003
990100,-5050,-145111,"(STARFRUIT, US << MARKET, 5050, 1, 990100)","{""AMETHYSTS"": 8, ""STARFRUIT"": 14}",5617,5052,10000
990900,-34951,-180062,"(AMETHYSTS, US << MARKET, 10002, 1, 990900)
(AMETHYSTS, US << MARKET, 10002, 1, 990900)
(AMETHYSTS, US << MARKET, 10002, 1, 990900)
(AMETHYSTS, US << MARKET, 10002, 1, 990900)
(STARFRUIT, MARKET << US, 5057, 1, 990900)","{""AMETHYSTS"": 12, ""STARFRUIT"": 13}",5676,5054,10003
991000,-5058,-185120,"(STARFRUIT, US << MARKET, 5058, 1, 991000)","{""AMETHYSTS"": 12, ""STARFRUIT"": 14}",5692,5058,10000
991200,-20224,-205344,"(STARFRUIT, US << MARKET, 5056, 1, 991200)
(STARFRUIT, US << MARKET, 5056, 1, 991200)
(STARFRUIT, US << MARKET, 5056, 1, 991200)
(STARFRUIT, US << MARKET, 5056, 1, 991200)","{""AMETHYSTS"": 12, ""STARFRUIT"": 18}",5682,5057,10000
991600,-39992,-245336,"(AMETHYSTS, US << MARKET, 9998, 1, 991600)
(AMETHYSTS, US << MARKET, 9998, 1, 991600)
(AMETHYSTS, US << MARKET, 9998, 1, 991600)
(AMETHYSTS, US << MARKET, 9998, 1, 991600)","{""AMETHYSTS"": 16, ""STARFRUIT"": 18}",5624,5056,9997
992000,45540,-199796,"(STARFRUIT, MARKET << US, 5060, 1, 992000)
(STARFRUIT, MARKET << US, 5060, 1, 992000)
(STARFRUIT, MARKET << US, 5060, 1, 992000)
(STARFRUIT, MARKET << US, 5060, 1, 992000)
(STARFRUIT, MARKET << US, 5060, 1, 992000)
(STARFRUIT, MARKET << US, 5060, 1, 992000)
(STARFRUIT, MARKET << US, 5060, 1, 992000)
(STARFRUIT, MARKET << US, 5060, 1, 992000)
(STARFRUIT, MARKET << US, 5060, 1, 992000)","{""AMETHYSTS"": 16, ""STARFRUIT"": 9}",5708,5056,10000
992200,20004,-179792,"(AMETHYSTS, MARKET << US, 10002, 1, 992200)
(AMETHYSTS, MARKET << US, 10002, 1, 992200)","{""AMETHYSTS"": 14, ""STARFRUIT"": 9}",5754,5056,10003
992500,-20208,-200000,"(STARFRUIT, US << MARKET, 5052, 1, 992500)
(STARFRUIT, US << MARKET, 5052, 1, 992500)
(STARFRUIT, US << MARKET, 5052, 1, 992500)
(STARFRUIT, US << MARKET, 5052, 1, 992500)","{""AMETHYSTS"": 14, ""STARFRUIT"": 13}",5715,5055,10000
992800,-20006,-220006,"(AMETHYSTS, US << MARKET, 10002, 1, 992800)
(AMETHYSTS, US << MARKET, 10004, 1, 992800)
(AMETHYSTS, US << MARKET, 10004, 1, 992800)
(AMETHYSTS, US << MARKET, 10004, 1, 992800)
(AMETHYSTS, MARKET << US, 10004, 1, 992800)
(AMETHYSTS, MARKET << US, 10004, 1, 992800)","{""AMETHYSTS"": 16, ""STARFRUIT"": 13}",5744,5054,10003
993000,14953,-205053,"(AMETHYSTS, MARKET << US, 10005, 1, 993000)
(AMETHYSTS, MARKET << US, 10005, 1, 993000)
(STARFRUIT, US << MARKET, 5057, 1, 993000)","{""AMETHYSTS"": 14, ""STARFRUIT"": 14}",5717,5055,10000
993400,-35170,-240223,"(AMETHYSTS, US << MARKET, 9996, 1, 993400)
(AMETHYSTS, US << MARKET, 9996, 1, 993400)
(STARFRUIT, US << MARKET, 5057, 1, 993400)
(STARFRUIT, US << MARKET, 5057, 1, 993400)
(STARFRUIT, US << MARKET, 5057, 1, 993400)
(STARFRUIT, US << MARKET, 5057, 1, 993400)
(STARFRUIT, MARKET << US, 5050, 1, 993400)","{""AMETHYSTS"": 16, ""STARFRUIT"": 17}",5662,5053,9999
993800,-5053,-245276,"(STARFRUIT, US << MARKET, 5052, 1, 993800)
(STARFRUIT, US << MARKET, 5052, 1, 993800)
(STARFRUIT, US << MARKET, 5052, 1, 993800)
(STARFRUIT, MARKET << US, 5052, 1, 993800)
(STARFRUIT, MARKET << US, 5051, 1, 993800)","{""AMETHYSTS"": 16, ""STARFRUIT"": 18}",5714,5055,10000
993900,-5056,-250332,"(STARFRUIT, US << MARKET, 5056, 1, 993900)","{""AMETHYSTS"": 16, ""STARFRUIT"": 19}",5691,5053,10001
994000,-29988,-280320,"(AMETHYSTS, US << MARKET, 9996, 1, 994000)
(AMETHYSTS, US << MARKET, 9996, 1, 994000)
(AMETHYSTS, US << MARKET, 9996, 1, 994000)
(AMETHYSTS, US << MARKET, 9996, 1, 994000)
(AMETHYSTS, MARKET << US, 9996, 1, 994000)","{""AMETHYSTS"": 19, ""STARFRUIT"": 19}",5706,5054,10000
994100,4939,-275381,"(AMETHYSTS, MARKET << US, 9995, 1, 994100)
(STARFRUIT, US << MARKET, 5056, 1, 994100)","{""AMETHYSTS"": 18, ""STARFRUIT"": 20}",5739,5056,10000
994400,5052,-270329,"(STARFRUIT, MARKET << US, 5052, 1, 994400)","{""AMETHYSTS"": 18, ""STARFRUIT"": 19}",5734,5055,10001
994700,5052,-265277,"(STARFRUIT, MARKET << US, 5052, 1, 994700)","{""AMETHYSTS"": 18, ""STARFRUIT"": 18}",5713,5052,10003
994900,-19996,-285273,"(AMETHYSTS, US << MARKET, 9998, 1, 994900)
(AMETHYSTS, US << MARKET, 9998, 1, 994900)
(STARFRUIT, US << MARKET, 5053, 1, 994900)
(STARFRUIT, US << MARKET, 5053, 1, 994900)
(STARFRUIT, MARKET << US, 5053, 1, 994900)
(STARFRUIT, MARKET << US, 5053, 1, 994900)","{""AMETHYSTS"": 20, ""STARFRUIT"": 18}",5655,5056,9996
995000,30318,-254955,"(STARFRUIT, MARKET << US, 5053, 1, 995000)
(STARFRUIT, MARKET << US, 5053, 1, 995000)
(STARFRUIT, MARKET << US, 5053, 1, 995000)
(STARFRUIT, MARKET << US, 5053, 1, 995000)
(STARFRUIT, MARKET << US, 5053, 1, 995000)
(STARFRUIT, MARKET << US, 5053, 1, 995000)","{""AMETHYSTS"": 20, ""STARFRUIT"": 12}",5669,5052,10000
995500,10116,-244839,"(STARFRUIT, MARKET << US, 5058, 1, 995500)
(STARFRUIT, MARKET << US, 5058, 1, 995500)","{""AMETHYSTS"": 20, ""STARFRUIT"": 10}",5741,5056,10001
995700,10114,-234725,"(STARFRUIT, MARKET << US, 5057, 1, 995700)
(STARFRUIT, MARKET << US, 5057, 1, 995700)","{""AMETHYSTS"": 20, ""STARFRUIT"": 8}",5719,5058,9999
996200,0,-234725,,"{""AMETHYSTS"": 20, ""STARFRUIT"": 8}",5735,5055,10001
996300,9996,-224729,"(AMETHYSTS, MARKET << US, 9996, 1, 996300)","{""AMETHYSTS"": 19, ""STARFRUIT"": 8}",5684,5054,9999
996500,60024,-164705,"(AMETHYSTS, MARKET << US, 10004, 1, 996500)
(AMETHYSTS, MARKET << US, 10004, 1, 996500)
(AMETHYSTS, MARKET << US, 10004, 1, 996500)
(AMETHYSTS, MARKET << US, 10004, 1, 996500)
(AMETHYSTS, MARKET << US, 10004, 1, 996500)
(AMETHYSTS, MARKET << US, 10004, 1, 996500)","{""AMETHYSTS"": 13, ""STARFRUIT"": 8}",5735,5055,10000
996600,20116,-144589,"(AMETHYSTS, MARKET << US, 9998, 1, 996600)
(STARFRUIT, MARKET << US, 5059, 1, 996600)
(STARFRUIT, MARKET << US, 5059, 1, 996600)","{""AMETHYSTS"": 12, ""STARFRUIT"": 6}",5711,5056,9997
996700,19808,-124781,"(AMETHYSTS, MARKET << US, 10005, 1, 996700)
(AMETHYSTS, MARKET << US, 10005, 1, 996700)
(AMETHYSTS, MARKET << US, 10005, 1, 996700)
(AMETHYSTS, MARKET << US, 10005, 1, 996700)
(STARFRUIT, US << MARKET, 5053, 1, 996700)
(STARFRUIT, US << MARKET, 5053, 1, 996700)
(STARFRUIT, US << MARKET, 5053, 1, 996700)
(STARFRUIT, US << MARKET, 5053, 1, 996700)","{""AMETHYSTS"": 8, ""STARFRUIT"": 10}",5803,5056,10003
996900,-25047,-149828,"(AMETHYSTS, US << MARKET, 9998, 1, 996900)
(AMETHYSTS, US << MARKET, 9998, 1, 996900)
(STARFRUIT, US << MARKET, 5051, 1, 996900)","{""AMETHYSTS"": 10, ""STARFRUIT"": 11}",5736,5054,9997
997000,35392,-114436,"(STARFRUIT, MARKET << US, 5056, 1, 997000)
(STARFRUIT, MARKET << US, 5056, 1, 997000)
(STARFRUIT, MARKET << US, 5056, 1, 997000)
(STARFRUIT, MARKET << US, 5056, 1, 997000)
(STARFRUIT, MARKET << US, 5056, 1, 997000)
(STARFRUIT, MARKET << US, 5056, 1, 997000)
(STARFRUIT, MARKET << US, 5056, 1, 997000)","{""AMETHYSTS"": 10, ""STARFRUIT"": 4}",5792,5057,10000
997100,-14936,-129372,"(AMETHYSTS, US << MARKET, 9996, 1, 997100)
(AMETHYSTS, US << MARKET, 9996, 1, 997100)
(STARFRUIT, MARKET << US, 5056, 1, 997100)","{""AMETHYSTS"": 12, ""STARFRUIT"": 3}",5796,5056,10000
997500,9998,-119374,"(AMETHYSTS, MARKET << US, 9998, 1, 997500)","{""AMETHYSTS"": 11, ""STARFRUIT"": 3}",5790,5051,10001
997600,80016,-39358,"(AMETHYSTS, MARKET << US, 10002, 1, 997600)
(AMETHYSTS, MARKET << US, 10002, 1, 997600)
(AMETHYSTS, MARKET << US, 10002, 1, 997600)
(AMETHYSTS, MARKET << US, 10002, 1, 997600)
(AMETHYSTS, MARKET << US, 10002, 1, 997600)
(AMETHYSTS, MARKET << US, 10002, 1, 997600)
(AMETHYSTS, MARKET << US, 10002, 1, 997600)
(AMETHYSTS, MARKET << US, 10002, 1, 997600)","{""AMETHYSTS"": 3, ""STARFRUIT"": 3}",5804,5051,10003
997700,20004,-19354,"(AMETHYSTS, MARKET << US, 10002, 1, 997700)
(AMETHYSTS, MARKET << US, 10002, 1, 997700)","{""AMETHYSTS"": 1, ""STARFRUIT"": 3}",5793,5050,9997
998000,5050,-14304,"(STARFRUIT, MARKET << US, 5050, 1, 998000)","{""AMETHYSTS"": 1, ""STARFRUIT"": 2}",5795,5049,10001
998400,80016,65712,"(AMETHYSTS, MARKET << US, 10002, 1, 998400)
(AMETHYSTS, MARKET << US, 10002, 1, 998400)
(AMETHYSTS, MARKET << US, 10002, 1, 998400)
(AMETHYSTS, MARKET << US, 10002, 1, 998400)
(AMETHYSTS, MARKET << US, 10002, 1, 998400)
(AMETHYSTS, MARKET << US, 10002, 1, 998400)
(AMETHYSTS, MARKET << US, 10002, 1, 998400)
(AMETHYSTS, MARKET << US, 10002, 1, 998400)","{""AMETHYSTS"": -7, ""STARFRUIT"": 2}",5795,5052,10003
998500,-20200,45512,"(STARFRUIT, US << MARKET, 5050, 1, 998500)
(STARFRUIT, US << MARKET, 5050, 1, 998500)
(STARFRUIT, US << MARKET, 5050, 1, 998500)
(STARFRUIT, US << MARKET, 5050, 1, 998500)","{""AMETHYSTS"": -7, ""STARFRUIT"": 6}",5837,5053,9999
998700,-10110,35402,"(STARFRUIT, US << MARKET, 5055, 1, 998700)
(STARFRUIT, US << MARKET, 5055, 1, 998700)","{""AMETHYSTS"": -7, ""STARFRUIT"": 8}",5818,5052,10000
998800,-15052,20350,"(AMETHYSTS, US << MARKET, 10002, 1, 998800)
(STARFRUIT, US << MARKET, 5050, 1, 998800)","{""AMETHYSTS"": -6, ""STARFRUIT"": 9}",5809,5053,10003
999500,-29882,-9532,"(AMETHYSTS, US << MARKET, 9995, 1, 999500)
(AMETHYSTS, US << MARKET, 9995, 1, 999500)
(AMETHYSTS, US << MARKET, 9995, 1, 999500)
(AMETHYSTS, US << MARKET, 9995, 1, 999500)
(STARFRUIT, MARKET << US, 5049, 1, 999500)
(STARFRUIT, MARKET << US, 5049, 1, 999500)","{""AMETHYSTS"": -2, ""STARFRUIT"": 7}",5836,5052,9998
999600,-5048,-14580,"(STARFRUIT, US << MARKET, 5048, 1, 999600)","{""AMETHYSTS"": -2, ""STARFRUIT"": 8}",5830,5051,9999
